kernel,runtime,gpu,collapse,num_teams,num_threads,mem_to,mem_alloc,mem_from,mem_delete,num_var,N1
nn_kernel_cpu,21282,0,1,1,64,0,0,0,0,1,10000000
nn_kernel_gpu,638,1,1,78125,128,0,0,0,0,1,10000000
nn_kernel_gpu_mem,14646,1,1,78125,128,80000000,40000000,40000000,80000000,1,10000000
nn_kernel_cpu,7801,0,1,1,64,0,0,0,0,1,1000000
nn_kernel_gpu,119,1,1,7813,128,0,0,0,0,1,1000000
nn_kernel_gpu_mem,2350,1,1,7813,128,8000000,4000000,4000000,8000000,1,1000000
nn_kernel_cpu,271,0,1,1,64,0,0,0,0,1,100000
nn_kernel_gpu,44,1,1,782,128,0,0,0,0,1,100000
nn_kernel_gpu_mem,295,1,1,782,128,800000,400000,400000,800000,1,100000
nn_kernel_cpu,578,0,1,1,64,0,0,0,0,1,10000
nn_kernel_gpu,33,1,1,79,128,0,0,0,0,1,10000
nn_kernel_gpu_mem,112,1,1,79,128,80000,40000,40000,80000,1,10000
nn_kernel_cpu,4988,0,1,1,64,0,0,0,0,1,10010000
nn_kernel_gpu,633,1,1,78204,128,0,0,0,0,1,10010000
nn_kernel_gpu_mem,21706,1,1,78204,128,80080000,40040000,40040000,80080000,1,10010000
nn_kernel_cpu,19702,0,1,1,64,0,0,0,0,1,10020000
nn_kernel_gpu,629,1,1,78282,128,0,0,0,0,1,10020000
nn_kernel_gpu_mem,15487,1,1,78282,128,80160000,40080000,40080000,80160000,1,10020000
nn_kernel_cpu,11083,0,1,1,64,0,0,0,0,1,10030000
nn_kernel_gpu,634,1,1,78360,128,0,0,0,0,1,10030000
nn_kernel_gpu_mem,14673,1,1,78360,128,80240000,40120000,40120000,80240000,1,10030000
nn_kernel_cpu,26757,0,1,1,64,0,0,0,0,1,10040000
nn_kernel_gpu,633,1,1,78438,128,0,0,0,0,1,10040000
nn_kernel_gpu_mem,14686,1,1,78438,128,80320000,40160000,40160000,80320000,1,10040000
nn_kernel_cpu,33793,0,1,1,64,0,0,0,0,1,10050000
nn_kernel_gpu,627,1,1,78516,128,0,0,0,0,1,10050000
nn_kernel_gpu_mem,14833,1,1,78516,128,80400000,40200000,40200000,80400000,1,10050000
nn_kernel_cpu,14314,0,1,1,64,0,0,0,0,1,10060000
nn_kernel_gpu,630,1,1,78594,128,0,0,0,0,1,10060000
nn_kernel_gpu_mem,13959,1,1,78594,128,80480000,40240000,40240000,80480000,1,10060000
nn_kernel_cpu,30923,0,1,1,64,0,0,0,0,1,10070000
nn_kernel_gpu,673,1,1,78672,128,0,0,0,0,1,10070000
nn_kernel_gpu_mem,15446,1,1,78672,128,80560000,40280000,40280000,80560000,1,10070000
nn_kernel_cpu,16873,0,1,1,64,0,0,0,0,1,10080000
nn_kernel_gpu,634,1,1,78750,128,0,0,0,0,1,10080000
nn_kernel_gpu_mem,15922,1,1,78750,128,80640000,40320000,40320000,80640000,1,10080000
nn_kernel_cpu,23409,0,1,1,64,0,0,0,0,1,10090000
nn_kernel_gpu,635,1,1,78829,128,0,0,0,0,1,10090000
nn_kernel_gpu_mem,14875,1,1,78829,128,80720000,40360000,40360000,80720000,1,10090000
nn_kernel_cpu,7268,0,1,1,64,0,0,0,0,1,10100000
nn_kernel_gpu,636,1,1,78907,128,0,0,0,0,1,10100000
nn_kernel_gpu_mem,14551,1,1,78907,128,80800000,40400000,40400000,80800000,1,10100000
nn_kernel_cpu,7682,0,1,1,64,0,0,0,0,1,1010000
nn_kernel_gpu,114,1,1,7891,128,0,0,0,0,1,1010000
nn_kernel_gpu_mem,2315,1,1,7891,128,8080000,4040000,4040000,8080000,1,1010000
nn_kernel_cpu,23615,0,1,1,64,0,0,0,0,1,10110000
nn_kernel_gpu,644,1,1,78985,128,0,0,0,0,1,10110000
nn_kernel_gpu_mem,16403,1,1,78985,128,80880000,40440000,40440000,80880000,1,10110000
nn_kernel_cpu,21835,0,1,1,64,0,0,0,0,1,10120000
nn_kernel_gpu,634,1,1,79063,128,0,0,0,0,1,10120000
nn_kernel_gpu_mem,15543,1,1,79063,128,80960000,40480000,40480000,80960000,1,10120000
nn_kernel_cpu,14254,0,1,1,64,0,0,0,0,1,10130000
nn_kernel_gpu,627,1,1,79141,128,0,0,0,0,1,10130000
nn_kernel_gpu_mem,14090,1,1,79141,128,81040000,40520000,40520000,81040000,1,10130000
nn_kernel_cpu,9654,0,1,1,64,0,0,0,0,1,10140000
nn_kernel_gpu,635,1,1,79219,128,0,0,0,0,1,10140000
nn_kernel_gpu_mem,19910,1,1,79219,128,81120000,40560000,40560000,81120000,1,10140000
nn_kernel_cpu,16489,0,1,1,64,0,0,0,0,1,10150000
nn_kernel_gpu,636,1,1,79297,128,0,0,0,0,1,10150000
nn_kernel_gpu_mem,13676,1,1,79297,128,81200000,40600000,40600000,81200000,1,10150000
nn_kernel_cpu,19300,0,1,1,64,0,0,0,0,1,10160000
nn_kernel_gpu,639,1,1,79375,128,0,0,0,0,1,10160000
nn_kernel_gpu_mem,15778,1,1,79375,128,81280000,40640000,40640000,81280000,1,10160000
nn_kernel_cpu,17612,0,1,1,64,0,0,0,0,1,10170000
nn_kernel_gpu,648,1,1,79454,128,0,0,0,0,1,10170000
nn_kernel_gpu_mem,14777,1,1,79454,128,81360000,40680000,40680000,81360000,1,10170000
nn_kernel_cpu,22699,0,1,1,64,0,0,0,0,1,10180000
nn_kernel_gpu,648,1,1,79532,128,0,0,0,0,1,10180000
nn_kernel_gpu_mem,14475,1,1,79532,128,81440000,40720000,40720000,81440000,1,10180000
nn_kernel_cpu,14823,0,1,1,64,0,0,0,0,1,10190000
nn_kernel_gpu,645,1,1,79610,128,0,0,0,0,1,10190000
nn_kernel_gpu_mem,11877,1,1,79610,128,81520000,40760000,40760000,81520000,1,10190000
nn_kernel_cpu,11518,0,1,1,64,0,0,0,0,1,10200000
nn_kernel_gpu,638,1,1,79688,128,0,0,0,0,1,10200000
nn_kernel_gpu_mem,11908,1,1,79688,128,81600000,40800000,40800000,81600000,1,10200000
nn_kernel_cpu,2510,0,1,1,64,0,0,0,0,1,1020000
nn_kernel_gpu,121,1,1,7969,128,0,0,0,0,1,1020000
nn_kernel_gpu_mem,4004,1,1,7969,128,8160000,4080000,4080000,8160000,1,1020000
nn_kernel_cpu,23696,0,1,1,64,0,0,0,0,1,10210000
nn_kernel_gpu,642,1,1,79766,128,0,0,0,0,1,10210000
nn_kernel_gpu_mem,16665,1,1,79766,128,81680000,40840000,40840000,81680000,1,10210000
nn_kernel_cpu,9624,0,1,1,64,0,0,0,0,1,10220000
nn_kernel_gpu,640,1,1,79844,128,0,0,0,0,1,10220000
nn_kernel_gpu_mem,21908,1,1,79844,128,81760000,40880000,40880000,81760000,1,10220000
nn_kernel_cpu,12187,0,1,1,64,0,0,0,0,1,10230000
nn_kernel_gpu,652,1,1,79922,128,0,0,0,0,1,10230000
nn_kernel_gpu_mem,11238,1,1,79922,128,81840000,40920000,40920000,81840000,1,10230000
nn_kernel_cpu,23328,0,1,1,64,0,0,0,0,1,10240000
nn_kernel_gpu,648,1,1,80000,128,0,0,0,0,1,10240000
nn_kernel_gpu_mem,15315,1,1,80000,128,81920000,40960000,40960000,81920000,1,10240000
nn_kernel_cpu,6689,0,1,1,64,0,0,0,0,1,10250000
nn_kernel_gpu,654,1,1,80079,128,0,0,0,0,1,10250000
nn_kernel_gpu_mem,14677,1,1,80079,128,82000000,41000000,41000000,82000000,1,10250000
nn_kernel_cpu,15967,0,1,1,64,0,0,0,0,1,10260000
nn_kernel_gpu,641,1,1,80157,128,0,0,0,0,1,10260000
nn_kernel_gpu_mem,14644,1,1,80157,128,82080000,41040000,41040000,82080000,1,10260000
nn_kernel_cpu,23825,0,1,1,64,0,0,0,0,1,10270000
nn_kernel_gpu,631,1,1,80235,128,0,0,0,0,1,10270000
nn_kernel_gpu_mem,14855,1,1,80235,128,82160000,41080000,41080000,82160000,1,10270000
nn_kernel_cpu,12026,0,1,1,64,0,0,0,0,1,10280000
nn_kernel_gpu,646,1,1,80313,128,0,0,0,0,1,10280000
nn_kernel_gpu_mem,15973,1,1,80313,128,82240000,41120000,41120000,82240000,1,10280000
nn_kernel_cpu,19542,0,1,1,64,0,0,0,0,1,10290000
nn_kernel_gpu,644,1,1,80391,128,0,0,0,0,1,10290000
nn_kernel_gpu_mem,11670,1,1,80391,128,82320000,41160000,41160000,82320000,1,10290000
nn_kernel_cpu,4956,0,1,1,64,0,0,0,0,1,10300000
nn_kernel_gpu,644,1,1,80469,128,0,0,0,0,1,10300000
nn_kernel_gpu_mem,14802,1,1,80469,128,82400000,41200000,41200000,82400000,1,10300000
nn_kernel_cpu,60616,0,1,1,64,0,0,0,0,1,1030000
nn_kernel_gpu,120,1,1,8047,128,0,0,0,0,1,1030000
nn_kernel_gpu_mem,2027,1,1,8047,128,8240000,4120000,4120000,8240000,1,1030000
nn_kernel_cpu,8134,0,1,1,64,0,0,0,0,1,10310000
nn_kernel_gpu,685,1,1,80547,128,0,0,0,0,1,10310000
nn_kernel_gpu_mem,14720,1,1,80547,128,82480000,41240000,41240000,82480000,1,10310000
nn_kernel_cpu,8319,0,1,1,64,0,0,0,0,1,10320000
nn_kernel_gpu,664,1,1,80625,128,0,0,0,0,1,10320000
nn_kernel_gpu_mem,14209,1,1,80625,128,82560000,41280000,41280000,82560000,1,10320000
nn_kernel_cpu,16047,0,1,1,64,0,0,0,0,1,10330000
nn_kernel_gpu,658,1,1,80704,128,0,0,0,0,1,10330000
nn_kernel_gpu_mem,14924,1,1,80704,128,82640000,41320000,41320000,82640000,1,10330000
nn_kernel_cpu,8173,0,1,1,64,0,0,0,0,1,10340000
nn_kernel_gpu,641,1,1,80782,128,0,0,0,0,1,10340000
nn_kernel_gpu_mem,14639,1,1,80782,128,82720000,41360000,41360000,82720000,1,10340000
nn_kernel_cpu,25308,0,1,1,64,0,0,0,0,1,10350000
nn_kernel_gpu,644,1,1,80860,128,0,0,0,0,1,10350000
nn_kernel_gpu_mem,15583,1,1,80860,128,82800000,41400000,41400000,82800000,1,10350000
nn_kernel_cpu,7364,0,1,1,64,0,0,0,0,1,10360000
nn_kernel_gpu,643,1,1,80938,128,0,0,0,0,1,10360000
nn_kernel_gpu_mem,15696,1,1,80938,128,82880000,41440000,41440000,82880000,1,10360000
nn_kernel_cpu,11064,0,1,1,64,0,0,0,0,1,10370000
nn_kernel_gpu,654,1,1,81016,128,0,0,0,0,1,10370000
nn_kernel_gpu_mem,14552,1,1,81016,128,82960000,41480000,41480000,82960000,1,10370000
nn_kernel_cpu,23632,0,1,1,64,0,0,0,0,1,10380000
nn_kernel_gpu,650,1,1,81094,128,0,0,0,0,1,10380000
nn_kernel_gpu_mem,15625,1,1,81094,128,83040000,41520000,41520000,83040000,1,10380000
nn_kernel_cpu,7514,0,1,1,64,0,0,0,0,1,10390000
nn_kernel_gpu,643,1,1,81172,128,0,0,0,0,1,10390000
nn_kernel_gpu_mem,14883,1,1,81172,128,83120000,41560000,41560000,83120000,1,10390000
nn_kernel_cpu,30392,0,1,1,64,0,0,0,0,1,10400000
nn_kernel_gpu,650,1,1,81250,128,0,0,0,0,1,10400000
nn_kernel_gpu_mem,14822,1,1,81250,128,83200000,41600000,41600000,83200000,1,10400000
nn_kernel_cpu,3966,0,1,1,64,0,0,0,0,1,1040000
nn_kernel_gpu,106,1,1,8125,128,0,0,0,0,1,1040000
nn_kernel_gpu_mem,3339,1,1,8125,128,8320000,4160000,4160000,8320000,1,1040000
nn_kernel_cpu,23382,0,1,1,64,0,0,0,0,1,10410000
nn_kernel_gpu,646,1,1,81329,128,0,0,0,0,1,10410000
nn_kernel_gpu_mem,15218,1,1,81329,128,83280000,41640000,41640000,83280000,1,10410000
nn_kernel_cpu,22627,0,1,1,64,0,0,0,0,1,10420000
nn_kernel_gpu,652,1,1,81407,128,0,0,0,0,1,10420000
nn_kernel_gpu_mem,14393,1,1,81407,128,83360000,41680000,41680000,83360000,1,10420000
nn_kernel_cpu,22309,0,1,1,64,0,0,0,0,1,10430000
nn_kernel_gpu,659,1,1,81485,128,0,0,0,0,1,10430000
nn_kernel_gpu_mem,17015,1,1,81485,128,83440000,41720000,41720000,83440000,1,10430000
nn_kernel_cpu,13881,0,1,1,64,0,0,0,0,1,10440000
nn_kernel_gpu,660,1,1,81563,128,0,0,0,0,1,10440000
nn_kernel_gpu_mem,15017,1,1,81563,128,83520000,41760000,41760000,83520000,1,10440000
nn_kernel_cpu,24977,0,1,1,64,0,0,0,0,1,10450000
nn_kernel_gpu,646,1,1,81641,128,0,0,0,0,1,10450000
nn_kernel_gpu_mem,14792,1,1,81641,128,83600000,41800000,41800000,83600000,1,10450000
nn_kernel_cpu,30453,0,1,1,64,0,0,0,0,1,10460000
nn_kernel_gpu,665,1,1,81719,128,0,0,0,0,1,10460000
nn_kernel_gpu_mem,17684,1,1,81719,128,83680000,41840000,41840000,83680000,1,10460000
nn_kernel_cpu,29678,0,1,1,64,0,0,0,0,1,10470000
nn_kernel_gpu,650,1,1,81797,128,0,0,0,0,1,10470000
nn_kernel_gpu_mem,20073,1,1,81797,128,83760000,41880000,41880000,83760000,1,10470000
nn_kernel_cpu,58658,0,1,1,64,0,0,0,0,1,10480000
nn_kernel_gpu,646,1,1,81875,128,0,0,0,0,1,10480000
nn_kernel_gpu_mem,15180,1,1,81875,128,83840000,41920000,41920000,83840000,1,10480000
nn_kernel_cpu,8473,0,1,1,64,0,0,0,0,1,10490000
nn_kernel_gpu,648,1,1,81954,128,0,0,0,0,1,10490000
nn_kernel_gpu_mem,14695,1,1,81954,128,83920000,41960000,41960000,83920000,1,10490000
nn_kernel_cpu,23540,0,1,1,64,0,0,0,0,1,10500000
nn_kernel_gpu,663,1,1,82032,128,0,0,0,0,1,10500000
nn_kernel_gpu_mem,15003,1,1,82032,128,84000000,42000000,42000000,84000000,1,10500000
nn_kernel_cpu,24237,0,1,1,64,0,0,0,0,1,1050000
nn_kernel_gpu,118,1,1,8204,128,0,0,0,0,1,1050000
nn_kernel_gpu_mem,2197,1,1,8204,128,8400000,4200000,4200000,8400000,1,1050000
nn_kernel_cpu,23860,0,1,1,64,0,0,0,0,1,10510000
nn_kernel_gpu,659,1,1,82110,128,0,0,0,0,1,10510000
nn_kernel_gpu_mem,12148,1,1,82110,128,84080000,42040000,42040000,84080000,1,10510000
nn_kernel_cpu,30536,0,1,1,64,0,0,0,0,1,10520000
nn_kernel_gpu,699,1,1,82188,128,0,0,0,0,1,10520000
nn_kernel_gpu_mem,15108,1,1,82188,128,84160000,42080000,42080000,84160000,1,10520000
nn_kernel_cpu,11958,0,1,1,64,0,0,0,0,1,10530000
nn_kernel_gpu,661,1,1,82266,128,0,0,0,0,1,10530000
nn_kernel_gpu_mem,17278,1,1,82266,128,84240000,42120000,42120000,84240000,1,10530000
nn_kernel_cpu,28416,0,1,1,64,0,0,0,0,1,10540000
nn_kernel_gpu,665,1,1,82344,128,0,0,0,0,1,10540000
nn_kernel_gpu_mem,14830,1,1,82344,128,84320000,42160000,42160000,84320000,1,10540000
nn_kernel_cpu,25287,0,1,1,64,0,0,0,0,1,10550000
nn_kernel_gpu,658,1,1,82422,128,0,0,0,0,1,10550000
nn_kernel_gpu_mem,14883,1,1,82422,128,84400000,42200000,42200000,84400000,1,10550000
nn_kernel_cpu,27031,0,1,1,64,0,0,0,0,1,10560000
nn_kernel_gpu,655,1,1,82500,128,0,0,0,0,1,10560000
nn_kernel_gpu_mem,15329,1,1,82500,128,84480000,42240000,42240000,84480000,1,10560000
nn_kernel_cpu,23062,0,1,1,64,0,0,0,0,1,10570000
nn_kernel_gpu,661,1,1,82579,128,0,0,0,0,1,10570000
nn_kernel_gpu_mem,16092,1,1,82579,128,84560000,42280000,42280000,84560000,1,10570000
nn_kernel_cpu,12859,0,1,1,64,0,0,0,0,1,10580000
nn_kernel_gpu,658,1,1,82657,128,0,0,0,0,1,10580000
nn_kernel_gpu_mem,15961,1,1,82657,128,84640000,42320000,42320000,84640000,1,10580000
nn_kernel_cpu,16286,0,1,1,64,0,0,0,0,1,10590000
nn_kernel_gpu,658,1,1,82735,128,0,0,0,0,1,10590000
nn_kernel_gpu_mem,14564,1,1,82735,128,84720000,42360000,42360000,84720000,1,10590000
nn_kernel_cpu,27552,0,1,1,64,0,0,0,0,1,10600000
nn_kernel_gpu,654,1,1,82813,128,0,0,0,0,1,10600000
nn_kernel_gpu_mem,17406,1,1,82813,128,84800000,42400000,42400000,84800000,1,10600000
nn_kernel_cpu,15192,0,1,1,64,0,0,0,0,1,1060000
nn_kernel_gpu,111,1,1,8282,128,0,0,0,0,1,1060000
nn_kernel_gpu_mem,2035,1,1,8282,128,8480000,4240000,4240000,8480000,1,1060000
nn_kernel_cpu,23040,0,1,1,64,0,0,0,0,1,10610000
nn_kernel_gpu,667,1,1,82891,128,0,0,0,0,1,10610000
nn_kernel_gpu_mem,15077,1,1,82891,128,84880000,42440000,42440000,84880000,1,10610000
nn_kernel_cpu,29273,0,1,1,64,0,0,0,0,1,10620000
nn_kernel_gpu,665,1,1,82969,128,0,0,0,0,1,10620000
nn_kernel_gpu_mem,15599,1,1,82969,128,84960000,42480000,42480000,84960000,1,10620000
nn_kernel_cpu,14622,0,1,1,64,0,0,0,0,1,10630000
nn_kernel_gpu,660,1,1,83047,128,0,0,0,0,1,10630000
nn_kernel_gpu_mem,11847,1,1,83047,128,85040000,42520000,42520000,85040000,1,10630000
nn_kernel_cpu,7663,0,1,1,64,0,0,0,0,1,10640000
nn_kernel_gpu,659,1,1,83125,128,0,0,0,0,1,10640000
nn_kernel_gpu_mem,17172,1,1,83125,128,85120000,42560000,42560000,85120000,1,10640000
nn_kernel_cpu,26404,0,1,1,64,0,0,0,0,1,10650000
nn_kernel_gpu,657,1,1,83204,128,0,0,0,0,1,10650000
nn_kernel_gpu_mem,15275,1,1,83204,128,85200000,42600000,42600000,85200000,1,10650000
nn_kernel_cpu,9243,0,1,1,64,0,0,0,0,1,10660000
nn_kernel_gpu,658,1,1,83282,128,0,0,0,0,1,10660000
nn_kernel_gpu_mem,15761,1,1,83282,128,85280000,42640000,42640000,85280000,1,10660000
nn_kernel_cpu,26742,0,1,1,64,0,0,0,0,1,10670000
nn_kernel_gpu,660,1,1,83360,128,0,0,0,0,1,10670000
nn_kernel_gpu_mem,15948,1,1,83360,128,85360000,42680000,42680000,85360000,1,10670000
nn_kernel_cpu,19274,0,1,1,64,0,0,0,0,1,10680000
nn_kernel_gpu,667,1,1,83438,128,0,0,0,0,1,10680000
nn_kernel_gpu_mem,14546,1,1,83438,128,85440000,42720000,42720000,85440000,1,10680000
nn_kernel_cpu,12078,0,1,1,64,0,0,0,0,1,10690000
nn_kernel_gpu,677,1,1,83516,128,0,0,0,0,1,10690000
nn_kernel_gpu_mem,16405,1,1,83516,128,85520000,42760000,42760000,85520000,1,10690000
nn_kernel_cpu,29775,0,1,1,64,0,0,0,0,1,10700000
nn_kernel_gpu,671,1,1,83594,128,0,0,0,0,1,10700000
nn_kernel_gpu_mem,15493,1,1,83594,128,85600000,42800000,42800000,85600000,1,10700000
nn_kernel_cpu,13384,0,1,1,64,0,0,0,0,1,1070000
nn_kernel_gpu,111,1,1,8360,128,0,0,0,0,1,1070000
nn_kernel_gpu_mem,2140,1,1,8360,128,8560000,4280000,4280000,8560000,1,1070000
nn_kernel_cpu,23782,0,1,1,64,0,0,0,0,1,10710000
nn_kernel_gpu,674,1,1,83672,128,0,0,0,0,1,10710000
nn_kernel_gpu_mem,15719,1,1,83672,128,85680000,42840000,42840000,85680000,1,10710000
nn_kernel_cpu,23885,0,1,1,64,0,0,0,0,1,10720000
nn_kernel_gpu,676,1,1,83750,128,0,0,0,0,1,10720000
nn_kernel_gpu_mem,16065,1,1,83750,128,85760000,42880000,42880000,85760000,1,10720000
nn_kernel_cpu,19143,0,1,1,64,0,0,0,0,1,10730000
nn_kernel_gpu,704,1,1,83829,128,0,0,0,0,1,10730000
nn_kernel_gpu_mem,13205,1,1,83829,128,85840000,42920000,42920000,85840000,1,10730000
nn_kernel_cpu,23488,0,1,1,64,0,0,0,0,1,10740000
nn_kernel_gpu,711,1,1,83907,128,0,0,0,0,1,10740000
nn_kernel_gpu_mem,15818,1,1,83907,128,85920000,42960000,42960000,85920000,1,10740000
nn_kernel_cpu,9361,0,1,1,64,0,0,0,0,1,10750000
nn_kernel_gpu,684,1,1,83985,128,0,0,0,0,1,10750000
nn_kernel_gpu_mem,15238,1,1,83985,128,86000000,43000000,43000000,86000000,1,10750000
nn_kernel_cpu,11886,0,1,1,64,0,0,0,0,1,10760000
nn_kernel_gpu,665,1,1,84063,128,0,0,0,0,1,10760000
nn_kernel_gpu_mem,15426,1,1,84063,128,86080000,43040000,43040000,86080000,1,10760000
nn_kernel_cpu,24928,0,1,1,64,0,0,0,0,1,10770000
nn_kernel_gpu,684,1,1,84141,128,0,0,0,0,1,10770000
nn_kernel_gpu_mem,15565,1,1,84141,128,86160000,43080000,43080000,86160000,1,10770000
nn_kernel_cpu,9044,0,1,1,64,0,0,0,0,1,10780000
nn_kernel_gpu,687,1,1,84219,128,0,0,0,0,1,10780000
nn_kernel_gpu_mem,16338,1,1,84219,128,86240000,43120000,43120000,86240000,1,10780000
nn_kernel_cpu,20584,0,1,1,64,0,0,0,0,1,10790000
nn_kernel_gpu,671,1,1,84297,128,0,0,0,0,1,10790000
nn_kernel_gpu_mem,15172,1,1,84297,128,86320000,43160000,43160000,86320000,1,10790000
nn_kernel_cpu,14832,0,1,1,64,0,0,0,0,1,10800000
nn_kernel_gpu,663,1,1,84375,128,0,0,0,0,1,10800000
nn_kernel_gpu_mem,24073,1,1,84375,128,86400000,43200000,43200000,86400000,1,10800000
nn_kernel_cpu,17245,0,1,1,64,0,0,0,0,1,1080000
nn_kernel_gpu,128,1,1,8438,128,0,0,0,0,1,1080000
nn_kernel_gpu_mem,2517,1,1,8438,128,8640000,4320000,4320000,8640000,1,1080000
nn_kernel_cpu,8851,0,1,1,64,0,0,0,0,1,10810000
nn_kernel_gpu,666,1,1,84454,128,0,0,0,0,1,10810000
nn_kernel_gpu_mem,16132,1,1,84454,128,86480000,43240000,43240000,86480000,1,10810000
nn_kernel_cpu,14753,0,1,1,64,0,0,0,0,1,10820000
nn_kernel_gpu,688,1,1,84532,128,0,0,0,0,1,10820000
nn_kernel_gpu_mem,15480,1,1,84532,128,86560000,43280000,43280000,86560000,1,10820000
nn_kernel_cpu,10714,0,1,1,64,0,0,0,0,1,10830000
nn_kernel_gpu,682,1,1,84610,128,0,0,0,0,1,10830000
nn_kernel_gpu_mem,11969,1,1,84610,128,86640000,43320000,43320000,86640000,1,10830000
nn_kernel_cpu,20778,0,1,1,64,0,0,0,0,1,10840000
nn_kernel_gpu,687,1,1,84688,128,0,0,0,0,1,10840000
nn_kernel_gpu_mem,14970,1,1,84688,128,86720000,43360000,43360000,86720000,1,10840000
nn_kernel_cpu,15568,0,1,1,64,0,0,0,0,1,10850000
nn_kernel_gpu,671,1,1,84766,128,0,0,0,0,1,10850000
nn_kernel_gpu_mem,18279,1,1,84766,128,86800000,43400000,43400000,86800000,1,10850000
nn_kernel_cpu,5365,0,1,1,64,0,0,0,0,1,10860000
nn_kernel_gpu,685,1,1,84844,128,0,0,0,0,1,10860000
nn_kernel_gpu_mem,12514,1,1,84844,128,86880000,43440000,43440000,86880000,1,10860000
nn_kernel_cpu,7493,0,1,1,64,0,0,0,0,1,10870000
nn_kernel_gpu,686,1,1,84922,128,0,0,0,0,1,10870000
nn_kernel_gpu_mem,15914,1,1,84922,128,86960000,43480000,43480000,86960000,1,10870000
nn_kernel_cpu,17822,0,1,1,64,0,0,0,0,1,10880000
nn_kernel_gpu,679,1,1,85000,128,0,0,0,0,1,10880000
nn_kernel_gpu_mem,12238,1,1,85000,128,87040000,43520000,43520000,87040000,1,10880000
nn_kernel_cpu,9939,0,1,1,64,0,0,0,0,1,10890000
nn_kernel_gpu,675,1,1,85079,128,0,0,0,0,1,10890000
nn_kernel_gpu_mem,17112,1,1,85079,128,87120000,43560000,43560000,87120000,1,10890000
nn_kernel_cpu,25151,0,1,1,64,0,0,0,0,1,10900000
nn_kernel_gpu,677,1,1,85157,128,0,0,0,0,1,10900000
nn_kernel_gpu_mem,15789,1,1,85157,128,87200000,43600000,43600000,87200000,1,10900000
nn_kernel_cpu,3193,0,1,1,64,0,0,0,0,1,1090000
nn_kernel_gpu,111,1,1,8516,128,0,0,0,0,1,1090000
nn_kernel_gpu_mem,2212,1,1,8516,128,8720000,4360000,4360000,8720000,1,1090000
nn_kernel_cpu,22880,0,1,1,64,0,0,0,0,1,10910000
nn_kernel_gpu,682,1,1,85235,128,0,0,0,0,1,10910000
nn_kernel_gpu_mem,23514,1,1,85235,128,87280000,43640000,43640000,87280000,1,10910000
nn_kernel_cpu,23857,0,1,1,64,0,0,0,0,1,10920000
nn_kernel_gpu,673,1,1,85313,128,0,0,0,0,1,10920000
nn_kernel_gpu_mem,16518,1,1,85313,128,87360000,43680000,43680000,87360000,1,10920000
nn_kernel_cpu,8566,0,1,1,64,0,0,0,0,1,10930000
nn_kernel_gpu,697,1,1,85391,128,0,0,0,0,1,10930000
nn_kernel_gpu_mem,15150,1,1,85391,128,87440000,43720000,43720000,87440000,1,10930000
nn_kernel_cpu,14759,0,1,1,64,0,0,0,0,1,10940000
nn_kernel_gpu,682,1,1,85469,128,0,0,0,0,1,10940000
nn_kernel_gpu_mem,19767,1,1,85469,128,87520000,43760000,43760000,87520000,1,10940000
nn_kernel_cpu,35987,0,1,1,64,0,0,0,0,1,10950000
nn_kernel_gpu,689,1,1,85547,128,0,0,0,0,1,10950000
nn_kernel_gpu_mem,16057,1,1,85547,128,87600000,43800000,43800000,87600000,1,10950000
nn_kernel_cpu,24349,0,1,1,64,0,0,0,0,1,10960000
nn_kernel_gpu,692,1,1,85625,128,0,0,0,0,1,10960000
nn_kernel_gpu_mem,16494,1,1,85625,128,87680000,43840000,43840000,87680000,1,10960000
nn_kernel_cpu,7955,0,1,1,64,0,0,0,0,1,10970000
nn_kernel_gpu,691,1,1,85704,128,0,0,0,0,1,10970000
nn_kernel_gpu_mem,15943,1,1,85704,128,87760000,43880000,43880000,87760000,1,10970000
nn_kernel_cpu,20182,0,1,1,64,0,0,0,0,1,10980000
nn_kernel_gpu,698,1,1,85782,128,0,0,0,0,1,10980000
nn_kernel_gpu_mem,17790,1,1,85782,128,87840000,43920000,43920000,87840000,1,10980000
nn_kernel_cpu,11066,0,1,1,64,0,0,0,0,1,10990000
nn_kernel_gpu,689,1,1,85860,128,0,0,0,0,1,10990000
nn_kernel_gpu_mem,16244,1,1,85860,128,87920000,43960000,43960000,87920000,1,10990000
nn_kernel_cpu,25113,0,1,1,64,0,0,0,0,1,11000000
nn_kernel_gpu,689,1,1,85938,128,0,0,0,0,1,11000000
nn_kernel_gpu_mem,16517,1,1,85938,128,88000000,44000000,44000000,88000000,1,11000000
nn_kernel_cpu,15849,0,1,1,64,0,0,0,0,1,1100000
nn_kernel_gpu,115,1,1,8594,128,0,0,0,0,1,1100000
nn_kernel_gpu_mem,5169,1,1,8594,128,8800000,4400000,4400000,8800000,1,1100000
nn_kernel_cpu,8054,0,1,1,64,0,0,0,0,1,110000
nn_kernel_gpu,36,1,1,860,128,0,0,0,0,1,110000
nn_kernel_gpu_mem,222,1,1,860,128,880000,440000,440000,880000,1,110000
nn_kernel_cpu,11666,0,1,1,64,0,0,0,0,1,11010000
nn_kernel_gpu,681,1,1,86016,128,0,0,0,0,1,11010000
nn_kernel_gpu_mem,15982,1,1,86016,128,88080000,44040000,44040000,88080000,1,11010000
nn_kernel_cpu,20223,0,1,1,64,0,0,0,0,1,11020000
nn_kernel_gpu,692,1,1,86094,128,0,0,0,0,1,11020000
nn_kernel_gpu_mem,16162,1,1,86094,128,88160000,44080000,44080000,88160000,1,11020000
nn_kernel_cpu,11311,0,1,1,64,0,0,0,0,1,11030000
nn_kernel_gpu,690,1,1,86172,128,0,0,0,0,1,11030000
nn_kernel_gpu_mem,15800,1,1,86172,128,88240000,44120000,44120000,88240000,1,11030000
nn_kernel_cpu,15000,0,1,1,64,0,0,0,0,1,11040000
nn_kernel_gpu,696,1,1,86250,128,0,0,0,0,1,11040000
nn_kernel_gpu_mem,15652,1,1,86250,128,88320000,44160000,44160000,88320000,1,11040000
nn_kernel_cpu,15408,0,1,1,64,0,0,0,0,1,11050000
nn_kernel_gpu,681,1,1,86329,128,0,0,0,0,1,11050000
nn_kernel_gpu_mem,15764,1,1,86329,128,88400000,44200000,44200000,88400000,1,11050000
nn_kernel_cpu,24255,0,1,1,64,0,0,0,0,1,11060000
nn_kernel_gpu,686,1,1,86407,128,0,0,0,0,1,11060000
nn_kernel_gpu_mem,16263,1,1,86407,128,88480000,44240000,44240000,88480000,1,11060000
nn_kernel_cpu,12927,0,1,1,64,0,0,0,0,1,11070000
nn_kernel_gpu,695,1,1,86485,128,0,0,0,0,1,11070000
nn_kernel_gpu_mem,15610,1,1,86485,128,88560000,44280000,44280000,88560000,1,11070000
nn_kernel_cpu,16881,0,1,1,64,0,0,0,0,1,11080000
nn_kernel_gpu,686,1,1,86563,128,0,0,0,0,1,11080000
nn_kernel_gpu_mem,14602,1,1,86563,128,88640000,44320000,44320000,88640000,1,11080000
nn_kernel_cpu,8405,0,1,1,64,0,0,0,0,1,11090000
nn_kernel_gpu,687,1,1,86641,128,0,0,0,0,1,11090000
nn_kernel_gpu_mem,17787,1,1,86641,128,88720000,44360000,44360000,88720000,1,11090000
nn_kernel_cpu,8925,0,1,1,64,0,0,0,0,1,11100000
nn_kernel_gpu,690,1,1,86719,128,0,0,0,0,1,11100000
nn_kernel_gpu_mem,12410,1,1,86719,128,88800000,44400000,44400000,88800000,1,11100000
nn_kernel_cpu,8411,0,1,1,64,0,0,0,0,1,1110000
nn_kernel_gpu,118,1,1,8672,128,0,0,0,0,1,1110000
nn_kernel_gpu_mem,2156,1,1,8672,128,8880000,4440000,4440000,8880000,1,1110000
nn_kernel_cpu,25979,0,1,1,64,0,0,0,0,1,11110000
nn_kernel_gpu,679,1,1,86797,128,0,0,0,0,1,11110000
nn_kernel_gpu_mem,16390,1,1,86797,128,88880000,44440000,44440000,88880000,1,11110000
nn_kernel_cpu,35411,0,1,1,64,0,0,0,0,1,11120000
nn_kernel_gpu,688,1,1,86875,128,0,0,0,0,1,11120000
nn_kernel_gpu_mem,21672,1,1,86875,128,88960000,44480000,44480000,88960000,1,11120000
nn_kernel_cpu,6393,0,1,1,64,0,0,0,0,1,11130000
nn_kernel_gpu,691,1,1,86954,128,0,0,0,0,1,11130000
nn_kernel_gpu_mem,15414,1,1,86954,128,89040000,44520000,44520000,89040000,1,11130000
nn_kernel_cpu,34185,0,1,1,64,0,0,0,0,1,11140000
nn_kernel_gpu,696,1,1,87032,128,0,0,0,0,1,11140000
nn_kernel_gpu_mem,15648,1,1,87032,128,89120000,44560000,44560000,89120000,1,11140000
nn_kernel_cpu,5868,0,1,1,64,0,0,0,0,1,11150000
nn_kernel_gpu,695,1,1,87110,128,0,0,0,0,1,11150000
nn_kernel_gpu_mem,16784,1,1,87110,128,89200000,44600000,44600000,89200000,1,11150000
nn_kernel_cpu,23534,0,1,1,64,0,0,0,0,1,11160000
nn_kernel_gpu,708,1,1,87188,128,0,0,0,0,1,11160000
nn_kernel_gpu_mem,16017,1,1,87188,128,89280000,44640000,44640000,89280000,1,11160000
nn_kernel_cpu,12674,0,1,1,64,0,0,0,0,1,11170000
nn_kernel_gpu,691,1,1,87266,128,0,0,0,0,1,11170000
nn_kernel_gpu_mem,23252,1,1,87266,128,89360000,44680000,44680000,89360000,1,11170000
nn_kernel_cpu,5974,0,1,1,64,0,0,0,0,1,11180000
nn_kernel_gpu,686,1,1,87344,128,0,0,0,0,1,11180000
nn_kernel_gpu_mem,16371,1,1,87344,128,89440000,44720000,44720000,89440000,1,11180000
nn_kernel_cpu,7777,0,1,1,64,0,0,0,0,1,11190000
nn_kernel_gpu,690,1,1,87422,128,0,0,0,0,1,11190000
nn_kernel_gpu_mem,15490,1,1,87422,128,89520000,44760000,44760000,89520000,1,11190000
nn_kernel_cpu,16821,0,1,1,64,0,0,0,0,1,11200000
nn_kernel_gpu,693,1,1,87500,128,0,0,0,0,1,11200000
nn_kernel_gpu_mem,16227,1,1,87500,128,89600000,44800000,44800000,89600000,1,11200000
nn_kernel_cpu,9141,0,1,1,64,0,0,0,0,1,1120000
nn_kernel_gpu,126,1,1,8750,128,0,0,0,0,1,1120000
nn_kernel_gpu_mem,2689,1,1,8750,128,8960000,4480000,4480000,8960000,1,1120000
nn_kernel_cpu,16474,0,1,1,64,0,0,0,0,1,11210000
nn_kernel_gpu,700,1,1,87579,128,0,0,0,0,1,11210000
nn_kernel_gpu_mem,16483,1,1,87579,128,89680000,44840000,44840000,89680000,1,11210000
nn_kernel_cpu,19823,0,1,1,64,0,0,0,0,1,11220000
nn_kernel_gpu,731,1,1,87657,128,0,0,0,0,1,11220000
nn_kernel_gpu_mem,15387,1,1,87657,128,89760000,44880000,44880000,89760000,1,11220000
nn_kernel_cpu,6613,0,1,1,64,0,0,0,0,1,11230000
nn_kernel_gpu,692,1,1,87735,128,0,0,0,0,1,11230000
nn_kernel_gpu_mem,21545,1,1,87735,128,89840000,44920000,44920000,89840000,1,11230000
nn_kernel_cpu,24354,0,1,1,64,0,0,0,0,1,11240000
nn_kernel_gpu,696,1,1,87813,128,0,0,0,0,1,11240000
nn_kernel_gpu_mem,23259,1,1,87813,128,89920000,44960000,44960000,89920000,1,11240000
nn_kernel_cpu,14712,0,1,1,64,0,0,0,0,1,11250000
nn_kernel_gpu,696,1,1,87891,128,0,0,0,0,1,11250000
nn_kernel_gpu_mem,15564,1,1,87891,128,90000000,45000000,45000000,90000000,1,11250000
nn_kernel_cpu,8510,0,1,1,64,0,0,0,0,1,11260000
nn_kernel_gpu,689,1,1,87969,128,0,0,0,0,1,11260000
nn_kernel_gpu_mem,17502,1,1,87969,128,90080000,45040000,45040000,90080000,1,11260000
nn_kernel_cpu,25705,0,1,1,64,0,0,0,0,1,11270000
nn_kernel_gpu,713,1,1,88047,128,0,0,0,0,1,11270000
nn_kernel_gpu_mem,15777,1,1,88047,128,90160000,45080000,45080000,90160000,1,11270000
nn_kernel_cpu,14368,0,1,1,64,0,0,0,0,1,11280000
nn_kernel_gpu,704,1,1,88125,128,0,0,0,0,1,11280000
nn_kernel_gpu_mem,16527,1,1,88125,128,90240000,45120000,45120000,90240000,1,11280000
nn_kernel_cpu,7479,0,1,1,64,0,0,0,0,1,11290000
nn_kernel_gpu,727,1,1,88204,128,0,0,0,0,1,11290000
nn_kernel_gpu_mem,16586,1,1,88204,128,90320000,45160000,45160000,90320000,1,11290000
nn_kernel_cpu,10867,0,1,1,64,0,0,0,0,1,11300000
nn_kernel_gpu,703,1,1,88282,128,0,0,0,0,1,11300000
nn_kernel_gpu_mem,16701,1,1,88282,128,90400000,45200000,45200000,90400000,1,11300000
nn_kernel_cpu,4078,0,1,1,64,0,0,0,0,1,1130000
nn_kernel_gpu,114,1,1,8829,128,0,0,0,0,1,1130000
nn_kernel_gpu_mem,3959,1,1,8829,128,9040000,4520000,4520000,9040000,1,1130000
nn_kernel_cpu,18361,0,1,1,64,0,0,0,0,1,11310000
nn_kernel_gpu,709,1,1,88360,128,0,0,0,0,1,11310000
nn_kernel_gpu_mem,17650,1,1,88360,128,90480000,45240000,45240000,90480000,1,11310000
nn_kernel_cpu,9424,0,1,1,64,0,0,0,0,1,11320000
nn_kernel_gpu,738,1,1,88438,128,0,0,0,0,1,11320000
nn_kernel_gpu_mem,19341,1,1,88438,128,90560000,45280000,45280000,90560000,1,11320000
nn_kernel_cpu,10583,0,1,1,64,0,0,0,0,1,11330000
nn_kernel_gpu,705,1,1,88516,128,0,0,0,0,1,11330000
nn_kernel_gpu_mem,12990,1,1,88516,128,90640000,45320000,45320000,90640000,1,11330000
nn_kernel_cpu,8247,0,1,1,64,0,0,0,0,1,11340000
nn_kernel_gpu,713,1,1,88594,128,0,0,0,0,1,11340000
nn_kernel_gpu_mem,17263,1,1,88594,128,90720000,45360000,45360000,90720000,1,11340000
nn_kernel_cpu,14010,0,1,1,64,0,0,0,0,1,11350000
nn_kernel_gpu,704,1,1,88672,128,0,0,0,0,1,11350000
nn_kernel_gpu_mem,22173,1,1,88672,128,90800000,45400000,45400000,90800000,1,11350000
nn_kernel_cpu,8894,0,1,1,64,0,0,0,0,1,11360000
nn_kernel_gpu,711,1,1,88750,128,0,0,0,0,1,11360000
nn_kernel_gpu_mem,16458,1,1,88750,128,90880000,45440000,45440000,90880000,1,11360000
nn_kernel_cpu,10104,0,1,1,64,0,0,0,0,1,11370000
nn_kernel_gpu,711,1,1,88829,128,0,0,0,0,1,11370000
nn_kernel_gpu_mem,16042,1,1,88829,128,90960000,45480000,45480000,90960000,1,11370000
nn_kernel_cpu,12033,0,1,1,64,0,0,0,0,1,11380000
nn_kernel_gpu,706,1,1,88907,128,0,0,0,0,1,11380000
nn_kernel_gpu_mem,18988,1,1,88907,128,91040000,45520000,45520000,91040000,1,11380000
nn_kernel_cpu,11240,0,1,1,64,0,0,0,0,1,11390000
nn_kernel_gpu,724,1,1,88985,128,0,0,0,0,1,11390000
nn_kernel_gpu_mem,16062,1,1,88985,128,91120000,45560000,45560000,91120000,1,11390000
nn_kernel_cpu,11487,0,1,1,64,0,0,0,0,1,11400000
nn_kernel_gpu,713,1,1,89063,128,0,0,0,0,1,11400000
nn_kernel_gpu_mem,16446,1,1,89063,128,91200000,45600000,45600000,91200000,1,11400000
nn_kernel_cpu,7717,0,1,1,64,0,0,0,0,1,1140000
nn_kernel_gpu,120,1,1,8907,128,0,0,0,0,1,1140000
nn_kernel_gpu_mem,3255,1,1,8907,128,9120000,4560000,4560000,9120000,1,1140000
nn_kernel_cpu,8862,0,1,1,64,0,0,0,0,1,11410000
nn_kernel_gpu,715,1,1,89141,128,0,0,0,0,1,11410000
nn_kernel_gpu_mem,12958,1,1,89141,128,91280000,45640000,45640000,91280000,1,11410000
nn_kernel_cpu,20936,0,1,1,64,0,0,0,0,1,11420000
nn_kernel_gpu,702,1,1,89219,128,0,0,0,0,1,11420000
nn_kernel_gpu_mem,17692,1,1,89219,128,91360000,45680000,45680000,91360000,1,11420000
nn_kernel_cpu,27886,0,1,1,64,0,0,0,0,1,11430000
nn_kernel_gpu,711,1,1,89297,128,0,0,0,0,1,11430000
nn_kernel_gpu_mem,23790,1,1,89297,128,91440000,45720000,45720000,91440000,1,11430000
nn_kernel_cpu,15838,0,1,1,64,0,0,0,0,1,11440000
nn_kernel_gpu,706,1,1,89375,128,0,0,0,0,1,11440000
nn_kernel_gpu_mem,22191,1,1,89375,128,91520000,45760000,45760000,91520000,1,11440000
nn_kernel_cpu,24224,0,1,1,64,0,0,0,0,1,11450000
nn_kernel_gpu,710,1,1,89454,128,0,0,0,0,1,11450000
nn_kernel_gpu_mem,16258,1,1,89454,128,91600000,45800000,45800000,91600000,1,11450000
nn_kernel_cpu,35752,0,1,1,64,0,0,0,0,1,11460000
nn_kernel_gpu,719,1,1,89532,128,0,0,0,0,1,11460000
nn_kernel_gpu_mem,16935,1,1,89532,128,91680000,45840000,45840000,91680000,1,11460000
nn_kernel_cpu,13761,0,1,1,64,0,0,0,0,1,11470000
nn_kernel_gpu,707,1,1,89610,128,0,0,0,0,1,11470000
nn_kernel_gpu_mem,12771,1,1,89610,128,91760000,45880000,45880000,91760000,1,11470000
nn_kernel_cpu,10019,0,1,1,64,0,0,0,0,1,11480000
nn_kernel_gpu,709,1,1,89688,128,0,0,0,0,1,11480000
nn_kernel_gpu_mem,16413,1,1,89688,128,91840000,45920000,45920000,91840000,1,11480000
nn_kernel_cpu,22670,0,1,1,64,0,0,0,0,1,11490000
nn_kernel_gpu,717,1,1,89766,128,0,0,0,0,1,11490000
nn_kernel_gpu_mem,16921,1,1,89766,128,91920000,45960000,45960000,91920000,1,11490000
nn_kernel_cpu,11130,0,1,1,64,0,0,0,0,1,11500000
nn_kernel_gpu,714,1,1,89844,128,0,0,0,0,1,11500000
nn_kernel_gpu_mem,12810,1,1,89844,128,92000000,46000000,46000000,92000000,1,11500000
nn_kernel_cpu,4307,0,1,1,64,0,0,0,0,1,1150000
nn_kernel_gpu,114,1,1,8985,128,0,0,0,0,1,1150000
nn_kernel_gpu_mem,4405,1,1,8985,128,9200000,4600000,4600000,9200000,1,1150000
nn_kernel_cpu,23600,0,1,1,64,0,0,0,0,1,11510000
nn_kernel_gpu,719,1,1,89922,128,0,0,0,0,1,11510000
nn_kernel_gpu_mem,16333,1,1,89922,128,92080000,46040000,46040000,92080000,1,11510000
nn_kernel_cpu,11652,0,1,1,64,0,0,0,0,1,11520000
nn_kernel_gpu,707,1,1,90000,128,0,0,0,0,1,11520000
nn_kernel_gpu_mem,15948,1,1,90000,128,92160000,46080000,46080000,92160000,1,11520000
nn_kernel_cpu,7789,0,1,1,64,0,0,0,0,1,11530000
nn_kernel_gpu,715,1,1,90079,128,0,0,0,0,1,11530000
nn_kernel_gpu_mem,13558,1,1,90079,128,92240000,46120000,46120000,92240000,1,11530000
nn_kernel_cpu,45289,0,1,1,64,0,0,0,0,1,11540000
nn_kernel_gpu,724,1,1,90157,128,0,0,0,0,1,11540000
nn_kernel_gpu_mem,15402,1,1,90157,128,92320000,46160000,46160000,92320000,1,11540000
nn_kernel_cpu,17016,0,1,1,64,0,0,0,0,1,11550000
nn_kernel_gpu,719,1,1,90235,128,0,0,0,0,1,11550000
nn_kernel_gpu_mem,17154,1,1,90235,128,92400000,46200000,46200000,92400000,1,11550000
nn_kernel_cpu,7808,0,1,1,64,0,0,0,0,1,11560000
nn_kernel_gpu,724,1,1,90313,128,0,0,0,0,1,11560000
nn_kernel_gpu_mem,17091,1,1,90313,128,92480000,46240000,46240000,92480000,1,11560000
nn_kernel_cpu,12967,0,1,1,64,0,0,0,0,1,11570000
nn_kernel_gpu,725,1,1,90391,128,0,0,0,0,1,11570000
nn_kernel_gpu_mem,18282,1,1,90391,128,92560000,46280000,46280000,92560000,1,11570000
nn_kernel_cpu,18872,0,1,1,64,0,0,0,0,1,11580000
nn_kernel_gpu,715,1,1,90469,128,0,0,0,0,1,11580000
nn_kernel_gpu_mem,18239,1,1,90469,128,92640000,46320000,46320000,92640000,1,11580000
nn_kernel_cpu,6390,0,1,1,64,0,0,0,0,1,11590000
nn_kernel_gpu,725,1,1,90547,128,0,0,0,0,1,11590000
nn_kernel_gpu_mem,13465,1,1,90547,128,92720000,46360000,46360000,92720000,1,11590000
nn_kernel_cpu,30851,0,1,1,64,0,0,0,0,1,11600000
nn_kernel_gpu,721,1,1,90625,128,0,0,0,0,1,11600000
nn_kernel_gpu_mem,13490,1,1,90625,128,92800000,46400000,46400000,92800000,1,11600000
nn_kernel_cpu,4768,0,1,1,64,0,0,0,0,1,1160000
nn_kernel_gpu,122,1,1,9063,128,0,0,0,0,1,1160000
nn_kernel_gpu_mem,2104,1,1,9063,128,9280000,4640000,4640000,9280000,1,1160000
nn_kernel_cpu,11936,0,1,1,64,0,0,0,0,1,11610000
nn_kernel_gpu,737,1,1,90704,128,0,0,0,0,1,11610000
nn_kernel_gpu_mem,17504,1,1,90704,128,92880000,46440000,46440000,92880000,1,11610000
nn_kernel_cpu,12668,0,1,1,64,0,0,0,0,1,11620000
nn_kernel_gpu,744,1,1,90782,128,0,0,0,0,1,11620000
nn_kernel_gpu_mem,16863,1,1,90782,128,92960000,46480000,46480000,92960000,1,11620000
nn_kernel_cpu,23004,0,1,1,64,0,0,0,0,1,11630000
nn_kernel_gpu,731,1,1,90860,128,0,0,0,0,1,11630000
nn_kernel_gpu_mem,13050,1,1,90860,128,93040000,46520000,46520000,93040000,1,11630000
nn_kernel_cpu,23172,0,1,1,64,0,0,0,0,1,11640000
nn_kernel_gpu,733,1,1,90938,128,0,0,0,0,1,11640000
nn_kernel_gpu_mem,23437,1,1,90938,128,93120000,46560000,46560000,93120000,1,11640000
nn_kernel_cpu,21767,0,1,1,64,0,0,0,0,1,11650000
nn_kernel_gpu,724,1,1,91016,128,0,0,0,0,1,11650000
nn_kernel_gpu_mem,13011,1,1,91016,128,93200000,46600000,46600000,93200000,1,11650000
nn_kernel_cpu,16522,0,1,1,64,0,0,0,0,1,11660000
nn_kernel_gpu,731,1,1,91094,128,0,0,0,0,1,11660000
nn_kernel_gpu_mem,22859,1,1,91094,128,93280000,46640000,46640000,93280000,1,11660000
nn_kernel_cpu,17417,0,1,1,64,0,0,0,0,1,11670000
nn_kernel_gpu,727,1,1,91172,128,0,0,0,0,1,11670000
nn_kernel_gpu_mem,13063,1,1,91172,128,93360000,46680000,46680000,93360000,1,11670000
nn_kernel_cpu,18008,0,1,1,64,0,0,0,0,1,11680000
nn_kernel_gpu,730,1,1,91250,128,0,0,0,0,1,11680000
nn_kernel_gpu_mem,16805,1,1,91250,128,93440000,46720000,46720000,93440000,1,11680000
nn_kernel_cpu,11315,0,1,1,64,0,0,0,0,1,11690000
nn_kernel_gpu,765,1,1,91329,128,0,0,0,0,1,11690000
nn_kernel_gpu_mem,16533,1,1,91329,128,93520000,46760000,46760000,93520000,1,11690000
nn_kernel_cpu,15867,0,1,1,64,0,0,0,0,1,11700000
nn_kernel_gpu,721,1,1,91407,128,0,0,0,0,1,11700000
nn_kernel_gpu_mem,19104,1,1,91407,128,93600000,46800000,46800000,93600000,1,11700000
nn_kernel_cpu,17480,0,1,1,64,0,0,0,0,1,1170000
nn_kernel_gpu,128,1,1,9141,128,0,0,0,0,1,1170000
nn_kernel_gpu_mem,2269,1,1,9141,128,9360000,4680000,4680000,9360000,1,1170000
nn_kernel_cpu,14019,0,1,1,64,0,0,0,0,1,11710000
nn_kernel_gpu,731,1,1,91485,128,0,0,0,0,1,11710000
nn_kernel_gpu_mem,16885,1,1,91485,128,93680000,46840000,46840000,93680000,1,11710000
nn_kernel_cpu,22750,0,1,1,64,0,0,0,0,1,11720000
nn_kernel_gpu,735,1,1,91563,128,0,0,0,0,1,11720000
nn_kernel_gpu_mem,16821,1,1,91563,128,93760000,46880000,46880000,93760000,1,11720000
nn_kernel_cpu,23442,0,1,1,64,0,0,0,0,1,11730000
nn_kernel_gpu,751,1,1,91641,128,0,0,0,0,1,11730000
nn_kernel_gpu_mem,16919,1,1,91641,128,93840000,46920000,46920000,93840000,1,11730000
nn_kernel_cpu,18339,0,1,1,64,0,0,0,0,1,11740000
nn_kernel_gpu,734,1,1,91719,128,0,0,0,0,1,11740000
nn_kernel_gpu_mem,17681,1,1,91719,128,93920000,46960000,46960000,93920000,1,11740000
nn_kernel_cpu,28596,0,1,1,64,0,0,0,0,1,11750000
nn_kernel_gpu,730,1,1,91797,128,0,0,0,0,1,11750000
nn_kernel_gpu_mem,15953,1,1,91797,128,94000000,47000000,47000000,94000000,1,11750000
nn_kernel_cpu,17578,0,1,1,64,0,0,0,0,1,11760000
nn_kernel_gpu,738,1,1,91875,128,0,0,0,0,1,11760000
nn_kernel_gpu_mem,22374,1,1,91875,128,94080000,47040000,47040000,94080000,1,11760000
nn_kernel_cpu,8772,0,1,1,64,0,0,0,0,1,11770000
nn_kernel_gpu,733,1,1,91954,128,0,0,0,0,1,11770000
nn_kernel_gpu_mem,13416,1,1,91954,128,94160000,47080000,47080000,94160000,1,11770000
nn_kernel_cpu,9501,0,1,1,64,0,0,0,0,1,11780000
nn_kernel_gpu,730,1,1,92032,128,0,0,0,0,1,11780000
nn_kernel_gpu_mem,16367,1,1,92032,128,94240000,47120000,47120000,94240000,1,11780000
nn_kernel_cpu,24621,0,1,1,64,0,0,0,0,1,11790000
nn_kernel_gpu,727,1,1,92110,128,0,0,0,0,1,11790000
nn_kernel_gpu_mem,18140,1,1,92110,128,94320000,47160000,47160000,94320000,1,11790000
nn_kernel_cpu,9252,0,1,1,64,0,0,0,0,1,11800000
nn_kernel_gpu,758,1,1,92188,128,0,0,0,0,1,11800000
nn_kernel_gpu_mem,22867,1,1,92188,128,94400000,47200000,47200000,94400000,1,11800000
nn_kernel_cpu,8610,0,1,1,64,0,0,0,0,1,1180000
nn_kernel_gpu,121,1,1,9219,128,0,0,0,0,1,1180000
nn_kernel_gpu_mem,3426,1,1,9219,128,9440000,4720000,4720000,9440000,1,1180000
nn_kernel_cpu,16760,0,1,1,64,0,0,0,0,1,11810000
nn_kernel_gpu,740,1,1,92266,128,0,0,0,0,1,11810000
nn_kernel_gpu_mem,20403,1,1,92266,128,94480000,47240000,47240000,94480000,1,11810000
nn_kernel_cpu,22621,0,1,1,64,0,0,0,0,1,11820000
nn_kernel_gpu,743,1,1,92344,128,0,0,0,0,1,11820000
nn_kernel_gpu_mem,18430,1,1,92344,128,94560000,47280000,47280000,94560000,1,11820000
nn_kernel_cpu,10838,0,1,1,64,0,0,0,0,1,11830000
nn_kernel_gpu,736,1,1,92422,128,0,0,0,0,1,11830000
nn_kernel_gpu_mem,13171,1,1,92422,128,94640000,47320000,47320000,94640000,1,11830000
nn_kernel_cpu,16166,0,1,1,64,0,0,0,0,1,11840000
nn_kernel_gpu,731,1,1,92500,128,0,0,0,0,1,11840000
nn_kernel_gpu_mem,13448,1,1,92500,128,94720000,47360000,47360000,94720000,1,11840000
nn_kernel_cpu,9750,0,1,1,64,0,0,0,0,1,11850000
nn_kernel_gpu,732,1,1,92579,128,0,0,0,0,1,11850000
nn_kernel_gpu_mem,12964,1,1,92579,128,94800000,47400000,47400000,94800000,1,11850000
nn_kernel_cpu,23313,0,1,1,64,0,0,0,0,1,11860000
nn_kernel_gpu,734,1,1,92657,128,0,0,0,0,1,11860000
nn_kernel_gpu_mem,16439,1,1,92657,128,94880000,47440000,47440000,94880000,1,11860000
nn_kernel_cpu,18320,0,1,1,64,0,0,0,0,1,11870000
nn_kernel_gpu,730,1,1,92735,128,0,0,0,0,1,11870000
nn_kernel_gpu_mem,15458,1,1,92735,128,94960000,47480000,47480000,94960000,1,11870000
nn_kernel_cpu,8944,0,1,1,64,0,0,0,0,1,11880000
nn_kernel_gpu,739,1,1,92813,128,0,0,0,0,1,11880000
nn_kernel_gpu_mem,18984,1,1,92813,128,95040000,47520000,47520000,95040000,1,11880000
nn_kernel_cpu,22288,0,1,1,64,0,0,0,0,1,11890000
nn_kernel_gpu,739,1,1,92891,128,0,0,0,0,1,11890000
nn_kernel_gpu_mem,13755,1,1,92891,128,95120000,47560000,47560000,95120000,1,11890000
nn_kernel_cpu,16158,0,1,1,64,0,0,0,0,1,11900000
nn_kernel_gpu,773,1,1,92969,128,0,0,0,0,1,11900000
nn_kernel_gpu_mem,23056,1,1,92969,128,95200000,47600000,47600000,95200000,1,11900000
nn_kernel_cpu,2688,0,1,1,64,0,0,0,0,1,1190000
nn_kernel_gpu,118,1,1,9297,128,0,0,0,0,1,1190000
nn_kernel_gpu_mem,2208,1,1,9297,128,9520000,4760000,4760000,9520000,1,1190000
nn_kernel_cpu,10576,0,1,1,64,0,0,0,0,1,11910000
nn_kernel_gpu,743,1,1,93047,128,0,0,0,0,1,11910000
nn_kernel_gpu_mem,16953,1,1,93047,128,95280000,47640000,47640000,95280000,1,11910000
nn_kernel_cpu,9865,0,1,1,64,0,0,0,0,1,11920000
nn_kernel_gpu,735,1,1,93125,128,0,0,0,0,1,11920000
nn_kernel_gpu_mem,19786,1,1,93125,128,95360000,47680000,47680000,95360000,1,11920000
nn_kernel_cpu,13933,0,1,1,64,0,0,0,0,1,11930000
nn_kernel_gpu,742,1,1,93204,128,0,0,0,0,1,11930000
nn_kernel_gpu_mem,13606,1,1,93204,128,95440000,47720000,47720000,95440000,1,11930000
nn_kernel_cpu,14716,0,1,1,64,0,0,0,0,1,11940000
nn_kernel_gpu,756,1,1,93282,128,0,0,0,0,1,11940000
nn_kernel_gpu_mem,17053,1,1,93282,128,95520000,47760000,47760000,95520000,1,11940000
nn_kernel_cpu,16716,0,1,1,64,0,0,0,0,1,11950000
nn_kernel_gpu,775,1,1,93360,128,0,0,0,0,1,11950000
nn_kernel_gpu_mem,17563,1,1,93360,128,95600000,47800000,47800000,95600000,1,11950000
nn_kernel_cpu,7221,0,1,1,64,0,0,0,0,1,11960000
nn_kernel_gpu,759,1,1,93438,128,0,0,0,0,1,11960000
nn_kernel_gpu_mem,17092,1,1,93438,128,95680000,47840000,47840000,95680000,1,11960000
nn_kernel_cpu,19729,0,1,1,64,0,0,0,0,1,11970000
nn_kernel_gpu,759,1,1,93516,128,0,0,0,0,1,11970000
nn_kernel_gpu_mem,18037,1,1,93516,128,95760000,47880000,47880000,95760000,1,11970000
nn_kernel_cpu,26592,0,1,1,64,0,0,0,0,1,11980000
nn_kernel_gpu,750,1,1,93594,128,0,0,0,0,1,11980000
nn_kernel_gpu_mem,16364,1,1,93594,128,95840000,47920000,47920000,95840000,1,11980000
nn_kernel_cpu,9882,0,1,1,64,0,0,0,0,1,11990000
nn_kernel_gpu,753,1,1,93672,128,0,0,0,0,1,11990000
nn_kernel_gpu_mem,18214,1,1,93672,128,95920000,47960000,47960000,95920000,1,11990000
nn_kernel_cpu,9926,0,1,1,64,0,0,0,0,1,12000000
nn_kernel_gpu,741,1,1,93750,128,0,0,0,0,1,12000000
nn_kernel_gpu_mem,17749,1,1,93750,128,96000000,48000000,48000000,96000000,1,12000000
nn_kernel_cpu,16142,0,1,1,64,0,0,0,0,1,1200000
nn_kernel_gpu,123,1,1,9375,128,0,0,0,0,1,1200000
nn_kernel_gpu_mem,2190,1,1,9375,128,9600000,4800000,4800000,9600000,1,1200000
nn_kernel_cpu,8391,0,1,1,64,0,0,0,0,1,120000
nn_kernel_gpu,49,1,1,938,128,0,0,0,0,1,120000
nn_kernel_gpu_mem,378,1,1,938,128,960000,480000,480000,960000,1,120000
nn_kernel_cpu,11236,0,1,1,64,0,0,0,0,1,12010000
nn_kernel_gpu,752,1,1,93829,128,0,0,0,0,1,12010000
nn_kernel_gpu_mem,23656,1,1,93829,128,96080000,48040000,48040000,96080000,1,12010000
nn_kernel_cpu,13642,0,1,1,64,0,0,0,0,1,12020000
nn_kernel_gpu,754,1,1,93907,128,0,0,0,0,1,12020000
nn_kernel_gpu_mem,17566,1,1,93907,128,96160000,48080000,48080000,96160000,1,12020000
nn_kernel_cpu,16154,0,1,1,64,0,0,0,0,1,12030000
nn_kernel_gpu,755,1,1,93985,128,0,0,0,0,1,12030000
nn_kernel_gpu_mem,17884,1,1,93985,128,96240000,48120000,48120000,96240000,1,12030000
nn_kernel_cpu,16525,0,1,1,64,0,0,0,0,1,12040000
nn_kernel_gpu,752,1,1,94063,128,0,0,0,0,1,12040000
nn_kernel_gpu_mem,27489,1,1,94063,128,96320000,48160000,48160000,96320000,1,12040000
nn_kernel_cpu,27667,0,1,1,64,0,0,0,0,1,12050000
nn_kernel_gpu,751,1,1,94141,128,0,0,0,0,1,12050000
nn_kernel_gpu_mem,18233,1,1,94141,128,96400000,48200000,48200000,96400000,1,12050000
nn_kernel_cpu,30864,0,1,1,64,0,0,0,0,1,12060000
nn_kernel_gpu,761,1,1,94219,128,0,0,0,0,1,12060000
nn_kernel_gpu_mem,15017,1,1,94219,128,96480000,48240000,48240000,96480000,1,12060000
nn_kernel_cpu,17587,0,1,1,64,0,0,0,0,1,12070000
nn_kernel_gpu,737,1,1,94297,128,0,0,0,0,1,12070000
nn_kernel_gpu_mem,15804,1,1,94297,128,96560000,48280000,48280000,96560000,1,12070000
nn_kernel_cpu,12991,0,1,1,64,0,0,0,0,1,12080000
nn_kernel_gpu,753,1,1,94375,128,0,0,0,0,1,12080000
nn_kernel_gpu_mem,17588,1,1,94375,128,96640000,48320000,48320000,96640000,1,12080000
nn_kernel_cpu,26090,0,1,1,64,0,0,0,0,1,12090000
nn_kernel_gpu,758,1,1,94454,128,0,0,0,0,1,12090000
nn_kernel_gpu_mem,17823,1,1,94454,128,96720000,48360000,48360000,96720000,1,12090000
nn_kernel_cpu,35942,0,1,1,64,0,0,0,0,1,12100000
nn_kernel_gpu,749,1,1,94532,128,0,0,0,0,1,12100000
nn_kernel_gpu_mem,14083,1,1,94532,128,96800000,48400000,48400000,96800000,1,12100000
nn_kernel_cpu,5809,0,1,1,64,0,0,0,0,1,1210000
nn_kernel_gpu,132,1,1,9454,128,0,0,0,0,1,1210000
nn_kernel_gpu_mem,5750,1,1,9454,128,9680000,4840000,4840000,9680000,1,1210000
nn_kernel_cpu,15138,0,1,1,64,0,0,0,0,1,12110000
nn_kernel_gpu,755,1,1,94610,128,0,0,0,0,1,12110000
nn_kernel_gpu_mem,17819,1,1,94610,128,96880000,48440000,48440000,96880000,1,12110000
nn_kernel_cpu,20501,0,1,1,64,0,0,0,0,1,12120000
nn_kernel_gpu,753,1,1,94688,128,0,0,0,0,1,12120000
nn_kernel_gpu_mem,14106,1,1,94688,128,96960000,48480000,48480000,96960000,1,12120000
nn_kernel_cpu,20207,0,1,1,64,0,0,0,0,1,12130000
nn_kernel_gpu,749,1,1,94766,128,0,0,0,0,1,12130000
nn_kernel_gpu_mem,17371,1,1,94766,128,97040000,48520000,48520000,97040000,1,12130000
nn_kernel_cpu,35061,0,1,1,64,0,0,0,0,1,12140000
nn_kernel_gpu,762,1,1,94844,128,0,0,0,0,1,12140000
nn_kernel_gpu_mem,17552,1,1,94844,128,97120000,48560000,48560000,97120000,1,12140000
nn_kernel_cpu,9483,0,1,1,64,0,0,0,0,1,12150000
nn_kernel_gpu,757,1,1,94922,128,0,0,0,0,1,12150000
nn_kernel_gpu_mem,14178,1,1,94922,128,97200000,48600000,48600000,97200000,1,12150000
nn_kernel_cpu,40926,0,1,1,64,0,0,0,0,1,12160000
nn_kernel_gpu,755,1,1,95000,128,0,0,0,0,1,12160000
nn_kernel_gpu_mem,19114,1,1,95000,128,97280000,48640000,48640000,97280000,1,12160000
nn_kernel_cpu,24166,0,1,1,64,0,0,0,0,1,12170000
nn_kernel_gpu,762,1,1,95079,128,0,0,0,0,1,12170000
nn_kernel_gpu_mem,17080,1,1,95079,128,97360000,48680000,48680000,97360000,1,12170000
nn_kernel_cpu,19906,0,1,1,64,0,0,0,0,1,12180000
nn_kernel_gpu,792,1,1,95157,128,0,0,0,0,1,12180000
nn_kernel_gpu_mem,18046,1,1,95157,128,97440000,48720000,48720000,97440000,1,12180000
nn_kernel_cpu,13172,0,1,1,64,0,0,0,0,1,12190000
nn_kernel_gpu,775,1,1,95235,128,0,0,0,0,1,12190000
nn_kernel_gpu_mem,17106,1,1,95235,128,97520000,48760000,48760000,97520000,1,12190000
nn_kernel_cpu,23777,0,1,1,64,0,0,0,0,1,12200000
nn_kernel_gpu,767,1,1,95313,128,0,0,0,0,1,12200000
nn_kernel_gpu_mem,17521,1,1,95313,128,97600000,48800000,48800000,97600000,1,12200000
nn_kernel_cpu,5730,0,1,1,64,0,0,0,0,1,1220000
nn_kernel_gpu,121,1,1,9532,128,0,0,0,0,1,1220000
nn_kernel_gpu_mem,2329,1,1,9532,128,9760000,4880000,4880000,9760000,1,1220000
nn_kernel_cpu,23403,0,1,1,64,0,0,0,0,1,12210000
nn_kernel_gpu,756,1,1,95391,128,0,0,0,0,1,12210000
nn_kernel_gpu_mem,16831,1,1,95391,128,97680000,48840000,48840000,97680000,1,12210000
nn_kernel_cpu,23561,0,1,1,64,0,0,0,0,1,12220000
nn_kernel_gpu,762,1,1,95469,128,0,0,0,0,1,12220000
nn_kernel_gpu_mem,18204,1,1,95469,128,97760000,48880000,48880000,97760000,1,12220000
nn_kernel_cpu,37211,0,1,1,64,0,0,0,0,1,12230000
nn_kernel_gpu,756,1,1,95547,128,0,0,0,0,1,12230000
nn_kernel_gpu_mem,17573,1,1,95547,128,97840000,48920000,48920000,97840000,1,12230000
nn_kernel_cpu,15620,0,1,1,64,0,0,0,0,1,12240000
nn_kernel_gpu,760,1,1,95625,128,0,0,0,0,1,12240000
nn_kernel_gpu_mem,17365,1,1,95625,128,97920000,48960000,48960000,97920000,1,12240000
nn_kernel_cpu,20931,0,1,1,64,0,0,0,0,1,12250000
nn_kernel_gpu,750,1,1,95704,128,0,0,0,0,1,12250000
nn_kernel_gpu_mem,16914,1,1,95704,128,98000000,49000000,49000000,98000000,1,12250000
nn_kernel_cpu,23416,0,1,1,64,0,0,0,0,1,12260000
nn_kernel_gpu,759,1,1,95782,128,0,0,0,0,1,12260000
nn_kernel_gpu_mem,14096,1,1,95782,128,98080000,49040000,49040000,98080000,1,12260000
nn_kernel_cpu,23529,0,1,1,64,0,0,0,0,1,12270000
nn_kernel_gpu,761,1,1,95860,128,0,0,0,0,1,12270000
nn_kernel_gpu_mem,18367,1,1,95860,128,98160000,49080000,49080000,98160000,1,12270000
nn_kernel_cpu,21062,0,1,1,64,0,0,0,0,1,12280000
nn_kernel_gpu,761,1,1,95938,128,0,0,0,0,1,12280000
nn_kernel_gpu_mem,18489,1,1,95938,128,98240000,49120000,49120000,98240000,1,12280000
nn_kernel_cpu,8747,0,1,1,64,0,0,0,0,1,12290000
nn_kernel_gpu,798,1,1,96016,128,0,0,0,0,1,12290000
nn_kernel_gpu_mem,17804,1,1,96016,128,98320000,49160000,49160000,98320000,1,12290000
nn_kernel_cpu,12910,0,1,1,64,0,0,0,0,1,12300000
nn_kernel_gpu,755,1,1,96094,128,0,0,0,0,1,12300000
nn_kernel_gpu_mem,17487,1,1,96094,128,98400000,49200000,49200000,98400000,1,12300000
nn_kernel_cpu,3098,0,1,1,64,0,0,0,0,1,1230000
nn_kernel_gpu,145,1,1,9610,128,0,0,0,0,1,1230000
nn_kernel_gpu_mem,2519,1,1,9610,128,9840000,4920000,4920000,9840000,1,1230000
nn_kernel_cpu,25583,0,1,1,64,0,0,0,0,1,12310000
nn_kernel_gpu,778,1,1,96172,128,0,0,0,0,1,12310000
nn_kernel_gpu_mem,17476,1,1,96172,128,98480000,49240000,49240000,98480000,1,12310000
nn_kernel_cpu,9775,0,1,1,64,0,0,0,0,1,12320000
nn_kernel_gpu,772,1,1,96250,128,0,0,0,0,1,12320000
nn_kernel_gpu_mem,17575,1,1,96250,128,98560000,49280000,49280000,98560000,1,12320000
nn_kernel_cpu,23646,0,1,1,64,0,0,0,0,1,12330000
nn_kernel_gpu,769,1,1,96329,128,0,0,0,0,1,12330000
nn_kernel_gpu_mem,17435,1,1,96329,128,98640000,49320000,49320000,98640000,1,12330000
nn_kernel_cpu,12039,0,1,1,64,0,0,0,0,1,12340000
nn_kernel_gpu,769,1,1,96407,128,0,0,0,0,1,12340000
nn_kernel_gpu_mem,17819,1,1,96407,128,98720000,49360000,49360000,98720000,1,12340000
nn_kernel_cpu,32604,0,1,1,64,0,0,0,0,1,12350000
nn_kernel_gpu,765,1,1,96485,128,0,0,0,0,1,12350000
nn_kernel_gpu_mem,14389,1,1,96485,128,98800000,49400000,49400000,98800000,1,12350000
nn_kernel_cpu,11112,0,1,1,64,0,0,0,0,1,12360000
nn_kernel_gpu,778,1,1,96563,128,0,0,0,0,1,12360000
nn_kernel_gpu_mem,17830,1,1,96563,128,98880000,49440000,49440000,98880000,1,12360000
nn_kernel_cpu,8970,0,1,1,64,0,0,0,0,1,12370000
nn_kernel_gpu,771,1,1,96641,128,0,0,0,0,1,12370000
nn_kernel_gpu_mem,18449,1,1,96641,128,98960000,49480000,49480000,98960000,1,12370000
nn_kernel_cpu,40969,0,1,1,64,0,0,0,0,1,12380000
nn_kernel_gpu,767,1,1,96719,128,0,0,0,0,1,12380000
nn_kernel_gpu_mem,18338,1,1,96719,128,99040000,49520000,49520000,99040000,1,12380000
nn_kernel_cpu,22433,0,1,1,64,0,0,0,0,1,12390000
nn_kernel_gpu,772,1,1,96797,128,0,0,0,0,1,12390000
nn_kernel_gpu_mem,13998,1,1,96797,128,99120000,49560000,49560000,99120000,1,12390000
nn_kernel_cpu,24223,0,1,1,64,0,0,0,0,1,12400000
nn_kernel_gpu,776,1,1,96875,128,0,0,0,0,1,12400000
nn_kernel_gpu_mem,18857,1,1,96875,128,99200000,49600000,49600000,99200000,1,12400000
nn_kernel_cpu,46545,0,1,1,64,0,0,0,0,1,1240000
nn_kernel_gpu,133,1,1,9688,128,0,0,0,0,1,1240000
nn_kernel_gpu_mem,3516,1,1,9688,128,9920000,4960000,4960000,9920000,1,1240000
nn_kernel_cpu,9970,0,1,1,64,0,0,0,0,1,12410000
nn_kernel_gpu,792,1,1,96954,128,0,0,0,0,1,12410000
nn_kernel_gpu_mem,17904,1,1,96954,128,99280000,49640000,49640000,99280000,1,12410000
nn_kernel_cpu,13536,0,1,1,64,0,0,0,0,1,12420000
nn_kernel_gpu,763,1,1,97032,128,0,0,0,0,1,12420000
nn_kernel_gpu_mem,17396,1,1,97032,128,99360000,49680000,49680000,99360000,1,12420000
nn_kernel_cpu,10447,0,1,1,64,0,0,0,0,1,12430000
nn_kernel_gpu,783,1,1,97110,128,0,0,0,0,1,12430000
nn_kernel_gpu_mem,25090,1,1,97110,128,99440000,49720000,49720000,99440000,1,12430000
nn_kernel_cpu,23816,0,1,1,64,0,0,0,0,1,12440000
nn_kernel_gpu,776,1,1,97188,128,0,0,0,0,1,12440000
nn_kernel_gpu_mem,18176,1,1,97188,128,99520000,49760000,49760000,99520000,1,12440000
nn_kernel_cpu,10657,0,1,1,64,0,0,0,0,1,12450000
nn_kernel_gpu,777,1,1,97266,128,0,0,0,0,1,12450000
nn_kernel_gpu_mem,18273,1,1,97266,128,99600000,49800000,49800000,99600000,1,12450000
nn_kernel_cpu,23327,0,1,1,64,0,0,0,0,1,12460000
nn_kernel_gpu,778,1,1,97344,128,0,0,0,0,1,12460000
nn_kernel_gpu_mem,17629,1,1,97344,128,99680000,49840000,49840000,99680000,1,12460000
nn_kernel_cpu,11618,0,1,1,64,0,0,0,0,1,12470000
nn_kernel_gpu,773,1,1,97422,128,0,0,0,0,1,12470000
nn_kernel_gpu_mem,18876,1,1,97422,128,99760000,49880000,49880000,99760000,1,12470000
nn_kernel_cpu,28995,0,1,1,64,0,0,0,0,1,12480000
nn_kernel_gpu,778,1,1,97500,128,0,0,0,0,1,12480000
nn_kernel_gpu_mem,18686,1,1,97500,128,99840000,49920000,49920000,99840000,1,12480000
nn_kernel_cpu,27916,0,1,1,64,0,0,0,0,1,12490000
nn_kernel_gpu,780,1,1,97579,128,0,0,0,0,1,12490000
nn_kernel_gpu_mem,19254,1,1,97579,128,99920000,49960000,49960000,99920000,1,12490000
nn_kernel_cpu,13462,0,1,1,64,0,0,0,0,1,12500000
nn_kernel_gpu,763,1,1,97657,128,0,0,0,0,1,12500000
nn_kernel_gpu_mem,13839,1,1,97657,128,100000000,50000000,50000000,100000000,1,12500000
nn_kernel_cpu,7607,0,1,1,64,0,0,0,0,1,1250000
nn_kernel_gpu,144,1,1,9766,128,0,0,0,0,1,1250000
nn_kernel_gpu_mem,2500,1,1,9766,128,10000000,5000000,5000000,10000000,1,1250000
nn_kernel_cpu,6258,0,1,1,64,0,0,0,0,1,12510000
nn_kernel_gpu,781,1,1,97735,128,0,0,0,0,1,12510000
nn_kernel_gpu_mem,17847,1,1,97735,128,100080000,50040000,50040000,100080000,1,12510000
nn_kernel_cpu,20877,0,1,1,64,0,0,0,0,1,12520000
nn_kernel_gpu,775,1,1,97813,128,0,0,0,0,1,12520000
nn_kernel_gpu_mem,17781,1,1,97813,128,100160000,50080000,50080000,100160000,1,12520000
nn_kernel_cpu,24569,0,1,1,64,0,0,0,0,1,12530000
nn_kernel_gpu,773,1,1,97891,128,0,0,0,0,1,12530000
nn_kernel_gpu_mem,17200,1,1,97891,128,100240000,50120000,50120000,100240000,1,12530000
nn_kernel_cpu,33228,0,1,1,64,0,0,0,0,1,12540000
nn_kernel_gpu,784,1,1,97969,128,0,0,0,0,1,12540000
nn_kernel_gpu_mem,18727,1,1,97969,128,100320000,50160000,50160000,100320000,1,12540000
nn_kernel_cpu,6003,0,1,1,64,0,0,0,0,1,12550000
nn_kernel_gpu,790,1,1,98047,128,0,0,0,0,1,12550000
nn_kernel_gpu_mem,17854,1,1,98047,128,100400000,50200000,50200000,100400000,1,12550000
nn_kernel_cpu,11888,0,1,1,64,0,0,0,0,1,12560000
nn_kernel_gpu,784,1,1,98125,128,0,0,0,0,1,12560000
nn_kernel_gpu_mem,13950,1,1,98125,128,100480000,50240000,50240000,100480000,1,12560000
nn_kernel_cpu,23104,0,1,1,64,0,0,0,0,1,12570000
nn_kernel_gpu,776,1,1,98204,128,0,0,0,0,1,12570000
nn_kernel_gpu_mem,18086,1,1,98204,128,100560000,50280000,50280000,100560000,1,12570000
nn_kernel_cpu,9953,0,1,1,64,0,0,0,0,1,12580000
nn_kernel_gpu,781,1,1,98282,128,0,0,0,0,1,12580000
nn_kernel_gpu_mem,18837,1,1,98282,128,100640000,50320000,50320000,100640000,1,12580000
nn_kernel_cpu,23200,0,1,1,64,0,0,0,0,1,12590000
nn_kernel_gpu,778,1,1,98360,128,0,0,0,0,1,12590000
nn_kernel_gpu_mem,14278,1,1,98360,128,100720000,50360000,50360000,100720000,1,12590000
nn_kernel_cpu,10318,0,1,1,64,0,0,0,0,1,12600000
nn_kernel_gpu,774,1,1,98438,128,0,0,0,0,1,12600000
nn_kernel_gpu_mem,18240,1,1,98438,128,100800000,50400000,50400000,100800000,1,12600000
nn_kernel_cpu,7777,0,1,1,64,0,0,0,0,1,1260000
nn_kernel_gpu,124,1,1,9844,128,0,0,0,0,1,1260000
nn_kernel_gpu_mem,5176,1,1,9844,128,10080000,5040000,5040000,10080000,1,1260000
nn_kernel_cpu,11827,0,1,1,64,0,0,0,0,1,12610000
nn_kernel_gpu,783,1,1,98516,128,0,0,0,0,1,12610000
nn_kernel_gpu_mem,15704,1,1,98516,128,100880000,50440000,50440000,100880000,1,12610000
nn_kernel_cpu,13981,0,1,1,64,0,0,0,0,1,12620000
nn_kernel_gpu,776,1,1,98594,128,0,0,0,0,1,12620000
nn_kernel_gpu_mem,14109,1,1,98594,128,100960000,50480000,50480000,100960000,1,12620000
nn_kernel_cpu,29217,0,1,1,64,0,0,0,0,1,12630000
nn_kernel_gpu,789,1,1,98672,128,0,0,0,0,1,12630000
nn_kernel_gpu_mem,19313,1,1,98672,128,101040000,50520000,50520000,101040000,1,12630000
nn_kernel_cpu,25480,0,1,1,64,0,0,0,0,1,12640000
nn_kernel_gpu,781,1,1,98750,128,0,0,0,0,1,12640000
nn_kernel_gpu_mem,26675,1,1,98750,128,101120000,50560000,50560000,101120000,1,12640000
nn_kernel_cpu,13289,0,1,1,64,0,0,0,0,1,12650000
nn_kernel_gpu,788,1,1,98829,128,0,0,0,0,1,12650000
nn_kernel_gpu_mem,18002,1,1,98829,128,101200000,50600000,50600000,101200000,1,12650000
nn_kernel_cpu,21252,0,1,1,64,0,0,0,0,1,12660000
nn_kernel_gpu,783,1,1,98907,128,0,0,0,0,1,12660000
nn_kernel_gpu_mem,17392,1,1,98907,128,101280000,50640000,50640000,101280000,1,12660000
nn_kernel_cpu,16920,0,1,1,64,0,0,0,0,1,12670000
nn_kernel_gpu,795,1,1,98985,128,0,0,0,0,1,12670000
nn_kernel_gpu_mem,17591,1,1,98985,128,101360000,50680000,50680000,101360000,1,12670000
nn_kernel_cpu,9742,0,1,1,64,0,0,0,0,1,12680000
nn_kernel_gpu,791,1,1,99063,128,0,0,0,0,1,12680000
nn_kernel_gpu_mem,17282,1,1,99063,128,101440000,50720000,50720000,101440000,1,12680000
nn_kernel_cpu,37909,0,1,1,64,0,0,0,0,1,12690000
nn_kernel_gpu,810,1,1,99141,128,0,0,0,0,1,12690000
nn_kernel_gpu_mem,14470,1,1,99141,128,101520000,50760000,50760000,101520000,1,12690000
nn_kernel_cpu,35449,0,1,1,64,0,0,0,0,1,12700000
nn_kernel_gpu,798,1,1,99219,128,0,0,0,0,1,12700000
nn_kernel_gpu_mem,14101,1,1,99219,128,101600000,50800000,50800000,101600000,1,12700000
nn_kernel_cpu,30570,0,1,1,64,0,0,0,0,1,1270000
nn_kernel_gpu,133,1,1,9922,128,0,0,0,0,1,1270000
nn_kernel_gpu_mem,3552,1,1,9922,128,10160000,5080000,5080000,10160000,1,1270000
nn_kernel_cpu,10799,0,1,1,64,0,0,0,0,1,12710000
nn_kernel_gpu,783,1,1,99297,128,0,0,0,0,1,12710000
nn_kernel_gpu_mem,17789,1,1,99297,128,101680000,50840000,50840000,101680000,1,12710000
nn_kernel_cpu,23945,0,1,1,64,0,0,0,0,1,12720000
nn_kernel_gpu,788,1,1,99375,128,0,0,0,0,1,12720000
nn_kernel_gpu_mem,18472,1,1,99375,128,101760000,50880000,50880000,101760000,1,12720000
nn_kernel_cpu,23627,0,1,1,64,0,0,0,0,1,12730000
nn_kernel_gpu,802,1,1,99454,128,0,0,0,0,1,12730000
nn_kernel_gpu_mem,19366,1,1,99454,128,101840000,50920000,50920000,101840000,1,12730000
nn_kernel_cpu,23619,0,1,1,64,0,0,0,0,1,12740000
nn_kernel_gpu,789,1,1,99532,128,0,0,0,0,1,12740000
nn_kernel_gpu_mem,14603,1,1,99532,128,101920000,50960000,50960000,101920000,1,12740000
nn_kernel_cpu,9111,0,1,1,64,0,0,0,0,1,12750000
nn_kernel_gpu,800,1,1,99610,128,0,0,0,0,1,12750000
nn_kernel_gpu_mem,17518,1,1,99610,128,102000000,51000000,51000000,102000000,1,12750000
nn_kernel_cpu,39251,0,1,1,64,0,0,0,0,1,12760000
nn_kernel_gpu,797,1,1,99688,128,0,0,0,0,1,12760000
nn_kernel_gpu_mem,14814,1,1,99688,128,102080000,51040000,51040000,102080000,1,12760000
nn_kernel_cpu,9850,0,1,1,64,0,0,0,0,1,12770000
nn_kernel_gpu,805,1,1,99766,128,0,0,0,0,1,12770000
nn_kernel_gpu_mem,18493,1,1,99766,128,102160000,51080000,51080000,102160000,1,12770000
nn_kernel_cpu,11557,0,1,1,64,0,0,0,0,1,12780000
nn_kernel_gpu,793,1,1,99844,128,0,0,0,0,1,12780000
nn_kernel_gpu_mem,14773,1,1,99844,128,102240000,51120000,51120000,102240000,1,12780000
nn_kernel_cpu,12899,0,1,1,64,0,0,0,0,1,12790000
nn_kernel_gpu,787,1,1,99922,128,0,0,0,0,1,12790000
nn_kernel_gpu_mem,14534,1,1,99922,128,102320000,51160000,51160000,102320000,1,12790000
nn_kernel_cpu,26926,0,1,1,64,0,0,0,0,1,12800000
nn_kernel_gpu,797,1,1,100000,128,0,0,0,0,1,12800000
nn_kernel_gpu_mem,18682,1,1,100000,128,102400000,51200000,51200000,102400000,1,12800000
nn_kernel_cpu,23937,0,1,1,64,0,0,0,0,1,1280000
nn_kernel_gpu,115,1,1,10000,128,0,0,0,0,1,1280000
nn_kernel_gpu_mem,3708,1,1,10000,128,10240000,5120000,5120000,10240000,1,1280000
nn_kernel_cpu,16949,0,1,1,64,0,0,0,0,1,12810000
nn_kernel_gpu,787,1,1,100079,128,0,0,0,0,1,12810000
nn_kernel_gpu_mem,14439,1,1,100079,128,102480000,51240000,51240000,102480000,1,12810000
nn_kernel_cpu,16670,0,1,1,64,0,0,0,0,1,12820000
nn_kernel_gpu,786,1,1,100157,128,0,0,0,0,1,12820000
nn_kernel_gpu_mem,18731,1,1,100157,128,102560000,51280000,51280000,102560000,1,12820000
nn_kernel_cpu,30581,0,1,1,64,0,0,0,0,1,12830000
nn_kernel_gpu,788,1,1,100235,128,0,0,0,0,1,12830000
nn_kernel_gpu_mem,18905,1,1,100235,128,102640000,51320000,51320000,102640000,1,12830000
nn_kernel_cpu,28881,0,1,1,64,0,0,0,0,1,12840000
nn_kernel_gpu,787,1,1,100313,128,0,0,0,0,1,12840000
nn_kernel_gpu_mem,14243,1,1,100313,128,102720000,51360000,51360000,102720000,1,12840000
nn_kernel_cpu,21252,0,1,1,64,0,0,0,0,1,12850000
nn_kernel_gpu,804,1,1,100391,128,0,0,0,0,1,12850000
nn_kernel_gpu_mem,19854,1,1,100391,128,102800000,51400000,51400000,102800000,1,12850000
nn_kernel_cpu,34980,0,1,1,64,0,0,0,0,1,12860000
nn_kernel_gpu,807,1,1,100469,128,0,0,0,0,1,12860000
nn_kernel_gpu_mem,19097,1,1,100469,128,102880000,51440000,51440000,102880000,1,12860000
nn_kernel_cpu,10988,0,1,1,64,0,0,0,0,1,12870000
nn_kernel_gpu,799,1,1,100547,128,0,0,0,0,1,12870000
nn_kernel_gpu_mem,18348,1,1,100547,128,102960000,51480000,51480000,102960000,1,12870000
nn_kernel_cpu,13567,0,1,1,64,0,0,0,0,1,12880000
nn_kernel_gpu,801,1,1,100625,128,0,0,0,0,1,12880000
nn_kernel_gpu_mem,18666,1,1,100625,128,103040000,51520000,51520000,103040000,1,12880000
nn_kernel_cpu,8864,0,1,1,64,0,0,0,0,1,12890000
nn_kernel_gpu,806,1,1,100704,128,0,0,0,0,1,12890000
nn_kernel_gpu_mem,19756,1,1,100704,128,103120000,51560000,51560000,103120000,1,12890000
nn_kernel_cpu,31048,0,1,1,64,0,0,0,0,1,12900000
nn_kernel_gpu,801,1,1,100782,128,0,0,0,0,1,12900000
nn_kernel_gpu_mem,14290,1,1,100782,128,103200000,51600000,51600000,103200000,1,12900000
nn_kernel_cpu,6628,0,1,1,64,0,0,0,0,1,1290000
nn_kernel_gpu,131,1,1,10079,128,0,0,0,0,1,1290000
nn_kernel_gpu_mem,3052,1,1,10079,128,10320000,5160000,5160000,10320000,1,1290000
nn_kernel_cpu,22772,0,1,1,64,0,0,0,0,1,12910000
nn_kernel_gpu,795,1,1,100860,128,0,0,0,0,1,12910000
nn_kernel_gpu_mem,18045,1,1,100860,128,103280000,51640000,51640000,103280000,1,12910000
nn_kernel_cpu,7483,0,1,1,64,0,0,0,0,1,12920000
nn_kernel_gpu,793,1,1,100938,128,0,0,0,0,1,12920000
nn_kernel_gpu_mem,14436,1,1,100938,128,103360000,51680000,51680000,103360000,1,12920000
nn_kernel_cpu,12701,0,1,1,64,0,0,0,0,1,12930000
nn_kernel_gpu,837,1,1,101016,128,0,0,0,0,1,12930000
nn_kernel_gpu_mem,19348,1,1,101016,128,103440000,51720000,51720000,103440000,1,12930000
nn_kernel_cpu,11363,0,1,1,64,0,0,0,0,1,12940000
nn_kernel_gpu,815,1,1,101094,128,0,0,0,0,1,12940000
nn_kernel_gpu_mem,20316,1,1,101094,128,103520000,51760000,51760000,103520000,1,12940000
nn_kernel_cpu,4379,0,1,1,64,0,0,0,0,1,12950000
nn_kernel_gpu,814,1,1,101172,128,0,0,0,0,1,12950000
nn_kernel_gpu_mem,20535,1,1,101172,128,103600000,51800000,51800000,103600000,1,12950000
nn_kernel_cpu,16343,0,1,1,64,0,0,0,0,1,12960000
nn_kernel_gpu,801,1,1,101250,128,0,0,0,0,1,12960000
nn_kernel_gpu_mem,20276,1,1,101250,128,103680000,51840000,51840000,103680000,1,12960000
nn_kernel_cpu,9243,0,1,1,64,0,0,0,0,1,12970000
nn_kernel_gpu,807,1,1,101329,128,0,0,0,0,1,12970000
nn_kernel_gpu_mem,19210,1,1,101329,128,103760000,51880000,51880000,103760000,1,12970000
nn_kernel_cpu,21588,0,1,1,64,0,0,0,0,1,12980000
nn_kernel_gpu,796,1,1,101407,128,0,0,0,0,1,12980000
nn_kernel_gpu_mem,26115,1,1,101407,128,103840000,51920000,51920000,103840000,1,12980000
nn_kernel_cpu,29458,0,1,1,64,0,0,0,0,1,12990000
nn_kernel_gpu,814,1,1,101485,128,0,0,0,0,1,12990000
nn_kernel_gpu_mem,18957,1,1,101485,128,103920000,51960000,51960000,103920000,1,12990000
nn_kernel_cpu,9222,0,1,1,64,0,0,0,0,1,13000000
nn_kernel_gpu,806,1,1,101563,128,0,0,0,0,1,13000000
nn_kernel_gpu_mem,14582,1,1,101563,128,104000000,52000000,52000000,104000000,1,13000000
nn_kernel_cpu,32052,0,1,1,64,0,0,0,0,1,1300000
nn_kernel_gpu,120,1,1,10157,128,0,0,0,0,1,1300000
nn_kernel_gpu_mem,3686,1,1,10157,128,10400000,5200000,5200000,10400000,1,1300000
nn_kernel_cpu,11207,0,1,1,64,0,0,0,0,1,130000
nn_kernel_gpu,58,1,1,1016,128,0,0,0,0,1,130000
nn_kernel_gpu_mem,255,1,1,1016,128,1040000,520000,520000,1040000,1,130000
nn_kernel_cpu,23242,0,1,1,64,0,0,0,0,1,13010000
nn_kernel_gpu,812,1,1,101641,128,0,0,0,0,1,13010000
nn_kernel_gpu_mem,20943,1,1,101641,128,104080000,52040000,52040000,104080000,1,13010000
nn_kernel_cpu,22528,0,1,1,64,0,0,0,0,1,13020000
nn_kernel_gpu,809,1,1,101719,128,0,0,0,0,1,13020000
nn_kernel_gpu_mem,14816,1,1,101719,128,104160000,52080000,52080000,104160000,1,13020000
nn_kernel_cpu,6719,0,1,1,64,0,0,0,0,1,13030000
nn_kernel_gpu,804,1,1,101797,128,0,0,0,0,1,13030000
nn_kernel_gpu_mem,14657,1,1,101797,128,104240000,52120000,52120000,104240000,1,13030000
nn_kernel_cpu,17794,0,1,1,64,0,0,0,0,1,13040000
nn_kernel_gpu,812,1,1,101875,128,0,0,0,0,1,13040000
nn_kernel_gpu_mem,18736,1,1,101875,128,104320000,52160000,52160000,104320000,1,13040000
nn_kernel_cpu,12619,0,1,1,64,0,0,0,0,1,13050000
nn_kernel_gpu,808,1,1,101954,128,0,0,0,0,1,13050000
nn_kernel_gpu_mem,18360,1,1,101954,128,104400000,52200000,52200000,104400000,1,13050000
nn_kernel_cpu,9575,0,1,1,64,0,0,0,0,1,13060000
nn_kernel_gpu,826,1,1,102032,128,0,0,0,0,1,13060000
nn_kernel_gpu_mem,18219,1,1,102032,128,104480000,52240000,52240000,104480000,1,13060000
nn_kernel_cpu,8898,0,1,1,64,0,0,0,0,1,13070000
nn_kernel_gpu,810,1,1,102110,128,0,0,0,0,1,13070000
nn_kernel_gpu_mem,14669,1,1,102110,128,104560000,52280000,52280000,104560000,1,13070000
nn_kernel_cpu,26796,0,1,1,64,0,0,0,0,1,13080000
nn_kernel_gpu,811,1,1,102188,128,0,0,0,0,1,13080000
nn_kernel_gpu_mem,15014,1,1,102188,128,104640000,52320000,52320000,104640000,1,13080000
nn_kernel_cpu,25764,0,1,1,64,0,0,0,0,1,13090000
nn_kernel_gpu,816,1,1,102266,128,0,0,0,0,1,13090000
nn_kernel_gpu_mem,19140,1,1,102266,128,104720000,52360000,52360000,104720000,1,13090000
nn_kernel_cpu,11609,0,1,1,64,0,0,0,0,1,13100000
nn_kernel_gpu,839,1,1,102344,128,0,0,0,0,1,13100000
nn_kernel_gpu_mem,15343,1,1,102344,128,104800000,52400000,52400000,104800000,1,13100000
nn_kernel_cpu,16535,0,1,1,64,0,0,0,0,1,1310000
nn_kernel_gpu,124,1,1,10235,128,0,0,0,0,1,1310000
nn_kernel_gpu_mem,2365,1,1,10235,128,10480000,5240000,5240000,10480000,1,1310000
nn_kernel_cpu,8298,0,1,1,64,0,0,0,0,1,13110000
nn_kernel_gpu,800,1,1,102422,128,0,0,0,0,1,13110000
nn_kernel_gpu_mem,19727,1,1,102422,128,104880000,52440000,52440000,104880000,1,13110000
nn_kernel_cpu,15721,0,1,1,64,0,0,0,0,1,13120000
nn_kernel_gpu,817,1,1,102500,128,0,0,0,0,1,13120000
nn_kernel_gpu_mem,17847,1,1,102500,128,104960000,52480000,52480000,104960000,1,13120000
nn_kernel_cpu,30794,0,1,1,64,0,0,0,0,1,13130000
nn_kernel_gpu,809,1,1,102579,128,0,0,0,0,1,13130000
nn_kernel_gpu_mem,15008,1,1,102579,128,105040000,52520000,52520000,105040000,1,13130000
nn_kernel_cpu,25115,0,1,1,64,0,0,0,0,1,13140000
nn_kernel_gpu,815,1,1,102657,128,0,0,0,0,1,13140000
nn_kernel_gpu_mem,19921,1,1,102657,128,105120000,52560000,52560000,105120000,1,13140000
nn_kernel_cpu,24535,0,1,1,64,0,0,0,0,1,13150000
nn_kernel_gpu,807,1,1,102735,128,0,0,0,0,1,13150000
nn_kernel_gpu_mem,14759,1,1,102735,128,105200000,52600000,52600000,105200000,1,13150000
nn_kernel_cpu,8068,0,1,1,64,0,0,0,0,1,13160000
nn_kernel_gpu,810,1,1,102813,128,0,0,0,0,1,13160000
nn_kernel_gpu_mem,20341,1,1,102813,128,105280000,52640000,52640000,105280000,1,13160000
nn_kernel_cpu,38409,0,1,1,64,0,0,0,0,1,13170000
nn_kernel_gpu,802,1,1,102891,128,0,0,0,0,1,13170000
nn_kernel_gpu_mem,21105,1,1,102891,128,105360000,52680000,52680000,105360000,1,13170000
nn_kernel_cpu,14863,0,1,1,64,0,0,0,0,1,13180000
nn_kernel_gpu,815,1,1,102969,128,0,0,0,0,1,13180000
nn_kernel_gpu_mem,19185,1,1,102969,128,105440000,52720000,52720000,105440000,1,13180000
nn_kernel_cpu,11419,0,1,1,64,0,0,0,0,1,13190000
nn_kernel_gpu,808,1,1,103047,128,0,0,0,0,1,13190000
nn_kernel_gpu_mem,19828,1,1,103047,128,105520000,52760000,52760000,105520000,1,13190000
nn_kernel_cpu,35916,0,1,1,64,0,0,0,0,1,13200000
nn_kernel_gpu,802,1,1,103125,128,0,0,0,0,1,13200000
nn_kernel_gpu_mem,14625,1,1,103125,128,105600000,52800000,52800000,105600000,1,13200000
nn_kernel_cpu,4317,0,1,1,64,0,0,0,0,1,1320000
nn_kernel_gpu,138,1,1,10313,128,0,0,0,0,1,1320000
nn_kernel_gpu_mem,4310,1,1,10313,128,10560000,5280000,5280000,10560000,1,1320000
nn_kernel_cpu,13934,0,1,1,64,0,0,0,0,1,13210000
nn_kernel_gpu,833,1,1,103204,128,0,0,0,0,1,13210000
nn_kernel_gpu_mem,19236,1,1,103204,128,105680000,52840000,52840000,105680000,1,13210000
nn_kernel_cpu,12434,0,1,1,64,0,0,0,0,1,13220000
nn_kernel_gpu,819,1,1,103282,128,0,0,0,0,1,13220000
nn_kernel_gpu_mem,20495,1,1,103282,128,105760000,52880000,52880000,105760000,1,13220000
nn_kernel_cpu,5543,0,1,1,64,0,0,0,0,1,13230000
nn_kernel_gpu,819,1,1,103360,128,0,0,0,0,1,13230000
nn_kernel_gpu_mem,19522,1,1,103360,128,105840000,52920000,52920000,105840000,1,13230000
nn_kernel_cpu,11758,0,1,1,64,0,0,0,0,1,13240000
nn_kernel_gpu,812,1,1,103438,128,0,0,0,0,1,13240000
nn_kernel_gpu_mem,21728,1,1,103438,128,105920000,52960000,52960000,105920000,1,13240000
nn_kernel_cpu,7880,0,1,1,64,0,0,0,0,1,13250000
nn_kernel_gpu,818,1,1,103516,128,0,0,0,0,1,13250000
nn_kernel_gpu_mem,18959,1,1,103516,128,106000000,53000000,53000000,106000000,1,13250000
nn_kernel_cpu,35935,0,1,1,64,0,0,0,0,1,13260000
nn_kernel_gpu,863,1,1,103594,128,0,0,0,0,1,13260000
nn_kernel_gpu_mem,20326,1,1,103594,128,106080000,53040000,53040000,106080000,1,13260000
nn_kernel_cpu,8507,0,1,1,64,0,0,0,0,1,13270000
nn_kernel_gpu,828,1,1,103672,128,0,0,0,0,1,13270000
nn_kernel_gpu_mem,18586,1,1,103672,128,106160000,53080000,53080000,106160000,1,13270000
nn_kernel_cpu,11309,0,1,1,64,0,0,0,0,1,13280000
nn_kernel_gpu,816,1,1,103750,128,0,0,0,0,1,13280000
nn_kernel_gpu_mem,19111,1,1,103750,128,106240000,53120000,53120000,106240000,1,13280000
nn_kernel_cpu,11075,0,1,1,64,0,0,0,0,1,13290000
nn_kernel_gpu,818,1,1,103829,128,0,0,0,0,1,13290000
nn_kernel_gpu_mem,20122,1,1,103829,128,106320000,53160000,53160000,106320000,1,13290000
nn_kernel_cpu,29797,0,1,1,64,0,0,0,0,1,13300000
nn_kernel_gpu,818,1,1,103907,128,0,0,0,0,1,13300000
nn_kernel_gpu_mem,24811,1,1,103907,128,106400000,53200000,53200000,106400000,1,13300000
nn_kernel_cpu,10252,0,1,1,64,0,0,0,0,1,1330000
nn_kernel_gpu,126,1,1,10391,128,0,0,0,0,1,1330000
nn_kernel_gpu_mem,2430,1,1,10391,128,10640000,5320000,5320000,10640000,1,1330000
nn_kernel_cpu,18665,0,1,1,64,0,0,0,0,1,13310000
nn_kernel_gpu,835,1,1,103985,128,0,0,0,0,1,13310000
nn_kernel_gpu_mem,18118,1,1,103985,128,106480000,53240000,53240000,106480000,1,13310000
nn_kernel_cpu,24756,0,1,1,64,0,0,0,0,1,13320000
nn_kernel_gpu,819,1,1,104063,128,0,0,0,0,1,13320000
nn_kernel_gpu_mem,20963,1,1,104063,128,106560000,53280000,53280000,106560000,1,13320000
nn_kernel_cpu,38945,0,1,1,64,0,0,0,0,1,13330000
nn_kernel_gpu,817,1,1,104141,128,0,0,0,0,1,13330000
nn_kernel_gpu_mem,15330,1,1,104141,128,106640000,53320000,53320000,106640000,1,13330000
nn_kernel_cpu,8569,0,1,1,64,0,0,0,0,1,13340000
nn_kernel_gpu,821,1,1,104219,128,0,0,0,0,1,13340000
nn_kernel_gpu_mem,18509,1,1,104219,128,106720000,53360000,53360000,106720000,1,13340000
nn_kernel_cpu,20197,0,1,1,64,0,0,0,0,1,13350000
nn_kernel_gpu,823,1,1,104297,128,0,0,0,0,1,13350000
nn_kernel_gpu_mem,24384,1,1,104297,128,106800000,53400000,53400000,106800000,1,13350000
nn_kernel_cpu,16017,0,1,1,64,0,0,0,0,1,13360000
nn_kernel_gpu,835,1,1,104375,128,0,0,0,0,1,13360000
nn_kernel_gpu_mem,20390,1,1,104375,128,106880000,53440000,53440000,106880000,1,13360000
nn_kernel_cpu,22209,0,1,1,64,0,0,0,0,1,13370000
nn_kernel_gpu,828,1,1,104454,128,0,0,0,0,1,13370000
nn_kernel_gpu_mem,19786,1,1,104454,128,106960000,53480000,53480000,106960000,1,13370000
nn_kernel_cpu,18516,0,1,1,64,0,0,0,0,1,13380000
nn_kernel_gpu,822,1,1,104532,128,0,0,0,0,1,13380000
nn_kernel_gpu_mem,15329,1,1,104532,128,107040000,53520000,53520000,107040000,1,13380000
nn_kernel_cpu,11868,0,1,1,64,0,0,0,0,1,13390000
nn_kernel_gpu,833,1,1,104610,128,0,0,0,0,1,13390000
nn_kernel_gpu_mem,25491,1,1,104610,128,107120000,53560000,53560000,107120000,1,13390000
nn_kernel_cpu,37391,0,1,1,64,0,0,0,0,1,13400000
nn_kernel_gpu,813,1,1,104688,128,0,0,0,0,1,13400000
nn_kernel_gpu_mem,14773,1,1,104688,128,107200000,53600000,53600000,107200000,1,13400000
nn_kernel_cpu,2337,0,1,1,64,0,0,0,0,1,1340000
nn_kernel_gpu,137,1,1,10469,128,0,0,0,0,1,1340000
nn_kernel_gpu_mem,3877,1,1,10469,128,10720000,5360000,5360000,10720000,1,1340000
nn_kernel_cpu,26595,0,1,1,64,0,0,0,0,1,13410000
nn_kernel_gpu,844,1,1,104766,128,0,0,0,0,1,13410000
nn_kernel_gpu_mem,20135,1,1,104766,128,107280000,53640000,53640000,107280000,1,13410000
nn_kernel_cpu,17677,0,1,1,64,0,0,0,0,1,13420000
nn_kernel_gpu,822,1,1,104844,128,0,0,0,0,1,13420000
nn_kernel_gpu_mem,18714,1,1,104844,128,107360000,53680000,53680000,107360000,1,13420000
nn_kernel_cpu,10459,0,1,1,64,0,0,0,0,1,13430000
nn_kernel_gpu,835,1,1,104922,128,0,0,0,0,1,13430000
nn_kernel_gpu_mem,14804,1,1,104922,128,107440000,53720000,53720000,107440000,1,13430000
nn_kernel_cpu,14618,0,1,1,64,0,0,0,0,1,13440000
nn_kernel_gpu,844,1,1,105000,128,0,0,0,0,1,13440000
nn_kernel_gpu_mem,18804,1,1,105000,128,107520000,53760000,53760000,107520000,1,13440000
nn_kernel_cpu,22324,0,1,1,64,0,0,0,0,1,13450000
nn_kernel_gpu,827,1,1,105079,128,0,0,0,0,1,13450000
nn_kernel_gpu_mem,18772,1,1,105079,128,107600000,53800000,53800000,107600000,1,13450000
nn_kernel_cpu,9453,0,1,1,64,0,0,0,0,1,13460000
nn_kernel_gpu,833,1,1,105157,128,0,0,0,0,1,13460000
nn_kernel_gpu_mem,15203,1,1,105157,128,107680000,53840000,53840000,107680000,1,13460000
nn_kernel_cpu,5132,0,1,1,64,0,0,0,0,1,13470000
nn_kernel_gpu,833,1,1,105235,128,0,0,0,0,1,13470000
nn_kernel_gpu_mem,19186,1,1,105235,128,107760000,53880000,53880000,107760000,1,13470000
nn_kernel_cpu,23987,0,1,1,64,0,0,0,0,1,13480000
nn_kernel_gpu,827,1,1,105313,128,0,0,0,0,1,13480000
nn_kernel_gpu_mem,19643,1,1,105313,128,107840000,53920000,53920000,107840000,1,13480000
nn_kernel_cpu,9593,0,1,1,64,0,0,0,0,1,13490000
nn_kernel_gpu,831,1,1,105391,128,0,0,0,0,1,13490000
nn_kernel_gpu_mem,18839,1,1,105391,128,107920000,53960000,53960000,107920000,1,13490000
nn_kernel_cpu,11295,0,1,1,64,0,0,0,0,1,13500000
nn_kernel_gpu,837,1,1,105469,128,0,0,0,0,1,13500000
nn_kernel_gpu_mem,19076,1,1,105469,128,108000000,54000000,54000000,108000000,1,13500000
nn_kernel_cpu,23998,0,1,1,64,0,0,0,0,1,1350000
nn_kernel_gpu,132,1,1,10547,128,0,0,0,0,1,1350000
nn_kernel_gpu_mem,2403,1,1,10547,128,10800000,5400000,5400000,10800000,1,1350000
nn_kernel_cpu,16055,0,1,1,64,0,0,0,0,1,13510000
nn_kernel_gpu,830,1,1,105547,128,0,0,0,0,1,13510000
nn_kernel_gpu_mem,21508,1,1,105547,128,108080000,54040000,54040000,108080000,1,13510000
nn_kernel_cpu,7646,0,1,1,64,0,0,0,0,1,13520000
nn_kernel_gpu,838,1,1,105625,128,0,0,0,0,1,13520000
nn_kernel_gpu_mem,15434,1,1,105625,128,108160000,54080000,54080000,108160000,1,13520000
nn_kernel_cpu,8245,0,1,1,64,0,0,0,0,1,13530000
nn_kernel_gpu,836,1,1,105704,128,0,0,0,0,1,13530000
nn_kernel_gpu_mem,22479,1,1,105704,128,108240000,54120000,54120000,108240000,1,13530000
nn_kernel_cpu,8128,0,1,1,64,0,0,0,0,1,13540000
nn_kernel_gpu,839,1,1,105782,128,0,0,0,0,1,13540000
nn_kernel_gpu_mem,20541,1,1,105782,128,108320000,54160000,54160000,108320000,1,13540000
nn_kernel_cpu,13619,0,1,1,64,0,0,0,0,1,13550000
nn_kernel_gpu,838,1,1,105860,128,0,0,0,0,1,13550000
nn_kernel_gpu_mem,21627,1,1,105860,128,108400000,54200000,54200000,108400000,1,13550000
nn_kernel_cpu,18324,0,1,1,64,0,0,0,0,1,13560000
nn_kernel_gpu,834,1,1,105938,128,0,0,0,0,1,13560000
nn_kernel_gpu_mem,19809,1,1,105938,128,108480000,54240000,54240000,108480000,1,13560000
nn_kernel_cpu,13906,0,1,1,64,0,0,0,0,1,13570000
nn_kernel_gpu,844,1,1,106016,128,0,0,0,0,1,13570000
nn_kernel_gpu_mem,20910,1,1,106016,128,108560000,54280000,54280000,108560000,1,13570000
nn_kernel_cpu,18401,0,1,1,64,0,0,0,0,1,13580000
nn_kernel_gpu,833,1,1,106094,128,0,0,0,0,1,13580000
nn_kernel_gpu_mem,15012,1,1,106094,128,108640000,54320000,54320000,108640000,1,13580000
nn_kernel_cpu,35937,0,1,1,64,0,0,0,0,1,13590000
nn_kernel_gpu,829,1,1,106172,128,0,0,0,0,1,13590000
nn_kernel_gpu_mem,18645,1,1,106172,128,108720000,54360000,54360000,108720000,1,13590000
nn_kernel_cpu,14924,0,1,1,64,0,0,0,0,1,13600000
nn_kernel_gpu,840,1,1,106250,128,0,0,0,0,1,13600000
nn_kernel_gpu_mem,19811,1,1,106250,128,108800000,54400000,54400000,108800000,1,13600000
nn_kernel_cpu,22121,0,1,1,64,0,0,0,0,1,1360000
nn_kernel_gpu,130,1,1,10625,128,0,0,0,0,1,1360000
nn_kernel_gpu_mem,2413,1,1,10625,128,10880000,5440000,5440000,10880000,1,1360000
nn_kernel_cpu,14834,0,1,1,64,0,0,0,0,1,13610000
nn_kernel_gpu,837,1,1,106329,128,0,0,0,0,1,13610000
nn_kernel_gpu_mem,24773,1,1,106329,128,108880000,54440000,54440000,108880000,1,13610000
nn_kernel_cpu,5448,0,1,1,64,0,0,0,0,1,13620000
nn_kernel_gpu,837,1,1,106407,128,0,0,0,0,1,13620000
nn_kernel_gpu_mem,15609,1,1,106407,128,108960000,54480000,54480000,108960000,1,13620000
nn_kernel_cpu,14139,0,1,1,64,0,0,0,0,1,13630000
nn_kernel_gpu,835,1,1,106485,128,0,0,0,0,1,13630000
nn_kernel_gpu_mem,22131,1,1,106485,128,109040000,54520000,54520000,109040000,1,13630000
nn_kernel_cpu,15450,0,1,1,64,0,0,0,0,1,13640000
nn_kernel_gpu,840,1,1,106563,128,0,0,0,0,1,13640000
nn_kernel_gpu_mem,15440,1,1,106563,128,109120000,54560000,54560000,109120000,1,13640000
nn_kernel_cpu,6860,0,1,1,64,0,0,0,0,1,13650000
nn_kernel_gpu,845,1,1,106641,128,0,0,0,0,1,13650000
nn_kernel_gpu_mem,21160,1,1,106641,128,109200000,54600000,54600000,109200000,1,13650000
nn_kernel_cpu,26168,0,1,1,64,0,0,0,0,1,13660000
nn_kernel_gpu,850,1,1,106719,128,0,0,0,0,1,13660000
nn_kernel_gpu_mem,21470,1,1,106719,128,109280000,54640000,54640000,109280000,1,13660000
nn_kernel_cpu,13293,0,1,1,64,0,0,0,0,1,13670000
nn_kernel_gpu,843,1,1,106797,128,0,0,0,0,1,13670000
nn_kernel_gpu_mem,24495,1,1,106797,128,109360000,54680000,54680000,109360000,1,13670000
nn_kernel_cpu,4041,0,1,1,64,0,0,0,0,1,13680000
nn_kernel_gpu,847,1,1,106875,128,0,0,0,0,1,13680000
nn_kernel_gpu_mem,21973,1,1,106875,128,109440000,54720000,54720000,109440000,1,13680000
nn_kernel_cpu,28340,0,1,1,64,0,0,0,0,1,13690000
nn_kernel_gpu,841,1,1,106954,128,0,0,0,0,1,13690000
nn_kernel_gpu_mem,18045,1,1,106954,128,109520000,54760000,54760000,109520000,1,13690000
nn_kernel_cpu,33396,0,1,1,64,0,0,0,0,1,13700000
nn_kernel_gpu,847,1,1,107032,128,0,0,0,0,1,13700000
nn_kernel_gpu_mem,19447,1,1,107032,128,109600000,54800000,54800000,109600000,1,13700000
nn_kernel_cpu,24041,0,1,1,64,0,0,0,0,1,1370000
nn_kernel_gpu,132,1,1,10704,128,0,0,0,0,1,1370000
nn_kernel_gpu_mem,2458,1,1,10704,128,10960000,5480000,5480000,10960000,1,1370000
nn_kernel_cpu,30104,0,1,1,64,0,0,0,0,1,13710000
nn_kernel_gpu,846,1,1,107110,128,0,0,0,0,1,13710000
nn_kernel_gpu_mem,20930,1,1,107110,128,109680000,54840000,54840000,109680000,1,13710000
nn_kernel_cpu,22835,0,1,1,64,0,0,0,0,1,13720000
nn_kernel_gpu,846,1,1,107188,128,0,0,0,0,1,13720000
nn_kernel_gpu_mem,19711,1,1,107188,128,109760000,54880000,54880000,109760000,1,13720000
nn_kernel_cpu,14786,0,1,1,64,0,0,0,0,1,13730000
nn_kernel_gpu,858,1,1,107266,128,0,0,0,0,1,13730000
nn_kernel_gpu_mem,20694,1,1,107266,128,109840000,54920000,54920000,109840000,1,13730000
nn_kernel_cpu,8515,0,1,1,64,0,0,0,0,1,13740000
nn_kernel_gpu,863,1,1,107344,128,0,0,0,0,1,13740000
nn_kernel_gpu_mem,19290,1,1,107344,128,109920000,54960000,54960000,109920000,1,13740000
nn_kernel_cpu,13602,0,1,1,64,0,0,0,0,1,13750000
nn_kernel_gpu,851,1,1,107422,128,0,0,0,0,1,13750000
nn_kernel_gpu_mem,20798,1,1,107422,128,110000000,55000000,55000000,110000000,1,13750000
nn_kernel_cpu,18845,0,1,1,64,0,0,0,0,1,13760000
nn_kernel_gpu,847,1,1,107500,128,0,0,0,0,1,13760000
nn_kernel_gpu_mem,19718,1,1,107500,128,110080000,55040000,55040000,110080000,1,13760000
nn_kernel_cpu,15799,0,1,1,64,0,0,0,0,1,13770000
nn_kernel_gpu,858,1,1,107579,128,0,0,0,0,1,13770000
nn_kernel_gpu_mem,15534,1,1,107579,128,110160000,55080000,55080000,110160000,1,13770000
nn_kernel_cpu,22397,0,1,1,64,0,0,0,0,1,13780000
nn_kernel_gpu,844,1,1,107657,128,0,0,0,0,1,13780000
nn_kernel_gpu_mem,19773,1,1,107657,128,110240000,55120000,55120000,110240000,1,13780000
nn_kernel_cpu,10025,0,1,1,64,0,0,0,0,1,13790000
nn_kernel_gpu,845,1,1,107735,128,0,0,0,0,1,13790000
nn_kernel_gpu_mem,18626,1,1,107735,128,110320000,55160000,55160000,110320000,1,13790000
nn_kernel_cpu,22593,0,1,1,64,0,0,0,0,1,13800000
nn_kernel_gpu,844,1,1,107813,128,0,0,0,0,1,13800000
nn_kernel_gpu_mem,15158,1,1,107813,128,110400000,55200000,55200000,110400000,1,13800000
nn_kernel_cpu,5870,0,1,1,64,0,0,0,0,1,1380000
nn_kernel_gpu,132,1,1,10782,128,0,0,0,0,1,1380000
nn_kernel_gpu_mem,2581,1,1,10782,128,11040000,5520000,5520000,11040000,1,1380000
nn_kernel_cpu,18825,0,1,1,64,0,0,0,0,1,13810000
nn_kernel_gpu,864,1,1,107891,128,0,0,0,0,1,13810000
nn_kernel_gpu_mem,22441,1,1,107891,128,110480000,55240000,55240000,110480000,1,13810000
nn_kernel_cpu,11507,0,1,1,64,0,0,0,0,1,13820000
nn_kernel_gpu,851,1,1,107969,128,0,0,0,0,1,13820000
nn_kernel_gpu_mem,18949,1,1,107969,128,110560000,55280000,55280000,110560000,1,13820000
nn_kernel_cpu,10631,0,1,1,64,0,0,0,0,1,13830000
nn_kernel_gpu,857,1,1,108047,128,0,0,0,0,1,13830000
nn_kernel_gpu_mem,21916,1,1,108047,128,110640000,55320000,55320000,110640000,1,13830000
nn_kernel_cpu,19248,0,1,1,64,0,0,0,0,1,13840000
nn_kernel_gpu,854,1,1,108125,128,0,0,0,0,1,13840000
nn_kernel_gpu_mem,15935,1,1,108125,128,110720000,55360000,55360000,110720000,1,13840000
nn_kernel_cpu,36543,0,1,1,64,0,0,0,0,1,13850000
nn_kernel_gpu,866,1,1,108204,128,0,0,0,0,1,13850000
nn_kernel_gpu_mem,15535,1,1,108204,128,110800000,55400000,55400000,110800000,1,13850000
nn_kernel_cpu,18888,0,1,1,64,0,0,0,0,1,13860000
nn_kernel_gpu,858,1,1,108282,128,0,0,0,0,1,13860000
nn_kernel_gpu_mem,21251,1,1,108282,128,110880000,55440000,55440000,110880000,1,13860000
nn_kernel_cpu,15473,0,1,1,64,0,0,0,0,1,13870000
nn_kernel_gpu,855,1,1,108360,128,0,0,0,0,1,13870000
nn_kernel_gpu_mem,20757,1,1,108360,128,110960000,55480000,55480000,110960000,1,13870000
nn_kernel_cpu,10133,0,1,1,64,0,0,0,0,1,13880000
nn_kernel_gpu,853,1,1,108438,128,0,0,0,0,1,13880000
nn_kernel_gpu_mem,19454,1,1,108438,128,111040000,55520000,55520000,111040000,1,13880000
nn_kernel_cpu,27842,0,1,1,64,0,0,0,0,1,13890000
nn_kernel_gpu,849,1,1,108516,128,0,0,0,0,1,13890000
nn_kernel_gpu_mem,15545,1,1,108516,128,111120000,55560000,55560000,111120000,1,13890000
nn_kernel_cpu,13152,0,1,1,64,0,0,0,0,1,13900000
nn_kernel_gpu,858,1,1,108594,128,0,0,0,0,1,13900000
nn_kernel_gpu_mem,25848,1,1,108594,128,111200000,55600000,55600000,111200000,1,13900000
nn_kernel_cpu,15750,0,1,1,64,0,0,0,0,1,1390000
nn_kernel_gpu,130,1,1,10860,128,0,0,0,0,1,1390000
nn_kernel_gpu_mem,4208,1,1,10860,128,11120000,5560000,5560000,11120000,1,1390000
nn_kernel_cpu,25908,0,1,1,64,0,0,0,0,1,13910000
nn_kernel_gpu,857,1,1,108672,128,0,0,0,0,1,13910000
nn_kernel_gpu_mem,23359,1,1,108672,128,111280000,55640000,55640000,111280000,1,13910000
nn_kernel_cpu,36556,0,1,1,64,0,0,0,0,1,13920000
nn_kernel_gpu,864,1,1,108750,128,0,0,0,0,1,13920000
nn_kernel_gpu_mem,15383,1,1,108750,128,111360000,55680000,55680000,111360000,1,13920000
nn_kernel_cpu,14657,0,1,1,64,0,0,0,0,1,13930000
nn_kernel_gpu,857,1,1,108829,128,0,0,0,0,1,13930000
nn_kernel_gpu_mem,22941,1,1,108829,128,111440000,55720000,55720000,111440000,1,13930000
nn_kernel_cpu,23940,0,1,1,64,0,0,0,0,1,13940000
nn_kernel_gpu,863,1,1,108907,128,0,0,0,0,1,13940000
nn_kernel_gpu_mem,20621,1,1,108907,128,111520000,55760000,55760000,111520000,1,13940000
nn_kernel_cpu,9379,0,1,1,64,0,0,0,0,1,13950000
nn_kernel_gpu,878,1,1,108985,128,0,0,0,0,1,13950000
nn_kernel_gpu_mem,21899,1,1,108985,128,111600000,55800000,55800000,111600000,1,13950000
nn_kernel_cpu,23509,0,1,1,64,0,0,0,0,1,13960000
nn_kernel_gpu,860,1,1,109063,128,0,0,0,0,1,13960000
nn_kernel_gpu_mem,15592,1,1,109063,128,111680000,55840000,55840000,111680000,1,13960000
nn_kernel_cpu,23883,0,1,1,64,0,0,0,0,1,13970000
nn_kernel_gpu,859,1,1,109141,128,0,0,0,0,1,13970000
nn_kernel_gpu_mem,20100,1,1,109141,128,111760000,55880000,55880000,111760000,1,13970000
nn_kernel_cpu,18839,0,1,1,64,0,0,0,0,1,13980000
nn_kernel_gpu,861,1,1,109219,128,0,0,0,0,1,13980000
nn_kernel_gpu_mem,15931,1,1,109219,128,111840000,55920000,55920000,111840000,1,13980000
nn_kernel_cpu,23306,0,1,1,64,0,0,0,0,1,13990000
nn_kernel_gpu,872,1,1,109297,128,0,0,0,0,1,13990000
nn_kernel_gpu_mem,21948,1,1,109297,128,111920000,55960000,55960000,111920000,1,13990000
nn_kernel_cpu,27189,0,1,1,64,0,0,0,0,1,14000000
nn_kernel_gpu,859,1,1,109375,128,0,0,0,0,1,14000000
nn_kernel_gpu_mem,22788,1,1,109375,128,112000000,56000000,56000000,112000000,1,14000000
nn_kernel_cpu,8298,0,1,1,64,0,0,0,0,1,1400000
nn_kernel_gpu,125,1,1,10938,128,0,0,0,0,1,1400000
nn_kernel_gpu_mem,2451,1,1,10938,128,11200000,5600000,5600000,11200000,1,1400000
nn_kernel_cpu,32146,0,1,1,64,0,0,0,0,1,140000
nn_kernel_gpu,42,1,1,1094,128,0,0,0,0,1,140000
nn_kernel_gpu_mem,429,1,1,1094,128,1120000,560000,560000,1120000,1,140000
nn_kernel_cpu,7696,0,1,1,64,0,0,0,0,1,14010000
nn_kernel_gpu,870,1,1,109454,128,0,0,0,0,1,14010000
nn_kernel_gpu_mem,21743,1,1,109454,128,112080000,56040000,56040000,112080000,1,14010000
nn_kernel_cpu,23887,0,1,1,64,0,0,0,0,1,14020000
nn_kernel_gpu,858,1,1,109532,128,0,0,0,0,1,14020000
nn_kernel_gpu_mem,15406,1,1,109532,128,112160000,56080000,56080000,112160000,1,14020000
nn_kernel_cpu,11739,0,1,1,64,0,0,0,0,1,14030000
nn_kernel_gpu,870,1,1,109610,128,0,0,0,0,1,14030000
nn_kernel_gpu_mem,21627,1,1,109610,128,112240000,56120000,56120000,112240000,1,14030000
nn_kernel_cpu,17268,0,1,1,64,0,0,0,0,1,14040000
nn_kernel_gpu,866,1,1,109688,128,0,0,0,0,1,14040000
nn_kernel_gpu_mem,21006,1,1,109688,128,112320000,56160000,56160000,112320000,1,14040000
nn_kernel_cpu,12428,0,1,1,64,0,0,0,0,1,14050000
nn_kernel_gpu,866,1,1,109766,128,0,0,0,0,1,14050000
nn_kernel_gpu_mem,22008,1,1,109766,128,112400000,56200000,56200000,112400000,1,14050000
nn_kernel_cpu,20515,0,1,1,64,0,0,0,0,1,14060000
nn_kernel_gpu,875,1,1,109844,128,0,0,0,0,1,14060000
nn_kernel_gpu_mem,21706,1,1,109844,128,112480000,56240000,56240000,112480000,1,14060000
nn_kernel_cpu,5645,0,1,1,64,0,0,0,0,1,14070000
nn_kernel_gpu,881,1,1,109922,128,0,0,0,0,1,14070000
nn_kernel_gpu_mem,20417,1,1,109922,128,112560000,56280000,56280000,112560000,1,14070000
nn_kernel_cpu,37087,0,1,1,64,0,0,0,0,1,14080000
nn_kernel_gpu,877,1,1,110000,128,0,0,0,0,1,14080000
nn_kernel_gpu_mem,15732,1,1,110000,128,112640000,56320000,56320000,112640000,1,14080000
nn_kernel_cpu,20806,0,1,1,64,0,0,0,0,1,14090000
nn_kernel_gpu,865,1,1,110079,128,0,0,0,0,1,14090000
nn_kernel_gpu_mem,20142,1,1,110079,128,112720000,56360000,56360000,112720000,1,14090000
nn_kernel_cpu,37455,0,1,1,64,0,0,0,0,1,14100000
nn_kernel_gpu,874,1,1,110157,128,0,0,0,0,1,14100000
nn_kernel_gpu_mem,21067,1,1,110157,128,112800000,56400000,56400000,112800000,1,14100000
nn_kernel_cpu,7074,0,1,1,64,0,0,0,0,1,1410000
nn_kernel_gpu,131,1,1,11016,128,0,0,0,0,1,1410000
nn_kernel_gpu_mem,4954,1,1,11016,128,11280000,5640000,5640000,11280000,1,1410000
nn_kernel_cpu,10458,0,1,1,64,0,0,0,0,1,14110000
nn_kernel_gpu,868,1,1,110235,128,0,0,0,0,1,14110000
nn_kernel_gpu_mem,15556,1,1,110235,128,112880000,56440000,56440000,112880000,1,14110000
nn_kernel_cpu,23938,0,1,1,64,0,0,0,0,1,14120000
nn_kernel_gpu,895,1,1,110313,128,0,0,0,0,1,14120000
nn_kernel_gpu_mem,23807,1,1,110313,128,112960000,56480000,56480000,112960000,1,14120000
nn_kernel_cpu,27150,0,1,1,64,0,0,0,0,1,14130000
nn_kernel_gpu,881,1,1,110391,128,0,0,0,0,1,14130000
nn_kernel_gpu_mem,23623,1,1,110391,128,113040000,56520000,56520000,113040000,1,14130000
nn_kernel_cpu,19413,0,1,1,64,0,0,0,0,1,14140000
nn_kernel_gpu,871,1,1,110469,128,0,0,0,0,1,14140000
nn_kernel_gpu_mem,15821,1,1,110469,128,113120000,56560000,56560000,113120000,1,14140000
nn_kernel_cpu,19868,0,1,1,64,0,0,0,0,1,14150000
nn_kernel_gpu,869,1,1,110547,128,0,0,0,0,1,14150000
nn_kernel_gpu_mem,15574,1,1,110547,128,113200000,56600000,56600000,113200000,1,14150000
nn_kernel_cpu,14818,0,1,1,64,0,0,0,0,1,14160000
nn_kernel_gpu,872,1,1,110625,128,0,0,0,0,1,14160000
nn_kernel_gpu_mem,15740,1,1,110625,128,113280000,56640000,56640000,113280000,1,14160000
nn_kernel_cpu,12079,0,1,1,64,0,0,0,0,1,14170000
nn_kernel_gpu,886,1,1,110704,128,0,0,0,0,1,14170000
nn_kernel_gpu_mem,22268,1,1,110704,128,113360000,56680000,56680000,113360000,1,14170000
nn_kernel_cpu,23415,0,1,1,64,0,0,0,0,1,14180000
nn_kernel_gpu,875,1,1,110782,128,0,0,0,0,1,14180000
nn_kernel_gpu_mem,23569,1,1,110782,128,113440000,56720000,56720000,113440000,1,14180000
nn_kernel_cpu,12826,0,1,1,64,0,0,0,0,1,14190000
nn_kernel_gpu,882,1,1,110860,128,0,0,0,0,1,14190000
nn_kernel_gpu_mem,21732,1,1,110860,128,113520000,56760000,56760000,113520000,1,14190000
nn_kernel_cpu,7475,0,1,1,64,0,0,0,0,1,14200000
nn_kernel_gpu,910,1,1,110938,128,0,0,0,0,1,14200000
nn_kernel_gpu_mem,23560,1,1,110938,128,113600000,56800000,56800000,113600000,1,14200000
nn_kernel_cpu,23424,0,1,1,64,0,0,0,0,1,1420000
nn_kernel_gpu,135,1,1,11094,128,0,0,0,0,1,1420000
nn_kernel_gpu_mem,2520,1,1,11094,128,11360000,5680000,5680000,11360000,1,1420000
nn_kernel_cpu,18033,0,1,1,64,0,0,0,0,1,14210000
nn_kernel_gpu,881,1,1,111016,128,0,0,0,0,1,14210000
nn_kernel_gpu_mem,15595,1,1,111016,128,113680000,56840000,56840000,113680000,1,14210000
nn_kernel_cpu,18445,0,1,1,64,0,0,0,0,1,14220000
nn_kernel_gpu,871,1,1,111094,128,0,0,0,0,1,14220000
nn_kernel_gpu_mem,19904,1,1,111094,128,113760000,56880000,56880000,113760000,1,14220000
nn_kernel_cpu,11159,0,1,1,64,0,0,0,0,1,14230000
nn_kernel_gpu,887,1,1,111172,128,0,0,0,0,1,14230000
nn_kernel_gpu_mem,16128,1,1,111172,128,113840000,56920000,56920000,113840000,1,14230000
nn_kernel_cpu,18361,0,1,1,64,0,0,0,0,1,14240000
nn_kernel_gpu,879,1,1,111250,128,0,0,0,0,1,14240000
nn_kernel_gpu_mem,15901,1,1,111250,128,113920000,56960000,56960000,113920000,1,14240000
nn_kernel_cpu,24432,0,1,1,64,0,0,0,0,1,14250000
nn_kernel_gpu,873,1,1,111329,128,0,0,0,0,1,14250000
nn_kernel_gpu_mem,16006,1,1,111329,128,114000000,57000000,57000000,114000000,1,14250000
nn_kernel_cpu,22137,0,1,1,64,0,0,0,0,1,14260000
nn_kernel_gpu,881,1,1,111407,128,0,0,0,0,1,14260000
nn_kernel_gpu_mem,16560,1,1,111407,128,114080000,57040000,57040000,114080000,1,14260000
nn_kernel_cpu,10301,0,1,1,64,0,0,0,0,1,14270000
nn_kernel_gpu,889,1,1,111485,128,0,0,0,0,1,14270000
nn_kernel_gpu_mem,27079,1,1,111485,128,114160000,57080000,57080000,114160000,1,14270000
nn_kernel_cpu,11879,0,1,1,64,0,0,0,0,1,14280000
nn_kernel_gpu,881,1,1,111563,128,0,0,0,0,1,14280000
nn_kernel_gpu_mem,16021,1,1,111563,128,114240000,57120000,57120000,114240000,1,14280000
nn_kernel_cpu,13004,0,1,1,64,0,0,0,0,1,14290000
nn_kernel_gpu,875,1,1,111641,128,0,0,0,0,1,14290000
nn_kernel_gpu_mem,20209,1,1,111641,128,114320000,57160000,57160000,114320000,1,14290000
nn_kernel_cpu,15425,0,1,1,64,0,0,0,0,1,14300000
nn_kernel_gpu,883,1,1,111719,128,0,0,0,0,1,14300000
nn_kernel_gpu_mem,15914,1,1,111719,128,114400000,57200000,57200000,114400000,1,14300000
nn_kernel_cpu,5754,0,1,1,64,0,0,0,0,1,1430000
nn_kernel_gpu,143,1,1,11172,128,0,0,0,0,1,1430000
nn_kernel_gpu_mem,2549,1,1,11172,128,11440000,5720000,5720000,11440000,1,1430000
nn_kernel_cpu,23675,0,1,1,64,0,0,0,0,1,14310000
nn_kernel_gpu,882,1,1,111797,128,0,0,0,0,1,14310000
nn_kernel_gpu_mem,22561,1,1,111797,128,114480000,57240000,57240000,114480000,1,14310000
nn_kernel_cpu,9895,0,1,1,64,0,0,0,0,1,14320000
nn_kernel_gpu,883,1,1,111875,128,0,0,0,0,1,14320000
nn_kernel_gpu_mem,15713,1,1,111875,128,114560000,57280000,57280000,114560000,1,14320000
nn_kernel_cpu,10928,0,1,1,64,0,0,0,0,1,14330000
nn_kernel_gpu,885,1,1,111954,128,0,0,0,0,1,14330000
nn_kernel_gpu_mem,15719,1,1,111954,128,114640000,57320000,57320000,114640000,1,14330000
nn_kernel_cpu,21576,0,1,1,64,0,0,0,0,1,14340000
nn_kernel_gpu,881,1,1,112032,128,0,0,0,0,1,14340000
nn_kernel_gpu_mem,22502,1,1,112032,128,114720000,57360000,57360000,114720000,1,14340000
nn_kernel_cpu,12747,0,1,1,64,0,0,0,0,1,14350000
nn_kernel_gpu,893,1,1,112110,128,0,0,0,0,1,14350000
nn_kernel_gpu_mem,22264,1,1,112110,128,114800000,57400000,57400000,114800000,1,14350000
nn_kernel_cpu,12581,0,1,1,64,0,0,0,0,1,14360000
nn_kernel_gpu,882,1,1,112188,128,0,0,0,0,1,14360000
nn_kernel_gpu_mem,16216,1,1,112188,128,114880000,57440000,57440000,114880000,1,14360000
nn_kernel_cpu,16782,0,1,1,64,0,0,0,0,1,14370000
nn_kernel_gpu,893,1,1,112266,128,0,0,0,0,1,14370000
nn_kernel_gpu_mem,20155,1,1,112266,128,114960000,57480000,57480000,114960000,1,14370000
nn_kernel_cpu,10408,0,1,1,64,0,0,0,0,1,14380000
nn_kernel_gpu,891,1,1,112344,128,0,0,0,0,1,14380000
nn_kernel_gpu_mem,21626,1,1,112344,128,115040000,57520000,57520000,115040000,1,14380000
nn_kernel_cpu,6659,0,1,1,64,0,0,0,0,1,14390000
nn_kernel_gpu,881,1,1,112422,128,0,0,0,0,1,14390000
nn_kernel_gpu_mem,15803,1,1,112422,128,115120000,57560000,57560000,115120000,1,14390000
nn_kernel_cpu,9988,0,1,1,64,0,0,0,0,1,14400000
nn_kernel_gpu,885,1,1,112500,128,0,0,0,0,1,14400000
nn_kernel_gpu_mem,24151,1,1,112500,128,115200000,57600000,57600000,115200000,1,14400000
nn_kernel_cpu,22031,0,1,1,64,0,0,0,0,1,1440000
nn_kernel_gpu,319,1,1,11250,128,0,0,0,0,1,1440000
nn_kernel_gpu_mem,2808,1,1,11250,128,11520000,5760000,5760000,11520000,1,1440000
nn_kernel_cpu,21103,0,1,1,64,0,0,0,0,1,14410000
nn_kernel_gpu,891,1,1,112579,128,0,0,0,0,1,14410000
nn_kernel_gpu_mem,22782,1,1,112579,128,115280000,57640000,57640000,115280000,1,14410000
nn_kernel_cpu,22045,0,1,1,64,0,0,0,0,1,14420000
nn_kernel_gpu,901,1,1,112657,128,0,0,0,0,1,14420000
nn_kernel_gpu_mem,20966,1,1,112657,128,115360000,57680000,57680000,115360000,1,14420000
nn_kernel_cpu,19105,0,1,1,64,0,0,0,0,1,14430000
nn_kernel_gpu,901,1,1,112735,128,0,0,0,0,1,14430000
nn_kernel_gpu_mem,16135,1,1,112735,128,115440000,57720000,57720000,115440000,1,14430000
nn_kernel_cpu,23092,0,1,1,64,0,0,0,0,1,14440000
nn_kernel_gpu,895,1,1,112813,128,0,0,0,0,1,14440000
nn_kernel_gpu_mem,22504,1,1,112813,128,115520000,57760000,57760000,115520000,1,14440000
nn_kernel_cpu,10176,0,1,1,64,0,0,0,0,1,14450000
nn_kernel_gpu,894,1,1,112891,128,0,0,0,0,1,14450000
nn_kernel_gpu_mem,22250,1,1,112891,128,115600000,57800000,57800000,115600000,1,14450000
nn_kernel_cpu,26384,0,1,1,64,0,0,0,0,1,14460000
nn_kernel_gpu,899,1,1,112969,128,0,0,0,0,1,14460000
nn_kernel_gpu_mem,23260,1,1,112969,128,115680000,57840000,57840000,115680000,1,14460000
nn_kernel_cpu,60783,0,1,1,64,0,0,0,0,1,14470000
nn_kernel_gpu,905,1,1,113047,128,0,0,0,0,1,14470000
nn_kernel_gpu_mem,16045,1,1,113047,128,115760000,57880000,57880000,115760000,1,14470000
nn_kernel_cpu,35172,0,1,1,64,0,0,0,0,1,14480000
nn_kernel_gpu,891,1,1,113125,128,0,0,0,0,1,14480000
nn_kernel_gpu_mem,15895,1,1,113125,128,115840000,57920000,57920000,115840000,1,14480000
nn_kernel_cpu,22955,0,1,1,64,0,0,0,0,1,14490000
nn_kernel_gpu,893,1,1,113204,128,0,0,0,0,1,14490000
nn_kernel_gpu_mem,24436,1,1,113204,128,115920000,57960000,57960000,115920000,1,14490000
nn_kernel_cpu,26227,0,1,1,64,0,0,0,0,1,14500000
nn_kernel_gpu,901,1,1,113282,128,0,0,0,0,1,14500000
nn_kernel_gpu_mem,26877,1,1,113282,128,116000000,58000000,58000000,116000000,1,14500000
nn_kernel_cpu,12320,0,1,1,64,0,0,0,0,1,1450000
nn_kernel_gpu,133,1,1,11329,128,0,0,0,0,1,1450000
nn_kernel_gpu_mem,4217,1,1,11329,128,11600000,5800000,5800000,11600000,1,1450000
nn_kernel_cpu,11831,0,1,1,64,0,0,0,0,1,14510000
nn_kernel_gpu,897,1,1,113360,128,0,0,0,0,1,14510000
nn_kernel_gpu_mem,16357,1,1,113360,128,116080000,58040000,58040000,116080000,1,14510000
nn_kernel_cpu,19072,0,1,1,64,0,0,0,0,1,14520000
nn_kernel_gpu,896,1,1,113438,128,0,0,0,0,1,14520000
nn_kernel_gpu_mem,16279,1,1,113438,128,116160000,58080000,58080000,116160000,1,14520000
nn_kernel_cpu,10706,0,1,1,64,0,0,0,0,1,14530000
nn_kernel_gpu,890,1,1,113516,128,0,0,0,0,1,14530000
nn_kernel_gpu_mem,16238,1,1,113516,128,116240000,58120000,58120000,116240000,1,14530000
nn_kernel_cpu,25161,0,1,1,64,0,0,0,0,1,14540000
nn_kernel_gpu,896,1,1,113594,128,0,0,0,0,1,14540000
nn_kernel_gpu_mem,20985,1,1,113594,128,116320000,58160000,58160000,116320000,1,14540000
nn_kernel_cpu,17306,0,1,1,64,0,0,0,0,1,14550000
nn_kernel_gpu,894,1,1,113672,128,0,0,0,0,1,14550000
nn_kernel_gpu_mem,15978,1,1,113672,128,116400000,58200000,58200000,116400000,1,14550000
nn_kernel_cpu,10137,0,1,1,64,0,0,0,0,1,14560000
nn_kernel_gpu,894,1,1,113750,128,0,0,0,0,1,14560000
nn_kernel_gpu_mem,16417,1,1,113750,128,116480000,58240000,58240000,116480000,1,14560000
nn_kernel_cpu,11971,0,1,1,64,0,0,0,0,1,14570000
nn_kernel_gpu,897,1,1,113829,128,0,0,0,0,1,14570000
nn_kernel_gpu_mem,16303,1,1,113829,128,116560000,58280000,58280000,116560000,1,14570000
nn_kernel_cpu,9856,0,1,1,64,0,0,0,0,1,14580000
nn_kernel_gpu,903,1,1,113907,128,0,0,0,0,1,14580000
nn_kernel_gpu_mem,15965,1,1,113907,128,116640000,58320000,58320000,116640000,1,14580000
nn_kernel_cpu,21194,0,1,1,64,0,0,0,0,1,14590000
nn_kernel_gpu,898,1,1,113985,128,0,0,0,0,1,14590000
nn_kernel_gpu_mem,16628,1,1,113985,128,116720000,58360000,58360000,116720000,1,14590000
nn_kernel_cpu,10523,0,1,1,64,0,0,0,0,1,14600000
nn_kernel_gpu,899,1,1,114063,128,0,0,0,0,1,14600000
nn_kernel_gpu_mem,16416,1,1,114063,128,116800000,58400000,58400000,116800000,1,14600000
nn_kernel_cpu,21163,0,1,1,64,0,0,0,0,1,1460000
nn_kernel_gpu,128,1,1,11407,128,0,0,0,0,1,1460000
nn_kernel_gpu_mem,3620,1,1,11407,128,11680000,5840000,5840000,11680000,1,1460000
nn_kernel_cpu,7453,0,1,1,64,0,0,0,0,1,14610000
nn_kernel_gpu,908,1,1,114141,128,0,0,0,0,1,14610000
nn_kernel_gpu_mem,16200,1,1,114141,128,116880000,58440000,58440000,116880000,1,14610000
nn_kernel_cpu,26382,0,1,1,64,0,0,0,0,1,14620000
nn_kernel_gpu,894,1,1,114219,128,0,0,0,0,1,14620000
nn_kernel_gpu_mem,16148,1,1,114219,128,116960000,58480000,58480000,116960000,1,14620000
nn_kernel_cpu,19367,0,1,1,64,0,0,0,0,1,14630000
nn_kernel_gpu,901,1,1,114297,128,0,0,0,0,1,14630000
nn_kernel_gpu_mem,16724,1,1,114297,128,117040000,58520000,58520000,117040000,1,14630000
nn_kernel_cpu,16024,0,1,1,64,0,0,0,0,1,14640000
nn_kernel_gpu,901,1,1,114375,128,0,0,0,0,1,14640000
nn_kernel_gpu_mem,22094,1,1,114375,128,117120000,58560000,58560000,117120000,1,14640000
nn_kernel_cpu,21337,0,1,1,64,0,0,0,0,1,14650000
nn_kernel_gpu,911,1,1,114454,128,0,0,0,0,1,14650000
nn_kernel_gpu_mem,16901,1,1,114454,128,117200000,58600000,58600000,117200000,1,14650000
nn_kernel_cpu,11644,0,1,1,64,0,0,0,0,1,14660000
nn_kernel_gpu,908,1,1,114532,128,0,0,0,0,1,14660000
nn_kernel_gpu_mem,22047,1,1,114532,128,117280000,58640000,58640000,117280000,1,14660000
nn_kernel_cpu,23472,0,1,1,64,0,0,0,0,1,14670000
nn_kernel_gpu,903,1,1,114610,128,0,0,0,0,1,14670000
nn_kernel_gpu_mem,24176,1,1,114610,128,117360000,58680000,58680000,117360000,1,14670000
nn_kernel_cpu,10755,0,1,1,64,0,0,0,0,1,14680000
nn_kernel_gpu,911,1,1,114688,128,0,0,0,0,1,14680000
nn_kernel_gpu_mem,23858,1,1,114688,128,117440000,58720000,58720000,117440000,1,14680000
nn_kernel_cpu,12860,0,1,1,64,0,0,0,0,1,14690000
nn_kernel_gpu,900,1,1,114766,128,0,0,0,0,1,14690000
nn_kernel_gpu_mem,22811,1,1,114766,128,117520000,58760000,58760000,117520000,1,14690000
nn_kernel_cpu,7512,0,1,1,64,0,0,0,0,1,14700000
nn_kernel_gpu,896,1,1,114844,128,0,0,0,0,1,14700000
nn_kernel_gpu_mem,21387,1,1,114844,128,117600000,58800000,58800000,117600000,1,14700000
nn_kernel_cpu,22564,0,1,1,64,0,0,0,0,1,1470000
nn_kernel_gpu,147,1,1,11485,128,0,0,0,0,1,1470000
nn_kernel_gpu_mem,2538,1,1,11485,128,11760000,5880000,5880000,11760000,1,1470000
nn_kernel_cpu,48581,0,1,1,64,0,0,0,0,1,14710000
nn_kernel_gpu,907,1,1,114922,128,0,0,0,0,1,14710000
nn_kernel_gpu_mem,16652,1,1,114922,128,117680000,58840000,58840000,117680000,1,14710000
nn_kernel_cpu,15780,0,1,1,64,0,0,0,0,1,14720000
nn_kernel_gpu,913,1,1,115000,128,0,0,0,0,1,14720000
nn_kernel_gpu_mem,27223,1,1,115000,128,117760000,58880000,58880000,117760000,1,14720000
nn_kernel_cpu,18982,0,1,1,64,0,0,0,0,1,14730000
nn_kernel_gpu,912,1,1,115079,128,0,0,0,0,1,14730000
nn_kernel_gpu_mem,23358,1,1,115079,128,117840000,58920000,58920000,117840000,1,14730000
nn_kernel_cpu,5979,0,1,1,64,0,0,0,0,1,14740000
nn_kernel_gpu,911,1,1,115157,128,0,0,0,0,1,14740000
nn_kernel_gpu_mem,23944,1,1,115157,128,117920000,58960000,58960000,117920000,1,14740000
nn_kernel_cpu,13685,0,1,1,64,0,0,0,0,1,14750000
nn_kernel_gpu,909,1,1,115235,128,0,0,0,0,1,14750000
nn_kernel_gpu_mem,17272,1,1,115235,128,118000000,59000000,59000000,118000000,1,14750000
nn_kernel_cpu,27455,0,1,1,64,0,0,0,0,1,14760000
nn_kernel_gpu,912,1,1,115313,128,0,0,0,0,1,14760000
nn_kernel_gpu_mem,25319,1,1,115313,128,118080000,59040000,59040000,118080000,1,14760000
nn_kernel_cpu,27486,0,1,1,64,0,0,0,0,1,14770000
nn_kernel_gpu,908,1,1,115391,128,0,0,0,0,1,14770000
nn_kernel_gpu_mem,26274,1,1,115391,128,118160000,59080000,59080000,118160000,1,14770000
nn_kernel_cpu,8711,0,1,1,64,0,0,0,0,1,14780000
nn_kernel_gpu,910,1,1,115469,128,0,0,0,0,1,14780000
nn_kernel_gpu_mem,24819,1,1,115469,128,118240000,59120000,59120000,118240000,1,14780000
nn_kernel_cpu,15171,0,1,1,64,0,0,0,0,1,14790000
nn_kernel_gpu,920,1,1,115547,128,0,0,0,0,1,14790000
nn_kernel_gpu_mem,26804,1,1,115547,128,118320000,59160000,59160000,118320000,1,14790000
nn_kernel_cpu,6760,0,1,1,64,0,0,0,0,1,14800000
nn_kernel_gpu,907,1,1,115625,128,0,0,0,0,1,14800000
nn_kernel_gpu_mem,21879,1,1,115625,128,118400000,59200000,59200000,118400000,1,14800000
nn_kernel_cpu,16552,0,1,1,64,0,0,0,0,1,1480000
nn_kernel_gpu,146,1,1,11563,128,0,0,0,0,1,1480000
nn_kernel_gpu_mem,2747,1,1,11563,128,11840000,5920000,5920000,11840000,1,1480000
nn_kernel_cpu,8392,0,1,1,64,0,0,0,0,1,14810000
nn_kernel_gpu,902,1,1,115704,128,0,0,0,0,1,14810000
nn_kernel_gpu_mem,23565,1,1,115704,128,118480000,59240000,59240000,118480000,1,14810000
nn_kernel_cpu,7691,0,1,1,64,0,0,0,0,1,14820000
nn_kernel_gpu,912,1,1,115782,128,0,0,0,0,1,14820000
nn_kernel_gpu_mem,22752,1,1,115782,128,118560000,59280000,59280000,118560000,1,14820000
nn_kernel_cpu,19250,0,1,1,64,0,0,0,0,1,14830000
nn_kernel_gpu,906,1,1,115860,128,0,0,0,0,1,14830000
nn_kernel_gpu_mem,16275,1,1,115860,128,118640000,59320000,59320000,118640000,1,14830000
nn_kernel_cpu,10894,0,1,1,64,0,0,0,0,1,14840000
nn_kernel_gpu,918,1,1,115938,128,0,0,0,0,1,14840000
nn_kernel_gpu_mem,26123,1,1,115938,128,118720000,59360000,59360000,118720000,1,14840000
nn_kernel_cpu,12898,0,1,1,64,0,0,0,0,1,14850000
nn_kernel_gpu,917,1,1,116016,128,0,0,0,0,1,14850000
nn_kernel_gpu_mem,26104,1,1,116016,128,118800000,59400000,59400000,118800000,1,14850000
nn_kernel_cpu,22591,0,1,1,64,0,0,0,0,1,14860000
nn_kernel_gpu,915,1,1,116094,128,0,0,0,0,1,14860000
nn_kernel_gpu_mem,17920,1,1,116094,128,118880000,59440000,59440000,118880000,1,14860000
nn_kernel_cpu,23408,0,1,1,64,0,0,0,0,1,14870000
nn_kernel_gpu,914,1,1,116172,128,0,0,0,0,1,14870000
nn_kernel_gpu_mem,25406,1,1,116172,128,118960000,59480000,59480000,118960000,1,14870000
nn_kernel_cpu,20018,0,1,1,64,0,0,0,0,1,14880000
nn_kernel_gpu,920,1,1,116250,128,0,0,0,0,1,14880000
nn_kernel_gpu_mem,27770,1,1,116250,128,119040000,59520000,59520000,119040000,1,14880000
nn_kernel_cpu,11527,0,1,1,64,0,0,0,0,1,14890000
nn_kernel_gpu,921,1,1,116329,128,0,0,0,0,1,14890000
nn_kernel_gpu_mem,17253,1,1,116329,128,119120000,59560000,59560000,119120000,1,14890000
nn_kernel_cpu,10159,0,1,1,64,0,0,0,0,1,14900000
nn_kernel_gpu,914,1,1,116407,128,0,0,0,0,1,14900000
nn_kernel_gpu_mem,18965,1,1,116407,128,119200000,59600000,59600000,119200000,1,14900000
nn_kernel_cpu,3783,0,1,1,64,0,0,0,0,1,1490000
nn_kernel_gpu,140,1,1,11641,128,0,0,0,0,1,1490000
nn_kernel_gpu_mem,2699,1,1,11641,128,11920000,5960000,5960000,11920000,1,1490000
nn_kernel_cpu,12051,0,1,1,64,0,0,0,0,1,14910000
nn_kernel_gpu,920,1,1,116485,128,0,0,0,0,1,14910000
nn_kernel_gpu_mem,16575,1,1,116485,128,119280000,59640000,59640000,119280000,1,14910000
nn_kernel_cpu,22283,0,1,1,64,0,0,0,0,1,14920000
nn_kernel_gpu,914,1,1,116563,128,0,0,0,0,1,14920000
nn_kernel_gpu_mem,16761,1,1,116563,128,119360000,59680000,59680000,119360000,1,14920000
nn_kernel_cpu,14586,0,1,1,64,0,0,0,0,1,14930000
nn_kernel_gpu,917,1,1,116641,128,0,0,0,0,1,14930000
nn_kernel_gpu_mem,16423,1,1,116641,128,119440000,59720000,59720000,119440000,1,14930000
nn_kernel_cpu,7730,0,1,1,64,0,0,0,0,1,14940000
nn_kernel_gpu,923,1,1,116719,128,0,0,0,0,1,14940000
nn_kernel_gpu_mem,16756,1,1,116719,128,119520000,59760000,59760000,119520000,1,14940000
nn_kernel_cpu,28895,0,1,1,64,0,0,0,0,1,14950000
nn_kernel_gpu,914,1,1,116797,128,0,0,0,0,1,14950000
nn_kernel_gpu_mem,17213,1,1,116797,128,119600000,59800000,59800000,119600000,1,14950000
nn_kernel_cpu,26599,0,1,1,64,0,0,0,0,1,14960000
nn_kernel_gpu,917,1,1,116875,128,0,0,0,0,1,14960000
nn_kernel_gpu_mem,23399,1,1,116875,128,119680000,59840000,59840000,119680000,1,14960000
nn_kernel_cpu,35094,0,1,1,64,0,0,0,0,1,14970000
nn_kernel_gpu,927,1,1,116954,128,0,0,0,0,1,14970000
nn_kernel_gpu_mem,27345,1,1,116954,128,119760000,59880000,59880000,119760000,1,14970000
nn_kernel_cpu,12241,0,1,1,64,0,0,0,0,1,14980000
nn_kernel_gpu,926,1,1,117032,128,0,0,0,0,1,14980000
nn_kernel_gpu_mem,27248,1,1,117032,128,119840000,59920000,59920000,119840000,1,14980000
nn_kernel_cpu,6871,0,1,1,64,0,0,0,0,1,14990000
nn_kernel_gpu,932,1,1,117110,128,0,0,0,0,1,14990000
nn_kernel_gpu_mem,22072,1,1,117110,128,119920000,59960000,59960000,119920000,1,14990000
nn_kernel_cpu,21963,0,1,1,64,0,0,0,0,1,15000000
nn_kernel_gpu,929,1,1,117188,128,0,0,0,0,1,15000000
nn_kernel_gpu_mem,16634,1,1,117188,128,120000000,60000000,60000000,120000000,1,15000000
nn_kernel_cpu,18438,0,1,1,64,0,0,0,0,1,1500000
nn_kernel_gpu,148,1,1,11719,128,0,0,0,0,1,1500000
nn_kernel_gpu_mem,2439,1,1,11719,128,12000000,6000000,6000000,12000000,1,1500000
nn_kernel_cpu,13543,0,1,1,64,0,0,0,0,1,150000
nn_kernel_gpu,39,1,1,1172,128,0,0,0,0,1,150000
nn_kernel_gpu_mem,593,1,1,1172,128,1200000,600000,600000,1200000,1,150000
nn_kernel_cpu,23436,0,1,1,64,0,0,0,0,1,15010000
nn_kernel_gpu,916,1,1,117266,128,0,0,0,0,1,15010000
nn_kernel_gpu_mem,17178,1,1,117266,128,120080000,60040000,60040000,120080000,1,15010000
nn_kernel_cpu,23458,0,1,1,64,0,0,0,0,1,15020000
nn_kernel_gpu,920,1,1,117344,128,0,0,0,0,1,15020000
nn_kernel_gpu_mem,26564,1,1,117344,128,120160000,60080000,60080000,120160000,1,15020000
nn_kernel_cpu,8203,0,1,1,64,0,0,0,0,1,15030000
nn_kernel_gpu,921,1,1,117422,128,0,0,0,0,1,15030000
nn_kernel_gpu_mem,26916,1,1,117422,128,120240000,60120000,60120000,120240000,1,15030000
nn_kernel_cpu,26528,0,1,1,64,0,0,0,0,1,15040000
nn_kernel_gpu,939,1,1,117500,128,0,0,0,0,1,15040000
nn_kernel_gpu_mem,25677,1,1,117500,128,120320000,60160000,60160000,120320000,1,15040000
nn_kernel_cpu,7552,0,1,1,64,0,0,0,0,1,15050000
nn_kernel_gpu,953,1,1,117579,128,0,0,0,0,1,15050000
nn_kernel_gpu_mem,29141,1,1,117579,128,120400000,60200000,60200000,120400000,1,15050000
nn_kernel_cpu,17515,0,1,1,64,0,0,0,0,1,15060000
nn_kernel_gpu,912,1,1,117657,128,0,0,0,0,1,15060000
nn_kernel_gpu_mem,16909,1,1,117657,128,120480000,60240000,60240000,120480000,1,15060000
nn_kernel_cpu,15786,0,1,1,64,0,0,0,0,1,15070000
nn_kernel_gpu,922,1,1,117735,128,0,0,0,0,1,15070000
nn_kernel_gpu_mem,21426,1,1,117735,128,120560000,60280000,60280000,120560000,1,15070000
nn_kernel_cpu,25918,0,1,1,64,0,0,0,0,1,15080000
nn_kernel_gpu,955,1,1,117813,128,0,0,0,0,1,15080000
nn_kernel_gpu_mem,24666,1,1,117813,128,120640000,60320000,60320000,120640000,1,15080000
nn_kernel_cpu,22069,0,1,1,64,0,0,0,0,1,15090000
nn_kernel_gpu,935,1,1,117891,128,0,0,0,0,1,15090000
nn_kernel_gpu_mem,16858,1,1,117891,128,120720000,60360000,60360000,120720000,1,15090000
nn_kernel_cpu,26084,0,1,1,64,0,0,0,0,1,15100000
nn_kernel_gpu,937,1,1,117969,128,0,0,0,0,1,15100000
nn_kernel_gpu_mem,17177,1,1,117969,128,120800000,60400000,60400000,120800000,1,15100000
nn_kernel_cpu,32370,0,1,1,64,0,0,0,0,1,1510000
nn_kernel_gpu,145,1,1,11797,128,0,0,0,0,1,1510000
nn_kernel_gpu_mem,3447,1,1,11797,128,12080000,6040000,6040000,12080000,1,1510000
nn_kernel_cpu,28495,0,1,1,64,0,0,0,0,1,15110000
nn_kernel_gpu,955,1,1,118047,128,0,0,0,0,1,15110000
nn_kernel_gpu_mem,24751,1,1,118047,128,120880000,60440000,60440000,120880000,1,15110000
nn_kernel_cpu,23373,0,1,1,64,0,0,0,0,1,15120000
nn_kernel_gpu,922,1,1,118125,128,0,0,0,0,1,15120000
nn_kernel_gpu_mem,16953,1,1,118125,128,120960000,60480000,60480000,120960000,1,15120000
nn_kernel_cpu,21878,0,1,1,64,0,0,0,0,1,15130000
nn_kernel_gpu,923,1,1,118204,128,0,0,0,0,1,15130000
nn_kernel_gpu_mem,24355,1,1,118204,128,121040000,60520000,60520000,121040000,1,15130000
nn_kernel_cpu,21392,0,1,1,64,0,0,0,0,1,15140000
nn_kernel_gpu,932,1,1,118282,128,0,0,0,0,1,15140000
nn_kernel_gpu_mem,24794,1,1,118282,128,121120000,60560000,60560000,121120000,1,15140000
nn_kernel_cpu,19491,0,1,1,64,0,0,0,0,1,15150000
nn_kernel_gpu,920,1,1,118360,128,0,0,0,0,1,15150000
nn_kernel_gpu_mem,16665,1,1,118360,128,121200000,60600000,60600000,121200000,1,15150000
nn_kernel_cpu,25425,0,1,1,64,0,0,0,0,1,15160000
nn_kernel_gpu,930,1,1,118438,128,0,0,0,0,1,15160000
nn_kernel_gpu_mem,16896,1,1,118438,128,121280000,60640000,60640000,121280000,1,15160000
nn_kernel_cpu,16171,0,1,1,64,0,0,0,0,1,15170000
nn_kernel_gpu,929,1,1,118516,128,0,0,0,0,1,15170000
nn_kernel_gpu_mem,24400,1,1,118516,128,121360000,60680000,60680000,121360000,1,15170000
nn_kernel_cpu,29005,0,1,1,64,0,0,0,0,1,15180000
nn_kernel_gpu,938,1,1,118594,128,0,0,0,0,1,15180000
nn_kernel_gpu_mem,27971,1,1,118594,128,121440000,60720000,60720000,121440000,1,15180000
nn_kernel_cpu,14425,0,1,1,64,0,0,0,0,1,15190000
nn_kernel_gpu,929,1,1,118672,128,0,0,0,0,1,15190000
nn_kernel_gpu_mem,17306,1,1,118672,128,121520000,60760000,60760000,121520000,1,15190000
nn_kernel_cpu,20185,0,1,1,64,0,0,0,0,1,15200000
nn_kernel_gpu,919,1,1,118750,128,0,0,0,0,1,15200000
nn_kernel_gpu_mem,16882,1,1,118750,128,121600000,60800000,60800000,121600000,1,15200000
nn_kernel_cpu,34107,0,1,1,64,0,0,0,0,1,1520000
nn_kernel_gpu,146,1,1,11875,128,0,0,0,0,1,1520000
nn_kernel_gpu_mem,2736,1,1,11875,128,12160000,6080000,6080000,12160000,1,1520000
nn_kernel_cpu,22708,0,1,1,64,0,0,0,0,1,15210000
nn_kernel_gpu,926,1,1,118829,128,0,0,0,0,1,15210000
nn_kernel_gpu_mem,25433,1,1,118829,128,121680000,60840000,60840000,121680000,1,15210000
nn_kernel_cpu,23649,0,1,1,64,0,0,0,0,1,15220000
nn_kernel_gpu,935,1,1,118907,128,0,0,0,0,1,15220000
nn_kernel_gpu_mem,21543,1,1,118907,128,121760000,60880000,60880000,121760000,1,15220000
nn_kernel_cpu,21991,0,1,1,64,0,0,0,0,1,15230000
nn_kernel_gpu,929,1,1,118985,128,0,0,0,0,1,15230000
nn_kernel_gpu_mem,17044,1,1,118985,128,121840000,60920000,60920000,121840000,1,15230000
nn_kernel_cpu,24158,0,1,1,64,0,0,0,0,1,15240000
nn_kernel_gpu,948,1,1,119063,128,0,0,0,0,1,15240000
nn_kernel_gpu_mem,22460,1,1,119063,128,121920000,60960000,60960000,121920000,1,15240000
nn_kernel_cpu,21714,0,1,1,64,0,0,0,0,1,15250000
nn_kernel_gpu,937,1,1,119141,128,0,0,0,0,1,15250000
nn_kernel_gpu_mem,28995,1,1,119141,128,122000000,61000000,61000000,122000000,1,15250000
nn_kernel_cpu,20275,0,1,1,64,0,0,0,0,1,15260000
nn_kernel_gpu,934,1,1,119219,128,0,0,0,0,1,15260000
nn_kernel_gpu_mem,22897,1,1,119219,128,122080000,61040000,61040000,122080000,1,15260000
nn_kernel_cpu,12926,0,1,1,64,0,0,0,0,1,15270000
nn_kernel_gpu,938,1,1,119297,128,0,0,0,0,1,15270000
nn_kernel_gpu_mem,20584,1,1,119297,128,122160000,61080000,61080000,122160000,1,15270000
nn_kernel_cpu,23256,0,1,1,64,0,0,0,0,1,15280000
nn_kernel_gpu,954,1,1,119375,128,0,0,0,0,1,15280000
nn_kernel_gpu_mem,27263,1,1,119375,128,122240000,61120000,61120000,122240000,1,15280000
nn_kernel_cpu,25394,0,1,1,64,0,0,0,0,1,15290000
nn_kernel_gpu,930,1,1,119454,128,0,0,0,0,1,15290000
nn_kernel_gpu_mem,17171,1,1,119454,128,122320000,61160000,61160000,122320000,1,15290000
nn_kernel_cpu,21435,0,1,1,64,0,0,0,0,1,15300000
nn_kernel_gpu,939,1,1,119532,128,0,0,0,0,1,15300000
nn_kernel_gpu_mem,17415,1,1,119532,128,122400000,61200000,61200000,122400000,1,15300000
nn_kernel_cpu,17447,0,1,1,64,0,0,0,0,1,1530000
nn_kernel_gpu,141,1,1,11954,128,0,0,0,0,1,1530000
nn_kernel_gpu_mem,2824,1,1,11954,128,12240000,6120000,6120000,12240000,1,1530000
nn_kernel_cpu,26256,0,1,1,64,0,0,0,0,1,15310000
nn_kernel_gpu,938,1,1,119610,128,0,0,0,0,1,15310000
nn_kernel_gpu_mem,24244,1,1,119610,128,122480000,61240000,61240000,122480000,1,15310000
nn_kernel_cpu,27076,0,1,1,64,0,0,0,0,1,15320000
nn_kernel_gpu,941,1,1,119688,128,0,0,0,0,1,15320000
nn_kernel_gpu_mem,25122,1,1,119688,128,122560000,61280000,61280000,122560000,1,15320000
nn_kernel_cpu,25188,0,1,1,64,0,0,0,0,1,15330000
nn_kernel_gpu,950,1,1,119766,128,0,0,0,0,1,15330000
nn_kernel_gpu_mem,26201,1,1,119766,128,122640000,61320000,61320000,122640000,1,15330000
nn_kernel_cpu,24297,0,1,1,64,0,0,0,0,1,15340000
nn_kernel_gpu,942,1,1,119844,128,0,0,0,0,1,15340000
nn_kernel_gpu_mem,43132,1,1,119844,128,122720000,61360000,61360000,122720000,1,15340000
nn_kernel_cpu,25113,0,1,1,64,0,0,0,0,1,15350000
nn_kernel_gpu,939,1,1,119922,128,0,0,0,0,1,15350000
nn_kernel_gpu_mem,23074,1,1,119922,128,122800000,61400000,61400000,122800000,1,15350000
nn_kernel_cpu,27190,0,1,1,64,0,0,0,0,1,15360000
nn_kernel_gpu,937,1,1,120000,128,0,0,0,0,1,15360000
nn_kernel_gpu_mem,24382,1,1,120000,128,122880000,61440000,61440000,122880000,1,15360000
nn_kernel_cpu,14212,0,1,1,64,0,0,0,0,1,15370000
nn_kernel_gpu,952,1,1,120079,128,0,0,0,0,1,15370000
nn_kernel_gpu_mem,27436,1,1,120079,128,122960000,61480000,61480000,122960000,1,15370000
nn_kernel_cpu,20118,0,1,1,64,0,0,0,0,1,15380000
nn_kernel_gpu,937,1,1,120157,128,0,0,0,0,1,15380000
nn_kernel_gpu_mem,25315,1,1,120157,128,123040000,61520000,61520000,123040000,1,15380000
nn_kernel_cpu,29593,0,1,1,64,0,0,0,0,1,15390000
nn_kernel_gpu,945,1,1,120235,128,0,0,0,0,1,15390000
nn_kernel_gpu_mem,23098,1,1,120235,128,123120000,61560000,61560000,123120000,1,15390000
nn_kernel_cpu,28659,0,1,1,64,0,0,0,0,1,15400000
nn_kernel_gpu,948,1,1,120313,128,0,0,0,0,1,15400000
nn_kernel_gpu_mem,25945,1,1,120313,128,123200000,61600000,61600000,123200000,1,15400000
nn_kernel_cpu,27513,0,1,1,64,0,0,0,0,1,1540000
nn_kernel_gpu,132,1,1,12032,128,0,0,0,0,1,1540000
nn_kernel_gpu_mem,3445,1,1,12032,128,12320000,6160000,6160000,12320000,1,1540000
nn_kernel_cpu,31268,0,1,1,64,0,0,0,0,1,15410000
nn_kernel_gpu,946,1,1,120391,128,0,0,0,0,1,15410000
nn_kernel_gpu_mem,17064,1,1,120391,128,123280000,61640000,61640000,123280000,1,15410000
nn_kernel_cpu,21170,0,1,1,64,0,0,0,0,1,15420000
nn_kernel_gpu,946,1,1,120469,128,0,0,0,0,1,15420000
nn_kernel_gpu_mem,25611,1,1,120469,128,123360000,61680000,61680000,123360000,1,15420000
nn_kernel_cpu,45545,0,1,1,64,0,0,0,0,1,15430000
nn_kernel_gpu,973,1,1,120547,128,0,0,0,0,1,15430000
nn_kernel_gpu_mem,26528,1,1,120547,128,123440000,61720000,61720000,123440000,1,15430000
nn_kernel_cpu,34583,0,1,1,64,0,0,0,0,1,15440000
nn_kernel_gpu,947,1,1,120625,128,0,0,0,0,1,15440000
nn_kernel_gpu_mem,24507,1,1,120625,128,123520000,61760000,61760000,123520000,1,15440000
nn_kernel_cpu,25261,0,1,1,64,0,0,0,0,1,15450000
nn_kernel_gpu,931,1,1,120704,128,0,0,0,0,1,15450000
nn_kernel_gpu_mem,24049,1,1,120704,128,123600000,61800000,61800000,123600000,1,15450000
nn_kernel_cpu,30557,0,1,1,64,0,0,0,0,1,15460000
nn_kernel_gpu,939,1,1,120782,128,0,0,0,0,1,15460000
nn_kernel_gpu_mem,29742,1,1,120782,128,123680000,61840000,61840000,123680000,1,15460000
nn_kernel_cpu,26825,0,1,1,64,0,0,0,0,1,15470000
nn_kernel_gpu,948,1,1,120860,128,0,0,0,0,1,15470000
nn_kernel_gpu_mem,23692,1,1,120860,128,123760000,61880000,61880000,123760000,1,15470000
nn_kernel_cpu,25619,0,1,1,64,0,0,0,0,1,15480000
nn_kernel_gpu,951,1,1,120938,128,0,0,0,0,1,15480000
nn_kernel_gpu_mem,25388,1,1,120938,128,123840000,61920000,61920000,123840000,1,15480000
nn_kernel_cpu,25779,0,1,1,64,0,0,0,0,1,15490000
nn_kernel_gpu,944,1,1,121016,128,0,0,0,0,1,15490000
nn_kernel_gpu_mem,27983,1,1,121016,128,123920000,61960000,61960000,123920000,1,15490000
nn_kernel_cpu,16258,0,1,1,64,0,0,0,0,1,15500000
nn_kernel_gpu,944,1,1,121094,128,0,0,0,0,1,15500000
nn_kernel_gpu_mem,16894,1,1,121094,128,124000000,62000000,62000000,124000000,1,15500000
nn_kernel_cpu,19949,0,1,1,64,0,0,0,0,1,1550000
nn_kernel_gpu,155,1,1,12110,128,0,0,0,0,1,1550000
nn_kernel_gpu_mem,2821,1,1,12110,128,12400000,6200000,6200000,12400000,1,1550000
nn_kernel_cpu,17198,0,1,1,64,0,0,0,0,1,15510000
nn_kernel_gpu,960,1,1,121172,128,0,0,0,0,1,15510000
nn_kernel_gpu_mem,36840,1,1,121172,128,124080000,62040000,62040000,124080000,1,15510000
nn_kernel_cpu,32291,0,1,1,64,0,0,0,0,1,15520000
nn_kernel_gpu,951,1,1,121250,128,0,0,0,0,1,15520000
nn_kernel_gpu_mem,22811,1,1,121250,128,124160000,62080000,62080000,124160000,1,15520000
nn_kernel_cpu,18457,0,1,1,64,0,0,0,0,1,15530000
nn_kernel_gpu,955,1,1,121329,128,0,0,0,0,1,15530000
nn_kernel_gpu_mem,17486,1,1,121329,128,124240000,62120000,62120000,124240000,1,15530000
nn_kernel_cpu,18699,0,1,1,64,0,0,0,0,1,15540000
nn_kernel_gpu,961,1,1,121407,128,0,0,0,0,1,15540000
nn_kernel_gpu_mem,17060,1,1,121407,128,124320000,62160000,62160000,124320000,1,15540000
nn_kernel_cpu,15345,0,1,1,64,0,0,0,0,1,15550000
nn_kernel_gpu,962,1,1,121485,128,0,0,0,0,1,15550000
nn_kernel_gpu_mem,17619,1,1,121485,128,124400000,62200000,62200000,124400000,1,15550000
nn_kernel_cpu,22172,0,1,1,64,0,0,0,0,1,15560000
nn_kernel_gpu,947,1,1,121563,128,0,0,0,0,1,15560000
nn_kernel_gpu_mem,17316,1,1,121563,128,124480000,62240000,62240000,124480000,1,15560000
nn_kernel_cpu,20886,0,1,1,64,0,0,0,0,1,15570000
nn_kernel_gpu,958,1,1,121641,128,0,0,0,0,1,15570000
nn_kernel_gpu_mem,25504,1,1,121641,128,124560000,62280000,62280000,124560000,1,15570000
nn_kernel_cpu,18770,0,1,1,64,0,0,0,0,1,15580000
nn_kernel_gpu,958,1,1,121719,128,0,0,0,0,1,15580000
nn_kernel_gpu_mem,23684,1,1,121719,128,124640000,62320000,62320000,124640000,1,15580000
nn_kernel_cpu,19065,0,1,1,64,0,0,0,0,1,15590000
nn_kernel_gpu,949,1,1,121797,128,0,0,0,0,1,15590000
nn_kernel_gpu_mem,43366,1,1,121797,128,124720000,62360000,62360000,124720000,1,15590000
nn_kernel_cpu,25698,0,1,1,64,0,0,0,0,1,15600000
nn_kernel_gpu,952,1,1,121875,128,0,0,0,0,1,15600000
nn_kernel_gpu_mem,17438,1,1,121875,128,124800000,62400000,62400000,124800000,1,15600000
nn_kernel_cpu,22734,0,1,1,64,0,0,0,0,1,1560000
nn_kernel_gpu,143,1,1,12188,128,0,0,0,0,1,1560000
nn_kernel_gpu_mem,2899,1,1,12188,128,12480000,6240000,6240000,12480000,1,1560000
nn_kernel_cpu,10345,0,1,1,64,0,0,0,0,1,15610000
nn_kernel_gpu,958,1,1,121954,128,0,0,0,0,1,15610000
nn_kernel_gpu_mem,27260,1,1,121954,128,124880000,62440000,62440000,124880000,1,15610000
nn_kernel_cpu,14218,0,1,1,64,0,0,0,0,1,15620000
nn_kernel_gpu,954,1,1,122032,128,0,0,0,0,1,15620000
nn_kernel_gpu_mem,17352,1,1,122032,128,124960000,62480000,62480000,124960000,1,15620000
nn_kernel_cpu,18239,0,1,1,64,0,0,0,0,1,15630000
nn_kernel_gpu,956,1,1,122110,128,0,0,0,0,1,15630000
nn_kernel_gpu_mem,23182,1,1,122110,128,125040000,62520000,62520000,125040000,1,15630000
nn_kernel_cpu,28019,0,1,1,64,0,0,0,0,1,15640000
nn_kernel_gpu,974,1,1,122188,128,0,0,0,0,1,15640000
nn_kernel_gpu_mem,23280,1,1,122188,128,125120000,62560000,62560000,125120000,1,15640000
nn_kernel_cpu,20798,0,1,1,64,0,0,0,0,1,15650000
nn_kernel_gpu,952,1,1,122266,128,0,0,0,0,1,15650000
nn_kernel_gpu_mem,17357,1,1,122266,128,125200000,62600000,62600000,125200000,1,15650000
nn_kernel_cpu,25799,0,1,1,64,0,0,0,0,1,15660000
nn_kernel_gpu,954,1,1,122344,128,0,0,0,0,1,15660000
nn_kernel_gpu_mem,17126,1,1,122344,128,125280000,62640000,62640000,125280000,1,15660000
nn_kernel_cpu,7334,0,1,1,64,0,0,0,0,1,15670000
nn_kernel_gpu,963,1,1,122422,128,0,0,0,0,1,15670000
nn_kernel_gpu_mem,17353,1,1,122422,128,125360000,62680000,62680000,125360000,1,15670000
nn_kernel_cpu,26455,0,1,1,64,0,0,0,0,1,15680000
nn_kernel_gpu,971,1,1,122500,128,0,0,0,0,1,15680000
nn_kernel_gpu_mem,17474,1,1,122500,128,125440000,62720000,62720000,125440000,1,15680000
nn_kernel_cpu,28111,0,1,1,64,0,0,0,0,1,15690000
nn_kernel_gpu,962,1,1,122579,128,0,0,0,0,1,15690000
nn_kernel_gpu_mem,23726,1,1,122579,128,125520000,62760000,62760000,125520000,1,15690000
nn_kernel_cpu,39487,0,1,1,64,0,0,0,0,1,15700000
nn_kernel_gpu,951,1,1,122657,128,0,0,0,0,1,15700000
nn_kernel_gpu_mem,17255,1,1,122657,128,125600000,62800000,62800000,125600000,1,15700000
nn_kernel_cpu,10537,0,1,1,64,0,0,0,0,1,1570000
nn_kernel_gpu,149,1,1,12266,128,0,0,0,0,1,1570000
nn_kernel_gpu_mem,2980,1,1,12266,128,12560000,6280000,6280000,12560000,1,1570000
nn_kernel_cpu,25032,0,1,1,64,0,0,0,0,1,15710000
nn_kernel_gpu,961,1,1,122735,128,0,0,0,0,1,15710000
nn_kernel_gpu_mem,26172,1,1,122735,128,125680000,62840000,62840000,125680000,1,15710000
nn_kernel_cpu,27205,0,1,1,64,0,0,0,0,1,15720000
nn_kernel_gpu,948,1,1,122813,128,0,0,0,0,1,15720000
nn_kernel_gpu_mem,17244,1,1,122813,128,125760000,62880000,62880000,125760000,1,15720000
nn_kernel_cpu,25260,0,1,1,64,0,0,0,0,1,15730000
nn_kernel_gpu,970,1,1,122891,128,0,0,0,0,1,15730000
nn_kernel_gpu_mem,26773,1,1,122891,128,125840000,62920000,62920000,125840000,1,15730000
nn_kernel_cpu,23325,0,1,1,64,0,0,0,0,1,15740000
nn_kernel_gpu,962,1,1,122969,128,0,0,0,0,1,15740000
nn_kernel_gpu_mem,25599,1,1,122969,128,125920000,62960000,62960000,125920000,1,15740000
nn_kernel_cpu,22795,0,1,1,64,0,0,0,0,1,15750000
nn_kernel_gpu,963,1,1,123047,128,0,0,0,0,1,15750000
nn_kernel_gpu_mem,17804,1,1,123047,128,126000000,63000000,63000000,126000000,1,15750000
nn_kernel_cpu,21244,0,1,1,64,0,0,0,0,1,15760000
nn_kernel_gpu,1002,1,1,123125,128,0,0,0,0,1,15760000
nn_kernel_gpu_mem,28747,1,1,123125,128,126080000,63040000,63040000,126080000,1,15760000
nn_kernel_cpu,9409,0,1,1,64,0,0,0,0,1,15770000
nn_kernel_gpu,964,1,1,123204,128,0,0,0,0,1,15770000
nn_kernel_gpu_mem,25446,1,1,123204,128,126160000,63080000,63080000,126160000,1,15770000
nn_kernel_cpu,9668,0,1,1,64,0,0,0,0,1,15780000
nn_kernel_gpu,968,1,1,123282,128,0,0,0,0,1,15780000
nn_kernel_gpu_mem,25626,1,1,123282,128,126240000,63120000,63120000,126240000,1,15780000
nn_kernel_cpu,31670,0,1,1,64,0,0,0,0,1,15790000
nn_kernel_gpu,962,1,1,123360,128,0,0,0,0,1,15790000
nn_kernel_gpu_mem,17518,1,1,123360,128,126320000,63160000,63160000,126320000,1,15790000
nn_kernel_cpu,27016,0,1,1,64,0,0,0,0,1,15800000
nn_kernel_gpu,952,1,1,123438,128,0,0,0,0,1,15800000
nn_kernel_gpu_mem,17827,1,1,123438,128,126400000,63200000,63200000,126400000,1,15800000
nn_kernel_cpu,29807,0,1,1,64,0,0,0,0,1,1580000
nn_kernel_gpu,144,1,1,12344,128,0,0,0,0,1,1580000
nn_kernel_gpu_mem,3288,1,1,12344,128,12640000,6320000,6320000,12640000,1,1580000
nn_kernel_cpu,25401,0,1,1,64,0,0,0,0,1,15810000
nn_kernel_gpu,963,1,1,123516,128,0,0,0,0,1,15810000
nn_kernel_gpu_mem,17891,1,1,123516,128,126480000,63240000,63240000,126480000,1,15810000
nn_kernel_cpu,30791,0,1,1,64,0,0,0,0,1,15820000
nn_kernel_gpu,961,1,1,123594,128,0,0,0,0,1,15820000
nn_kernel_gpu_mem,17564,1,1,123594,128,126560000,63280000,63280000,126560000,1,15820000
nn_kernel_cpu,20979,0,1,1,64,0,0,0,0,1,15830000
nn_kernel_gpu,954,1,1,123672,128,0,0,0,0,1,15830000
nn_kernel_gpu_mem,17515,1,1,123672,128,126640000,63320000,63320000,126640000,1,15830000
nn_kernel_cpu,27328,0,1,1,64,0,0,0,0,1,15840000
nn_kernel_gpu,962,1,1,123750,128,0,0,0,0,1,15840000
nn_kernel_gpu_mem,18132,1,1,123750,128,126720000,63360000,63360000,126720000,1,15840000
nn_kernel_cpu,16606,0,1,1,64,0,0,0,0,1,15850000
nn_kernel_gpu,971,1,1,123829,128,0,0,0,0,1,15850000
nn_kernel_gpu_mem,24821,1,1,123829,128,126800000,63400000,63400000,126800000,1,15850000
nn_kernel_cpu,26966,0,1,1,64,0,0,0,0,1,15860000
nn_kernel_gpu,971,1,1,123907,128,0,0,0,0,1,15860000
nn_kernel_gpu_mem,18138,1,1,123907,128,126880000,63440000,63440000,126880000,1,15860000
nn_kernel_cpu,24687,0,1,1,64,0,0,0,0,1,15870000
nn_kernel_gpu,983,1,1,123985,128,0,0,0,0,1,15870000
nn_kernel_gpu_mem,28453,1,1,123985,128,126960000,63480000,63480000,126960000,1,15870000
nn_kernel_cpu,23468,0,1,1,64,0,0,0,0,1,15880000
nn_kernel_gpu,974,1,1,124063,128,0,0,0,0,1,15880000
nn_kernel_gpu_mem,22494,1,1,124063,128,127040000,63520000,63520000,127040000,1,15880000
nn_kernel_cpu,29094,0,1,1,64,0,0,0,0,1,15890000
nn_kernel_gpu,993,1,1,124141,128,0,0,0,0,1,15890000
nn_kernel_gpu_mem,17523,1,1,124141,128,127120000,63560000,63560000,127120000,1,15890000
nn_kernel_cpu,19814,0,1,1,64,0,0,0,0,1,15900000
nn_kernel_gpu,975,1,1,124219,128,0,0,0,0,1,15900000
nn_kernel_gpu_mem,17826,1,1,124219,128,127200000,63600000,63600000,127200000,1,15900000
nn_kernel_cpu,6498,0,1,1,64,0,0,0,0,1,1590000
nn_kernel_gpu,144,1,1,12422,128,0,0,0,0,1,1590000
nn_kernel_gpu_mem,2797,1,1,12422,128,12720000,6360000,6360000,12720000,1,1590000
nn_kernel_cpu,25086,0,1,1,64,0,0,0,0,1,15910000
nn_kernel_gpu,975,1,1,124297,128,0,0,0,0,1,15910000
nn_kernel_gpu_mem,17476,1,1,124297,128,127280000,63640000,63640000,127280000,1,15910000
nn_kernel_cpu,30043,0,1,1,64,0,0,0,0,1,15920000
nn_kernel_gpu,960,1,1,124375,128,0,0,0,0,1,15920000
nn_kernel_gpu_mem,17518,1,1,124375,128,127360000,63680000,63680000,127360000,1,15920000
nn_kernel_cpu,25297,0,1,1,64,0,0,0,0,1,15930000
nn_kernel_gpu,976,1,1,124454,128,0,0,0,0,1,15930000
nn_kernel_gpu_mem,24273,1,1,124454,128,127440000,63720000,63720000,127440000,1,15930000
nn_kernel_cpu,20656,0,1,1,64,0,0,0,0,1,15940000
nn_kernel_gpu,1001,1,1,124532,128,0,0,0,0,1,15940000
nn_kernel_gpu_mem,27756,1,1,124532,128,127520000,63760000,63760000,127520000,1,15940000
nn_kernel_cpu,27481,0,1,1,64,0,0,0,0,1,15950000
nn_kernel_gpu,990,1,1,124610,128,0,0,0,0,1,15950000
nn_kernel_gpu_mem,26828,1,1,124610,128,127600000,63800000,63800000,127600000,1,15950000
nn_kernel_cpu,15524,0,1,1,64,0,0,0,0,1,15960000
nn_kernel_gpu,978,1,1,124688,128,0,0,0,0,1,15960000
nn_kernel_gpu_mem,17570,1,1,124688,128,127680000,63840000,63840000,127680000,1,15960000
nn_kernel_cpu,25861,0,1,1,64,0,0,0,0,1,15970000
nn_kernel_gpu,964,1,1,124766,128,0,0,0,0,1,15970000
nn_kernel_gpu_mem,17599,1,1,124766,128,127760000,63880000,63880000,127760000,1,15970000
nn_kernel_cpu,10542,0,1,1,64,0,0,0,0,1,15980000
nn_kernel_gpu,975,1,1,124844,128,0,0,0,0,1,15980000
nn_kernel_gpu_mem,35317,1,1,124844,128,127840000,63920000,63920000,127840000,1,15980000
nn_kernel_cpu,31370,0,1,1,64,0,0,0,0,1,15990000
nn_kernel_gpu,970,1,1,124922,128,0,0,0,0,1,15990000
nn_kernel_gpu_mem,17893,1,1,124922,128,127920000,63960000,63960000,127920000,1,15990000
nn_kernel_cpu,19949,0,1,1,64,0,0,0,0,1,16000000
nn_kernel_gpu,983,1,1,125000,128,0,0,0,0,1,16000000
nn_kernel_gpu_mem,28987,1,1,125000,128,128000000,64000000,64000000,128000000,1,16000000
nn_kernel_cpu,10311,0,1,1,64,0,0,0,0,1,1600000
nn_kernel_gpu,135,1,1,12500,128,0,0,0,0,1,1600000
nn_kernel_gpu_mem,3592,1,1,12500,128,12800000,6400000,6400000,12800000,1,1600000
nn_kernel_cpu,1297,0,1,1,64,0,0,0,0,1,160000
nn_kernel_gpu,57,1,1,1250,128,0,0,0,0,1,160000
nn_kernel_gpu_mem,365,1,1,1250,128,1280000,640000,640000,1280000,1,160000
nn_kernel_cpu,28395,0,1,1,64,0,0,0,0,1,16010000
nn_kernel_gpu,977,1,1,125079,128,0,0,0,0,1,16010000
nn_kernel_gpu_mem,18027,1,1,125079,128,128080000,64040000,64040000,128080000,1,16010000
nn_kernel_cpu,22219,0,1,1,64,0,0,0,0,1,16020000
nn_kernel_gpu,991,1,1,125157,128,0,0,0,0,1,16020000
nn_kernel_gpu_mem,24695,1,1,125157,128,128160000,64080000,64080000,128160000,1,16020000
nn_kernel_cpu,26441,0,1,1,64,0,0,0,0,1,16030000
nn_kernel_gpu,984,1,1,125235,128,0,0,0,0,1,16030000
nn_kernel_gpu_mem,27935,1,1,125235,128,128240000,64120000,64120000,128240000,1,16030000
nn_kernel_cpu,23595,0,1,1,64,0,0,0,0,1,16040000
nn_kernel_gpu,983,1,1,125313,128,0,0,0,0,1,16040000
nn_kernel_gpu_mem,26751,1,1,125313,128,128320000,64160000,64160000,128320000,1,16040000
nn_kernel_cpu,23288,0,1,1,64,0,0,0,0,1,16050000
nn_kernel_gpu,978,1,1,125391,128,0,0,0,0,1,16050000
nn_kernel_gpu_mem,29026,1,1,125391,128,128400000,64200000,64200000,128400000,1,16050000
nn_kernel_cpu,24916,0,1,1,64,0,0,0,0,1,16060000
nn_kernel_gpu,1003,1,1,125469,128,0,0,0,0,1,16060000
nn_kernel_gpu_mem,17523,1,1,125469,128,128480000,64240000,64240000,128480000,1,16060000
nn_kernel_cpu,28787,0,1,1,64,0,0,0,0,1,16070000
nn_kernel_gpu,977,1,1,125547,128,0,0,0,0,1,16070000
nn_kernel_gpu_mem,24555,1,1,125547,128,128560000,64280000,64280000,128560000,1,16070000
nn_kernel_cpu,22894,0,1,1,64,0,0,0,0,1,16080000
nn_kernel_gpu,985,1,1,125625,128,0,0,0,0,1,16080000
nn_kernel_gpu_mem,27321,1,1,125625,128,128640000,64320000,64320000,128640000,1,16080000
nn_kernel_cpu,25623,0,1,1,64,0,0,0,0,1,16090000
nn_kernel_gpu,986,1,1,125704,128,0,0,0,0,1,16090000
nn_kernel_gpu_mem,27897,1,1,125704,128,128720000,64360000,64360000,128720000,1,16090000
nn_kernel_cpu,39834,0,1,1,64,0,0,0,0,1,16100000
nn_kernel_gpu,984,1,1,125782,128,0,0,0,0,1,16100000
nn_kernel_gpu_mem,27873,1,1,125782,128,128800000,64400000,64400000,128800000,1,16100000
nn_kernel_cpu,20647,0,1,1,64,0,0,0,0,1,1610000
nn_kernel_gpu,135,1,1,12579,128,0,0,0,0,1,1610000
nn_kernel_gpu_mem,3569,1,1,12579,128,12880000,6440000,6440000,12880000,1,1610000
nn_kernel_cpu,28251,0,1,1,64,0,0,0,0,1,16110000
nn_kernel_gpu,983,1,1,125860,128,0,0,0,0,1,16110000
nn_kernel_gpu_mem,17674,1,1,125860,128,128880000,64440000,64440000,128880000,1,16110000
nn_kernel_cpu,21082,0,1,1,64,0,0,0,0,1,16120000
nn_kernel_gpu,989,1,1,125938,128,0,0,0,0,1,16120000
nn_kernel_gpu_mem,30398,1,1,125938,128,128960000,64480000,64480000,128960000,1,16120000
nn_kernel_cpu,19940,0,1,1,64,0,0,0,0,1,16130000
nn_kernel_gpu,976,1,1,126016,128,0,0,0,0,1,16130000
nn_kernel_gpu_mem,23383,1,1,126016,128,129040000,64520000,64520000,129040000,1,16130000
nn_kernel_cpu,18795,0,1,1,64,0,0,0,0,1,16140000
nn_kernel_gpu,983,1,1,126094,128,0,0,0,0,1,16140000
nn_kernel_gpu_mem,18032,1,1,126094,128,129120000,64560000,64560000,129120000,1,16140000
nn_kernel_cpu,22635,0,1,1,64,0,0,0,0,1,16150000
nn_kernel_gpu,979,1,1,126172,128,0,0,0,0,1,16150000
nn_kernel_gpu_mem,18059,1,1,126172,128,129200000,64600000,64600000,129200000,1,16150000
nn_kernel_cpu,25437,0,1,1,64,0,0,0,0,1,16160000
nn_kernel_gpu,1022,1,1,126250,128,0,0,0,0,1,16160000
nn_kernel_gpu_mem,25078,1,1,126250,128,129280000,64640000,64640000,129280000,1,16160000
nn_kernel_cpu,31021,0,1,1,64,0,0,0,0,1,16170000
nn_kernel_gpu,986,1,1,126329,128,0,0,0,0,1,16170000
nn_kernel_gpu_mem,24976,1,1,126329,128,129360000,64680000,64680000,129360000,1,16170000
nn_kernel_cpu,25748,0,1,1,64,0,0,0,0,1,16180000
nn_kernel_gpu,976,1,1,126407,128,0,0,0,0,1,16180000
nn_kernel_gpu_mem,26753,1,1,126407,128,129440000,64720000,64720000,129440000,1,16180000
nn_kernel_cpu,25847,0,1,1,64,0,0,0,0,1,16190000
nn_kernel_gpu,1002,1,1,126485,128,0,0,0,0,1,16190000
nn_kernel_gpu_mem,24468,1,1,126485,128,129520000,64760000,64760000,129520000,1,16190000
nn_kernel_cpu,22945,0,1,1,64,0,0,0,0,1,16200000
nn_kernel_gpu,1003,1,1,126563,128,0,0,0,0,1,16200000
nn_kernel_gpu_mem,24131,1,1,126563,128,129600000,64800000,64800000,129600000,1,16200000
nn_kernel_cpu,8941,0,1,1,64,0,0,0,0,1,1620000
nn_kernel_gpu,141,1,1,12657,128,0,0,0,0,1,1620000
nn_kernel_gpu_mem,2537,1,1,12657,128,12960000,6480000,6480000,12960000,1,1620000
nn_kernel_cpu,25998,0,1,1,64,0,0,0,0,1,16210000
nn_kernel_gpu,992,1,1,126641,128,0,0,0,0,1,16210000
nn_kernel_gpu_mem,17899,1,1,126641,128,129680000,64840000,64840000,129680000,1,16210000
nn_kernel_cpu,21474,0,1,1,64,0,0,0,0,1,16220000
nn_kernel_gpu,981,1,1,126719,128,0,0,0,0,1,16220000
nn_kernel_gpu_mem,17800,1,1,126719,128,129760000,64880000,64880000,129760000,1,16220000
nn_kernel_cpu,24919,0,1,1,64,0,0,0,0,1,16230000
nn_kernel_gpu,994,1,1,126797,128,0,0,0,0,1,16230000
nn_kernel_gpu_mem,23320,1,1,126797,128,129840000,64920000,64920000,129840000,1,16230000
nn_kernel_cpu,27103,0,1,1,64,0,0,0,0,1,16240000
nn_kernel_gpu,992,1,1,126875,128,0,0,0,0,1,16240000
nn_kernel_gpu_mem,24545,1,1,126875,128,129920000,64960000,64960000,129920000,1,16240000
nn_kernel_cpu,25077,0,1,1,64,0,0,0,0,1,16250000
nn_kernel_gpu,992,1,1,126954,128,0,0,0,0,1,16250000
nn_kernel_gpu_mem,25227,1,1,126954,128,130000000,65000000,65000000,130000000,1,16250000
nn_kernel_cpu,21030,0,1,1,64,0,0,0,0,1,16260000
nn_kernel_gpu,996,1,1,127032,128,0,0,0,0,1,16260000
nn_kernel_gpu_mem,28847,1,1,127032,128,130080000,65040000,65040000,130080000,1,16260000
nn_kernel_cpu,24437,0,1,1,64,0,0,0,0,1,16270000
nn_kernel_gpu,988,1,1,127110,128,0,0,0,0,1,16270000
nn_kernel_gpu_mem,21427,1,1,127110,128,130160000,65080000,65080000,130160000,1,16270000
nn_kernel_cpu,34015,0,1,1,64,0,0,0,0,1,16280000
nn_kernel_gpu,994,1,1,127188,128,0,0,0,0,1,16280000
nn_kernel_gpu_mem,17650,1,1,127188,128,130240000,65120000,65120000,130240000,1,16280000
nn_kernel_cpu,29851,0,1,1,64,0,0,0,0,1,16290000
nn_kernel_gpu,999,1,1,127266,128,0,0,0,0,1,16290000
nn_kernel_gpu_mem,28200,1,1,127266,128,130320000,65160000,65160000,130320000,1,16290000
nn_kernel_cpu,24235,0,1,1,64,0,0,0,0,1,16300000
nn_kernel_gpu,1003,1,1,127344,128,0,0,0,0,1,16300000
nn_kernel_gpu_mem,18162,1,1,127344,128,130400000,65200000,65200000,130400000,1,16300000
nn_kernel_cpu,8398,0,1,1,64,0,0,0,0,1,1630000
nn_kernel_gpu,145,1,1,12735,128,0,0,0,0,1,1630000
nn_kernel_gpu_mem,2996,1,1,12735,128,13040000,6520000,6520000,13040000,1,1630000
nn_kernel_cpu,23648,0,1,1,64,0,0,0,0,1,16310000
nn_kernel_gpu,996,1,1,127422,128,0,0,0,0,1,16310000
nn_kernel_gpu_mem,21201,1,1,127422,128,130480000,65240000,65240000,130480000,1,16310000
nn_kernel_cpu,21318,0,1,1,64,0,0,0,0,1,16320000
nn_kernel_gpu,1018,1,1,127500,128,0,0,0,0,1,16320000
nn_kernel_gpu_mem,30164,1,1,127500,128,130560000,65280000,65280000,130560000,1,16320000
nn_kernel_cpu,29677,0,1,1,64,0,0,0,0,1,16330000
nn_kernel_gpu,1017,1,1,127579,128,0,0,0,0,1,16330000
nn_kernel_gpu_mem,17596,1,1,127579,128,130640000,65320000,65320000,130640000,1,16330000
nn_kernel_cpu,28561,0,1,1,64,0,0,0,0,1,16340000
nn_kernel_gpu,995,1,1,127657,128,0,0,0,0,1,16340000
nn_kernel_gpu_mem,18536,1,1,127657,128,130720000,65360000,65360000,130720000,1,16340000
nn_kernel_cpu,29280,0,1,1,64,0,0,0,0,1,16350000
nn_kernel_gpu,997,1,1,127735,128,0,0,0,0,1,16350000
nn_kernel_gpu_mem,18316,1,1,127735,128,130800000,65400000,65400000,130800000,1,16350000
nn_kernel_cpu,22669,0,1,1,64,0,0,0,0,1,16360000
nn_kernel_gpu,997,1,1,127813,128,0,0,0,0,1,16360000
nn_kernel_gpu_mem,17891,1,1,127813,128,130880000,65440000,65440000,130880000,1,16360000
nn_kernel_cpu,22458,0,1,1,64,0,0,0,0,1,16370000
nn_kernel_gpu,1010,1,1,127891,128,0,0,0,0,1,16370000
nn_kernel_gpu_mem,17828,1,1,127891,128,130960000,65480000,65480000,130960000,1,16370000
nn_kernel_cpu,24823,0,1,1,64,0,0,0,0,1,16380000
nn_kernel_gpu,1018,1,1,127969,128,0,0,0,0,1,16380000
nn_kernel_gpu_mem,28650,1,1,127969,128,131040000,65520000,65520000,131040000,1,16380000
nn_kernel_cpu,36027,0,1,1,64,0,0,0,0,1,16390000
nn_kernel_gpu,1015,1,1,128047,128,0,0,0,0,1,16390000
nn_kernel_gpu_mem,26203,1,1,128047,128,131120000,65560000,65560000,131120000,1,16390000
nn_kernel_cpu,20816,0,1,1,64,0,0,0,0,1,16400000
nn_kernel_gpu,1015,1,1,128125,128,0,0,0,0,1,16400000
nn_kernel_gpu_mem,26907,1,1,128125,128,131200000,65600000,65600000,131200000,1,16400000
nn_kernel_cpu,27555,0,1,1,64,0,0,0,0,1,1640000
nn_kernel_gpu,141,1,1,12813,128,0,0,0,0,1,1640000
nn_kernel_gpu_mem,2263,1,1,12813,128,13120000,6560000,6560000,13120000,1,1640000
nn_kernel_cpu,37125,0,1,1,64,0,0,0,0,1,16410000
nn_kernel_gpu,1032,1,1,128204,128,0,0,0,0,1,16410000
nn_kernel_gpu_mem,25259,1,1,128204,128,131280000,65640000,65640000,131280000,1,16410000
nn_kernel_cpu,16802,0,1,1,64,0,0,0,0,1,16420000
nn_kernel_gpu,995,1,1,128282,128,0,0,0,0,1,16420000
nn_kernel_gpu_mem,18304,1,1,128282,128,131360000,65680000,65680000,131360000,1,16420000
nn_kernel_cpu,25957,0,1,1,64,0,0,0,0,1,16430000
nn_kernel_gpu,1009,1,1,128360,128,0,0,0,0,1,16430000
nn_kernel_gpu_mem,43757,1,1,128360,128,131440000,65720000,65720000,131440000,1,16430000
nn_kernel_cpu,34812,0,1,1,64,0,0,0,0,1,16440000
nn_kernel_gpu,1012,1,1,128438,128,0,0,0,0,1,16440000
nn_kernel_gpu_mem,29420,1,1,128438,128,131520000,65760000,65760000,131520000,1,16440000
nn_kernel_cpu,12073,0,1,1,64,0,0,0,0,1,16450000
nn_kernel_gpu,1013,1,1,128516,128,0,0,0,0,1,16450000
nn_kernel_gpu_mem,20339,1,1,128516,128,131600000,65800000,65800000,131600000,1,16450000
nn_kernel_cpu,22945,0,1,1,64,0,0,0,0,1,16460000
nn_kernel_gpu,1007,1,1,128594,128,0,0,0,0,1,16460000
nn_kernel_gpu_mem,26489,1,1,128594,128,131680000,65840000,65840000,131680000,1,16460000
nn_kernel_cpu,32515,0,1,1,64,0,0,0,0,1,16470000
nn_kernel_gpu,1002,1,1,128672,128,0,0,0,0,1,16470000
nn_kernel_gpu_mem,34849,1,1,128672,128,131760000,65880000,65880000,131760000,1,16470000
nn_kernel_cpu,6431,0,1,1,64,0,0,0,0,1,16480000
nn_kernel_gpu,1009,1,1,128750,128,0,0,0,0,1,16480000
nn_kernel_gpu_mem,18424,1,1,128750,128,131840000,65920000,65920000,131840000,1,16480000
nn_kernel_cpu,11366,0,1,1,64,0,0,0,0,1,16490000
nn_kernel_gpu,996,1,1,128829,128,0,0,0,0,1,16490000
nn_kernel_gpu_mem,18484,1,1,128829,128,131920000,65960000,65960000,131920000,1,16490000
nn_kernel_cpu,24244,0,1,1,64,0,0,0,0,1,16500000
nn_kernel_gpu,1006,1,1,128907,128,0,0,0,0,1,16500000
nn_kernel_gpu_mem,23590,1,1,128907,128,132000000,66000000,66000000,132000000,1,16500000
nn_kernel_cpu,23875,0,1,1,64,0,0,0,0,1,1650000
nn_kernel_gpu,147,1,1,12891,128,0,0,0,0,1,1650000
nn_kernel_gpu_mem,2993,1,1,12891,128,13200000,6600000,6600000,13200000,1,1650000
nn_kernel_cpu,12796,0,1,1,64,0,0,0,0,1,16510000
nn_kernel_gpu,1004,1,1,128985,128,0,0,0,0,1,16510000
nn_kernel_gpu_mem,28992,1,1,128985,128,132080000,66040000,66040000,132080000,1,16510000
nn_kernel_cpu,20856,0,1,1,64,0,0,0,0,1,16520000
nn_kernel_gpu,1004,1,1,129063,128,0,0,0,0,1,16520000
nn_kernel_gpu_mem,26599,1,1,129063,128,132160000,66080000,66080000,132160000,1,16520000
nn_kernel_cpu,12394,0,1,1,64,0,0,0,0,1,16530000
nn_kernel_gpu,1008,1,1,129141,128,0,0,0,0,1,16530000
nn_kernel_gpu_mem,26806,1,1,129141,128,132240000,66120000,66120000,132240000,1,16530000
nn_kernel_cpu,7739,0,1,1,64,0,0,0,0,1,16540000
nn_kernel_gpu,999,1,1,129219,128,0,0,0,0,1,16540000
nn_kernel_gpu_mem,18043,1,1,129219,128,132320000,66160000,66160000,132320000,1,16540000
nn_kernel_cpu,8941,0,1,1,64,0,0,0,0,1,16550000
nn_kernel_gpu,1023,1,1,129297,128,0,0,0,0,1,16550000
nn_kernel_gpu_mem,27639,1,1,129297,128,132400000,66200000,66200000,132400000,1,16550000
nn_kernel_cpu,15861,0,1,1,64,0,0,0,0,1,16560000
nn_kernel_gpu,1009,1,1,129375,128,0,0,0,0,1,16560000
nn_kernel_gpu_mem,26262,1,1,129375,128,132480000,66240000,66240000,132480000,1,16560000
nn_kernel_cpu,22642,0,1,1,64,0,0,0,0,1,16570000
nn_kernel_gpu,1008,1,1,129454,128,0,0,0,0,1,16570000
nn_kernel_gpu_mem,27311,1,1,129454,128,132560000,66280000,66280000,132560000,1,16570000
nn_kernel_cpu,10133,0,1,1,64,0,0,0,0,1,16580000
nn_kernel_gpu,1003,1,1,129532,128,0,0,0,0,1,16580000
nn_kernel_gpu_mem,18427,1,1,129532,128,132640000,66320000,66320000,132640000,1,16580000
nn_kernel_cpu,27290,0,1,1,64,0,0,0,0,1,16590000
nn_kernel_gpu,1023,1,1,129610,128,0,0,0,0,1,16590000
nn_kernel_gpu_mem,26430,1,1,129610,128,132720000,66360000,66360000,132720000,1,16590000
nn_kernel_cpu,23297,0,1,1,64,0,0,0,0,1,16600000
nn_kernel_gpu,1015,1,1,129688,128,0,0,0,0,1,16600000
nn_kernel_gpu_mem,34395,1,1,129688,128,132800000,66400000,66400000,132800000,1,16600000
nn_kernel_cpu,6465,0,1,1,64,0,0,0,0,1,1660000
nn_kernel_gpu,155,1,1,12969,128,0,0,0,0,1,1660000
nn_kernel_gpu_mem,4894,1,1,12969,128,13280000,6640000,6640000,13280000,1,1660000
nn_kernel_cpu,22521,0,1,1,64,0,0,0,0,1,16610000
nn_kernel_gpu,1012,1,1,129766,128,0,0,0,0,1,16610000
nn_kernel_gpu_mem,26270,1,1,129766,128,132880000,66440000,66440000,132880000,1,16610000
nn_kernel_cpu,25652,0,1,1,64,0,0,0,0,1,16620000
nn_kernel_gpu,1030,1,1,129844,128,0,0,0,0,1,16620000
nn_kernel_gpu_mem,27030,1,1,129844,128,132960000,66480000,66480000,132960000,1,16620000
nn_kernel_cpu,9467,0,1,1,64,0,0,0,0,1,16630000
nn_kernel_gpu,1020,1,1,129922,128,0,0,0,0,1,16630000
nn_kernel_gpu_mem,29224,1,1,129922,128,133040000,66520000,66520000,133040000,1,16630000
nn_kernel_cpu,9232,0,1,1,64,0,0,0,0,1,16640000
nn_kernel_gpu,1014,1,1,130000,128,0,0,0,0,1,16640000
nn_kernel_gpu_mem,18069,1,1,130000,128,133120000,66560000,66560000,133120000,1,16640000
nn_kernel_cpu,18331,0,1,1,64,0,0,0,0,1,16650000
nn_kernel_gpu,1022,1,1,130079,128,0,0,0,0,1,16650000
nn_kernel_gpu_mem,29055,1,1,130079,128,133200000,66600000,66600000,133200000,1,16650000
nn_kernel_cpu,16821,0,1,1,64,0,0,0,0,1,16660000
nn_kernel_gpu,1019,1,1,130157,128,0,0,0,0,1,16660000
nn_kernel_gpu_mem,26708,1,1,130157,128,133280000,66640000,66640000,133280000,1,16660000
nn_kernel_cpu,8191,0,1,1,64,0,0,0,0,1,16670000
nn_kernel_gpu,1014,1,1,130235,128,0,0,0,0,1,16670000
nn_kernel_gpu_mem,20406,1,1,130235,128,133360000,66680000,66680000,133360000,1,16670000
nn_kernel_cpu,14212,0,1,1,64,0,0,0,0,1,16680000
nn_kernel_gpu,1011,1,1,130313,128,0,0,0,0,1,16680000
nn_kernel_gpu_mem,24629,1,1,130313,128,133440000,66720000,66720000,133440000,1,16680000
nn_kernel_cpu,16111,0,1,1,64,0,0,0,0,1,16690000
nn_kernel_gpu,1020,1,1,130391,128,0,0,0,0,1,16690000
nn_kernel_gpu_mem,27522,1,1,130391,128,133520000,66760000,66760000,133520000,1,16690000
nn_kernel_cpu,19036,0,1,1,64,0,0,0,0,1,16700000
nn_kernel_gpu,1008,1,1,130469,128,0,0,0,0,1,16700000
nn_kernel_gpu_mem,20127,1,1,130469,128,133600000,66800000,66800000,133600000,1,16700000
nn_kernel_cpu,28552,0,1,1,64,0,0,0,0,1,1670000
nn_kernel_gpu,155,1,1,13047,128,0,0,0,0,1,1670000
nn_kernel_gpu_mem,2844,1,1,13047,128,13360000,6680000,6680000,13360000,1,1670000
nn_kernel_cpu,33250,0,1,1,64,0,0,0,0,1,16710000
nn_kernel_gpu,1026,1,1,130547,128,0,0,0,0,1,16710000
nn_kernel_gpu_mem,28621,1,1,130547,128,133680000,66840000,66840000,133680000,1,16710000
nn_kernel_cpu,27010,0,1,1,64,0,0,0,0,1,16720000
nn_kernel_gpu,1016,1,1,130625,128,0,0,0,0,1,16720000
nn_kernel_gpu_mem,26066,1,1,130625,128,133760000,66880000,66880000,133760000,1,16720000
nn_kernel_cpu,22599,0,1,1,64,0,0,0,0,1,16730000
nn_kernel_gpu,1034,1,1,130704,128,0,0,0,0,1,16730000
nn_kernel_gpu_mem,28949,1,1,130704,128,133840000,66920000,66920000,133840000,1,16730000
nn_kernel_cpu,17698,0,1,1,64,0,0,0,0,1,16740000
nn_kernel_gpu,1028,1,1,130782,128,0,0,0,0,1,16740000
nn_kernel_gpu_mem,29383,1,1,130782,128,133920000,66960000,66960000,133920000,1,16740000
nn_kernel_cpu,24683,0,1,1,64,0,0,0,0,1,16750000
nn_kernel_gpu,1025,1,1,130860,128,0,0,0,0,1,16750000
nn_kernel_gpu_mem,18889,1,1,130860,128,134000000,67000000,67000000,134000000,1,16750000
nn_kernel_cpu,6093,0,1,1,64,0,0,0,0,1,16760000
nn_kernel_gpu,1034,1,1,130938,128,0,0,0,0,1,16760000
nn_kernel_gpu_mem,27776,1,1,130938,128,134080000,67040000,67040000,134080000,1,16760000
nn_kernel_cpu,30242,0,1,1,64,0,0,0,0,1,16770000
nn_kernel_gpu,1017,1,1,131016,128,0,0,0,0,1,16770000
nn_kernel_gpu_mem,18155,1,1,131016,128,134160000,67080000,67080000,134160000,1,16770000
nn_kernel_cpu,37132,0,1,1,64,0,0,0,0,1,16780000
nn_kernel_gpu,1012,1,1,131094,128,0,0,0,0,1,16780000
nn_kernel_gpu_mem,18301,1,1,131094,128,134240000,67120000,67120000,134240000,1,16780000
nn_kernel_cpu,14700,0,1,1,64,0,0,0,0,1,16790000
nn_kernel_gpu,1016,1,1,131172,128,0,0,0,0,1,16790000
nn_kernel_gpu_mem,30641,1,1,131172,128,134320000,67160000,67160000,134320000,1,16790000
nn_kernel_cpu,21308,0,1,1,64,0,0,0,0,1,16800000
nn_kernel_gpu,1026,1,1,131250,128,0,0,0,0,1,16800000
nn_kernel_gpu_mem,18409,1,1,131250,128,134400000,67200000,67200000,134400000,1,16800000
nn_kernel_cpu,5966,0,1,1,64,0,0,0,0,1,1680000
nn_kernel_gpu,160,1,1,13125,128,0,0,0,0,1,1680000
nn_kernel_gpu_mem,4509,1,1,13125,128,13440000,6720000,6720000,13440000,1,1680000
nn_kernel_cpu,24336,0,1,1,64,0,0,0,0,1,16810000
nn_kernel_gpu,1014,1,1,131329,128,0,0,0,0,1,16810000
nn_kernel_gpu_mem,18573,1,1,131329,128,134480000,67240000,67240000,134480000,1,16810000
nn_kernel_cpu,13123,0,1,1,64,0,0,0,0,1,16820000
nn_kernel_gpu,1020,1,1,131407,128,0,0,0,0,1,16820000
nn_kernel_gpu_mem,28717,1,1,131407,128,134560000,67280000,67280000,134560000,1,16820000
nn_kernel_cpu,6971,0,1,1,64,0,0,0,0,1,16830000
nn_kernel_gpu,1026,1,1,131485,128,0,0,0,0,1,16830000
nn_kernel_gpu_mem,29866,1,1,131485,128,134640000,67320000,67320000,134640000,1,16830000
nn_kernel_cpu,53436,0,1,1,64,0,0,0,0,1,16840000
nn_kernel_gpu,1028,1,1,131563,128,0,0,0,0,1,16840000
nn_kernel_gpu_mem,28471,1,1,131563,128,134720000,67360000,67360000,134720000,1,16840000
nn_kernel_cpu,9932,0,1,1,64,0,0,0,0,1,16850000
nn_kernel_gpu,1029,1,1,131641,128,0,0,0,0,1,16850000
nn_kernel_gpu_mem,28519,1,1,131641,128,134800000,67400000,67400000,134800000,1,16850000
nn_kernel_cpu,23501,0,1,1,64,0,0,0,0,1,16860000
nn_kernel_gpu,1030,1,1,131719,128,0,0,0,0,1,16860000
nn_kernel_gpu_mem,33099,1,1,131719,128,134880000,67440000,67440000,134880000,1,16860000
nn_kernel_cpu,13611,0,1,1,64,0,0,0,0,1,16870000
nn_kernel_gpu,1023,1,1,131797,128,0,0,0,0,1,16870000
nn_kernel_gpu_mem,26880,1,1,131797,128,134960000,67480000,67480000,134960000,1,16870000
nn_kernel_cpu,14257,0,1,1,64,0,0,0,0,1,16880000
nn_kernel_gpu,1030,1,1,131875,128,0,0,0,0,1,16880000
nn_kernel_gpu_mem,33963,1,1,131875,128,135040000,67520000,67520000,135040000,1,16880000
nn_kernel_cpu,10801,0,1,1,64,0,0,0,0,1,16890000
nn_kernel_gpu,1019,1,1,131954,128,0,0,0,0,1,16890000
nn_kernel_gpu_mem,28326,1,1,131954,128,135120000,67560000,67560000,135120000,1,16890000
nn_kernel_cpu,26192,0,1,1,64,0,0,0,0,1,16900000
nn_kernel_gpu,1021,1,1,132032,128,0,0,0,0,1,16900000
nn_kernel_gpu_mem,18960,1,1,132032,128,135200000,67600000,67600000,135200000,1,16900000
nn_kernel_cpu,20537,0,1,1,64,0,0,0,0,1,1690000
nn_kernel_gpu,146,1,1,13204,128,0,0,0,0,1,1690000
nn_kernel_gpu_mem,2727,1,1,13204,128,13520000,6760000,6760000,13520000,1,1690000
nn_kernel_cpu,23650,0,1,1,64,0,0,0,0,1,16910000
nn_kernel_gpu,1033,1,1,132110,128,0,0,0,0,1,16910000
nn_kernel_gpu_mem,27028,1,1,132110,128,135280000,67640000,67640000,135280000,1,16910000
nn_kernel_cpu,9348,0,1,1,64,0,0,0,0,1,16920000
nn_kernel_gpu,1024,1,1,132188,128,0,0,0,0,1,16920000
nn_kernel_gpu_mem,29667,1,1,132188,128,135360000,67680000,67680000,135360000,1,16920000
nn_kernel_cpu,24932,0,1,1,64,0,0,0,0,1,16930000
nn_kernel_gpu,1028,1,1,132266,128,0,0,0,0,1,16930000
nn_kernel_gpu_mem,18511,1,1,132266,128,135440000,67720000,67720000,135440000,1,16930000
nn_kernel_cpu,20412,0,1,1,64,0,0,0,0,1,16940000
nn_kernel_gpu,1027,1,1,132344,128,0,0,0,0,1,16940000
nn_kernel_gpu_mem,25142,1,1,132344,128,135520000,67760000,67760000,135520000,1,16940000
nn_kernel_cpu,24074,0,1,1,64,0,0,0,0,1,16950000
nn_kernel_gpu,1024,1,1,132422,128,0,0,0,0,1,16950000
nn_kernel_gpu_mem,18746,1,1,132422,128,135600000,67800000,67800000,135600000,1,16950000
nn_kernel_cpu,23612,0,1,1,64,0,0,0,0,1,16960000
nn_kernel_gpu,1038,1,1,132500,128,0,0,0,0,1,16960000
nn_kernel_gpu_mem,28720,1,1,132500,128,135680000,67840000,67840000,135680000,1,16960000
nn_kernel_cpu,12462,0,1,1,64,0,0,0,0,1,16970000
nn_kernel_gpu,1024,1,1,132579,128,0,0,0,0,1,16970000
nn_kernel_gpu_mem,18588,1,1,132579,128,135760000,67880000,67880000,135760000,1,16970000
nn_kernel_cpu,25765,0,1,1,64,0,0,0,0,1,16980000
nn_kernel_gpu,1035,1,1,132657,128,0,0,0,0,1,16980000
nn_kernel_gpu_mem,28255,1,1,132657,128,135840000,67920000,67920000,135840000,1,16980000
nn_kernel_cpu,12016,0,1,1,64,0,0,0,0,1,16990000
nn_kernel_gpu,1037,1,1,132735,128,0,0,0,0,1,16990000
nn_kernel_gpu_mem,29449,1,1,132735,128,135920000,67960000,67960000,135920000,1,16990000
nn_kernel_cpu,11470,0,1,1,64,0,0,0,0,1,17000000
nn_kernel_gpu,1021,1,1,132813,128,0,0,0,0,1,17000000
nn_kernel_gpu_mem,25073,1,1,132813,128,136000000,68000000,68000000,136000000,1,17000000
nn_kernel_cpu,3529,0,1,1,64,0,0,0,0,1,1700000
nn_kernel_gpu,142,1,1,13282,128,0,0,0,0,1,1700000
nn_kernel_gpu_mem,5116,1,1,13282,128,13600000,6800000,6800000,13600000,1,1700000
nn_kernel_cpu,433,0,1,1,64,0,0,0,0,1,170000
nn_kernel_gpu,51,1,1,1329,128,0,0,0,0,1,170000
nn_kernel_gpu_mem,523,1,1,1329,128,1360000,680000,680000,1360000,1,170000
nn_kernel_cpu,7952,0,1,1,64,0,0,0,0,1,17010000
nn_kernel_gpu,1034,1,1,132891,128,0,0,0,0,1,17010000
nn_kernel_gpu_mem,29755,1,1,132891,128,136080000,68040000,68040000,136080000,1,17010000
nn_kernel_cpu,9366,0,1,1,64,0,0,0,0,1,17020000
nn_kernel_gpu,1069,1,1,132969,128,0,0,0,0,1,17020000
nn_kernel_gpu_mem,30639,1,1,132969,128,136160000,68080000,68080000,136160000,1,17020000
nn_kernel_cpu,28947,0,1,1,64,0,0,0,0,1,17030000
nn_kernel_gpu,1036,1,1,133047,128,0,0,0,0,1,17030000
nn_kernel_gpu_mem,27984,1,1,133047,128,136240000,68120000,68120000,136240000,1,17030000
nn_kernel_cpu,16177,0,1,1,64,0,0,0,0,1,17040000
nn_kernel_gpu,1034,1,1,133125,128,0,0,0,0,1,17040000
nn_kernel_gpu_mem,29804,1,1,133125,128,136320000,68160000,68160000,136320000,1,17040000
nn_kernel_cpu,16564,0,1,1,64,0,0,0,0,1,17050000
nn_kernel_gpu,1034,1,1,133204,128,0,0,0,0,1,17050000
nn_kernel_gpu_mem,19601,1,1,133204,128,136400000,68200000,68200000,136400000,1,17050000
nn_kernel_cpu,34429,0,1,1,64,0,0,0,0,1,17060000
nn_kernel_gpu,1035,1,1,133282,128,0,0,0,0,1,17060000
nn_kernel_gpu_mem,18554,1,1,133282,128,136480000,68240000,68240000,136480000,1,17060000
nn_kernel_cpu,15913,0,1,1,64,0,0,0,0,1,17070000
nn_kernel_gpu,1049,1,1,133360,128,0,0,0,0,1,17070000
nn_kernel_gpu_mem,29996,1,1,133360,128,136560000,68280000,68280000,136560000,1,17070000
nn_kernel_cpu,16428,0,1,1,64,0,0,0,0,1,17080000
nn_kernel_gpu,1038,1,1,133438,128,0,0,0,0,1,17080000
nn_kernel_gpu_mem,19146,1,1,133438,128,136640000,68320000,68320000,136640000,1,17080000
nn_kernel_cpu,16107,0,1,1,64,0,0,0,0,1,17090000
nn_kernel_gpu,1040,1,1,133516,128,0,0,0,0,1,17090000
nn_kernel_gpu_mem,19029,1,1,133516,128,136720000,68360000,68360000,136720000,1,17090000
nn_kernel_cpu,18987,0,1,1,64,0,0,0,0,1,17100000
nn_kernel_gpu,1037,1,1,133594,128,0,0,0,0,1,17100000
nn_kernel_gpu_mem,19080,1,1,133594,128,136800000,68400000,68400000,136800000,1,17100000
nn_kernel_cpu,23964,0,1,1,64,0,0,0,0,1,1710000
nn_kernel_gpu,169,1,1,13360,128,0,0,0,0,1,1710000
nn_kernel_gpu_mem,6332,1,1,13360,128,13680000,6840000,6840000,13680000,1,1710000
nn_kernel_cpu,26492,0,1,1,64,0,0,0,0,1,17110000
nn_kernel_gpu,1040,1,1,133672,128,0,0,0,0,1,17110000
nn_kernel_gpu_mem,31025,1,1,133672,128,136880000,68440000,68440000,136880000,1,17110000
nn_kernel_cpu,15400,0,1,1,64,0,0,0,0,1,17120000
nn_kernel_gpu,1038,1,1,133750,128,0,0,0,0,1,17120000
nn_kernel_gpu_mem,29267,1,1,133750,128,136960000,68480000,68480000,136960000,1,17120000
nn_kernel_cpu,25962,0,1,1,64,0,0,0,0,1,17130000
nn_kernel_gpu,1045,1,1,133829,128,0,0,0,0,1,17130000
nn_kernel_gpu_mem,27858,1,1,133829,128,137040000,68520000,68520000,137040000,1,17130000
nn_kernel_cpu,5432,0,1,1,64,0,0,0,0,1,17140000
nn_kernel_gpu,1044,1,1,133907,128,0,0,0,0,1,17140000
nn_kernel_gpu_mem,29075,1,1,133907,128,137120000,68560000,68560000,137120000,1,17140000
nn_kernel_cpu,26521,0,1,1,64,0,0,0,0,1,17150000
nn_kernel_gpu,1049,1,1,133985,128,0,0,0,0,1,17150000
nn_kernel_gpu_mem,33805,1,1,133985,128,137200000,68600000,68600000,137200000,1,17150000
nn_kernel_cpu,26541,0,1,1,64,0,0,0,0,1,17160000
nn_kernel_gpu,1051,1,1,134063,128,0,0,0,0,1,17160000
nn_kernel_gpu_mem,19604,1,1,134063,128,137280000,68640000,68640000,137280000,1,17160000
nn_kernel_cpu,14890,0,1,1,64,0,0,0,0,1,17170000
nn_kernel_gpu,1037,1,1,134141,128,0,0,0,0,1,17170000
nn_kernel_gpu_mem,18845,1,1,134141,128,137360000,68680000,68680000,137360000,1,17170000
nn_kernel_cpu,17846,0,1,1,64,0,0,0,0,1,17180000
nn_kernel_gpu,1040,1,1,134219,128,0,0,0,0,1,17180000
nn_kernel_gpu_mem,19121,1,1,134219,128,137440000,68720000,68720000,137440000,1,17180000
nn_kernel_cpu,8882,0,1,1,64,0,0,0,0,1,17190000
nn_kernel_gpu,1028,1,1,134297,128,0,0,0,0,1,17190000
nn_kernel_gpu_mem,19122,1,1,134297,128,137520000,68760000,68760000,137520000,1,17190000
nn_kernel_cpu,17336,0,1,1,64,0,0,0,0,1,17200000
nn_kernel_gpu,1039,1,1,134375,128,0,0,0,0,1,17200000
nn_kernel_gpu_mem,18987,1,1,134375,128,137600000,68800000,68800000,137600000,1,17200000
nn_kernel_cpu,24062,0,1,1,64,0,0,0,0,1,1720000
nn_kernel_gpu,153,1,1,13438,128,0,0,0,0,1,1720000
nn_kernel_gpu_mem,2868,1,1,13438,128,13760000,6880000,6880000,13760000,1,1720000
nn_kernel_cpu,14121,0,1,1,64,0,0,0,0,1,17210000
nn_kernel_gpu,1046,1,1,134454,128,0,0,0,0,1,17210000
nn_kernel_gpu_mem,18842,1,1,134454,128,137680000,68840000,68840000,137680000,1,17210000
nn_kernel_cpu,19831,0,1,1,64,0,0,0,0,1,17220000
nn_kernel_gpu,1048,1,1,134532,128,0,0,0,0,1,17220000
nn_kernel_gpu_mem,28324,1,1,134532,128,137760000,68880000,68880000,137760000,1,17220000
nn_kernel_cpu,30185,0,1,1,64,0,0,0,0,1,17230000
nn_kernel_gpu,1051,1,1,134610,128,0,0,0,0,1,17230000
nn_kernel_gpu_mem,28687,1,1,134610,128,137840000,68920000,68920000,137840000,1,17230000
nn_kernel_cpu,33310,0,1,1,64,0,0,0,0,1,17240000
nn_kernel_gpu,1045,1,1,134688,128,0,0,0,0,1,17240000
nn_kernel_gpu_mem,18830,1,1,134688,128,137920000,68960000,68960000,137920000,1,17240000
nn_kernel_cpu,19838,0,1,1,64,0,0,0,0,1,17250000
nn_kernel_gpu,1057,1,1,134766,128,0,0,0,0,1,17250000
nn_kernel_gpu_mem,19086,1,1,134766,128,138000000,69000000,69000000,138000000,1,17250000
nn_kernel_cpu,7768,0,1,1,64,0,0,0,0,1,17260000
nn_kernel_gpu,1038,1,1,134844,128,0,0,0,0,1,17260000
nn_kernel_gpu_mem,34604,1,1,134844,128,138080000,69040000,69040000,138080000,1,17260000
nn_kernel_cpu,22678,0,1,1,64,0,0,0,0,1,17270000
nn_kernel_gpu,1054,1,1,134922,128,0,0,0,0,1,17270000
nn_kernel_gpu_mem,30438,1,1,134922,128,138160000,69080000,69080000,138160000,1,17270000
nn_kernel_cpu,35680,0,1,1,64,0,0,0,0,1,17280000
nn_kernel_gpu,1044,1,1,135000,128,0,0,0,0,1,17280000
nn_kernel_gpu_mem,20694,1,1,135000,128,138240000,69120000,69120000,138240000,1,17280000
nn_kernel_cpu,11940,0,1,1,64,0,0,0,0,1,17290000
nn_kernel_gpu,1051,1,1,135079,128,0,0,0,0,1,17290000
nn_kernel_gpu_mem,29517,1,1,135079,128,138320000,69160000,69160000,138320000,1,17290000
nn_kernel_cpu,10719,0,1,1,64,0,0,0,0,1,17300000
nn_kernel_gpu,1053,1,1,135157,128,0,0,0,0,1,17300000
nn_kernel_gpu_mem,18900,1,1,135157,128,138400000,69200000,69200000,138400000,1,17300000
nn_kernel_cpu,4700,0,1,1,64,0,0,0,0,1,1730000
nn_kernel_gpu,163,1,1,13516,128,0,0,0,0,1,1730000
nn_kernel_gpu_mem,2819,1,1,13516,128,13840000,6920000,6920000,13840000,1,1730000
nn_kernel_cpu,13903,0,1,1,64,0,0,0,0,1,17310000
nn_kernel_gpu,1036,1,1,135235,128,0,0,0,0,1,17310000
nn_kernel_gpu_mem,18881,1,1,135235,128,138480000,69240000,69240000,138480000,1,17310000
nn_kernel_cpu,13707,0,1,1,64,0,0,0,0,1,17320000
nn_kernel_gpu,1053,1,1,135313,128,0,0,0,0,1,17320000
nn_kernel_gpu_mem,28987,1,1,135313,128,138560000,69280000,69280000,138560000,1,17320000
nn_kernel_cpu,11947,0,1,1,64,0,0,0,0,1,17330000
nn_kernel_gpu,1042,1,1,135391,128,0,0,0,0,1,17330000
nn_kernel_gpu_mem,19494,1,1,135391,128,138640000,69320000,69320000,138640000,1,17330000
nn_kernel_cpu,23015,0,1,1,64,0,0,0,0,1,17340000
nn_kernel_gpu,1056,1,1,135469,128,0,0,0,0,1,17340000
nn_kernel_gpu_mem,29674,1,1,135469,128,138720000,69360000,69360000,138720000,1,17340000
nn_kernel_cpu,12395,0,1,1,64,0,0,0,0,1,17350000
nn_kernel_gpu,1056,1,1,135547,128,0,0,0,0,1,17350000
nn_kernel_gpu_mem,19348,1,1,135547,128,138800000,69400000,69400000,138800000,1,17350000
nn_kernel_cpu,32219,0,1,1,64,0,0,0,0,1,17360000
nn_kernel_gpu,1043,1,1,135625,128,0,0,0,0,1,17360000
nn_kernel_gpu_mem,19287,1,1,135625,128,138880000,69440000,69440000,138880000,1,17360000
nn_kernel_cpu,10416,0,1,1,64,0,0,0,0,1,17370000
nn_kernel_gpu,1061,1,1,135704,128,0,0,0,0,1,17370000
nn_kernel_gpu_mem,19736,1,1,135704,128,138960000,69480000,69480000,138960000,1,17370000
nn_kernel_cpu,14634,0,1,1,64,0,0,0,0,1,17380000
nn_kernel_gpu,1059,1,1,135782,128,0,0,0,0,1,17380000
nn_kernel_gpu_mem,30265,1,1,135782,128,139040000,69520000,69520000,139040000,1,17380000
nn_kernel_cpu,15102,0,1,1,64,0,0,0,0,1,17390000
nn_kernel_gpu,1046,1,1,135860,128,0,0,0,0,1,17390000
nn_kernel_gpu_mem,32371,1,1,135860,128,139120000,69560000,69560000,139120000,1,17390000
nn_kernel_cpu,23633,0,1,1,64,0,0,0,0,1,17400000
nn_kernel_gpu,1053,1,1,135938,128,0,0,0,0,1,17400000
nn_kernel_gpu_mem,31738,1,1,135938,128,139200000,69600000,69600000,139200000,1,17400000
nn_kernel_cpu,4897,0,1,1,64,0,0,0,0,1,1740000
nn_kernel_gpu,161,1,1,13594,128,0,0,0,0,1,1740000
nn_kernel_gpu_mem,3004,1,1,13594,128,13920000,6960000,6960000,13920000,1,1740000
nn_kernel_cpu,27916,0,1,1,64,0,0,0,0,1,17410000
nn_kernel_gpu,1053,1,1,136016,128,0,0,0,0,1,17410000
nn_kernel_gpu_mem,19079,1,1,136016,128,139280000,69640000,69640000,139280000,1,17410000
nn_kernel_cpu,26693,0,1,1,64,0,0,0,0,1,17420000
nn_kernel_gpu,1064,1,1,136094,128,0,0,0,0,1,17420000
nn_kernel_gpu_mem,19346,1,1,136094,128,139360000,69680000,69680000,139360000,1,17420000
nn_kernel_cpu,28075,0,1,1,64,0,0,0,0,1,17430000
nn_kernel_gpu,1047,1,1,136172,128,0,0,0,0,1,17430000
nn_kernel_gpu_mem,19023,1,1,136172,128,139440000,69720000,69720000,139440000,1,17430000
nn_kernel_cpu,15074,0,1,1,64,0,0,0,0,1,17440000
nn_kernel_gpu,1060,1,1,136250,128,0,0,0,0,1,17440000
nn_kernel_gpu_mem,29196,1,1,136250,128,139520000,69760000,69760000,139520000,1,17440000
nn_kernel_cpu,6580,0,1,1,64,0,0,0,0,1,17450000
nn_kernel_gpu,1063,1,1,136329,128,0,0,0,0,1,17450000
nn_kernel_gpu_mem,28729,1,1,136329,128,139600000,69800000,69800000,139600000,1,17450000
nn_kernel_cpu,29020,0,1,1,64,0,0,0,0,1,17460000
nn_kernel_gpu,1059,1,1,136407,128,0,0,0,0,1,17460000
nn_kernel_gpu_mem,31116,1,1,136407,128,139680000,69840000,69840000,139680000,1,17460000
nn_kernel_cpu,23479,0,1,1,64,0,0,0,0,1,17470000
nn_kernel_gpu,1059,1,1,136485,128,0,0,0,0,1,17470000
nn_kernel_gpu_mem,30875,1,1,136485,128,139760000,69880000,69880000,139760000,1,17470000
nn_kernel_cpu,5565,0,1,1,64,0,0,0,0,1,17480000
nn_kernel_gpu,1059,1,1,136563,128,0,0,0,0,1,17480000
nn_kernel_gpu_mem,18989,1,1,136563,128,139840000,69920000,69920000,139840000,1,17480000
nn_kernel_cpu,20770,0,1,1,64,0,0,0,0,1,17490000
nn_kernel_gpu,1070,1,1,136641,128,0,0,0,0,1,17490000
nn_kernel_gpu_mem,19006,1,1,136641,128,139920000,69960000,69960000,139920000,1,17490000
nn_kernel_cpu,15071,0,1,1,64,0,0,0,0,1,17500000
nn_kernel_gpu,1080,1,1,136719,128,0,0,0,0,1,17500000
nn_kernel_gpu_mem,28789,1,1,136719,128,140000000,70000000,70000000,140000000,1,17500000
nn_kernel_cpu,6466,0,1,1,64,0,0,0,0,1,1750000
nn_kernel_gpu,148,1,1,13672,128,0,0,0,0,1,1750000
nn_kernel_gpu_mem,3131,1,1,13672,128,14000000,7000000,7000000,14000000,1,1750000
nn_kernel_cpu,10408,0,1,1,64,0,0,0,0,1,17510000
nn_kernel_gpu,1065,1,1,136797,128,0,0,0,0,1,17510000
nn_kernel_gpu_mem,31398,1,1,136797,128,140080000,70040000,70040000,140080000,1,17510000
nn_kernel_cpu,16303,0,1,1,64,0,0,0,0,1,17520000
nn_kernel_gpu,1067,1,1,136875,128,0,0,0,0,1,17520000
nn_kernel_gpu_mem,29918,1,1,136875,128,140160000,70080000,70080000,140160000,1,17520000
nn_kernel_cpu,12076,0,1,1,64,0,0,0,0,1,17530000
nn_kernel_gpu,1072,1,1,136954,128,0,0,0,0,1,17530000
nn_kernel_gpu_mem,19467,1,1,136954,128,140240000,70120000,70120000,140240000,1,17530000
nn_kernel_cpu,28266,0,1,1,64,0,0,0,0,1,17540000
nn_kernel_gpu,1063,1,1,137032,128,0,0,0,0,1,17540000
nn_kernel_gpu_mem,28897,1,1,137032,128,140320000,70160000,70160000,140320000,1,17540000
nn_kernel_cpu,21132,0,1,1,64,0,0,0,0,1,17550000
nn_kernel_gpu,1068,1,1,137110,128,0,0,0,0,1,17550000
nn_kernel_gpu_mem,27498,1,1,137110,128,140400000,70200000,70200000,140400000,1,17550000
nn_kernel_cpu,26155,0,1,1,64,0,0,0,0,1,17560000
nn_kernel_gpu,1105,1,1,137188,128,0,0,0,0,1,17560000
nn_kernel_gpu_mem,30596,1,1,137188,128,140480000,70240000,70240000,140480000,1,17560000
nn_kernel_cpu,18793,0,1,1,64,0,0,0,0,1,17570000
nn_kernel_gpu,1075,1,1,137266,128,0,0,0,0,1,17570000
nn_kernel_gpu_mem,32804,1,1,137266,128,140560000,70280000,70280000,140560000,1,17570000
nn_kernel_cpu,25159,0,1,1,64,0,0,0,0,1,17580000
nn_kernel_gpu,1073,1,1,137344,128,0,0,0,0,1,17580000
nn_kernel_gpu_mem,23478,1,1,137344,128,140640000,70320000,70320000,140640000,1,17580000
nn_kernel_cpu,16788,0,1,1,64,0,0,0,0,1,17590000
nn_kernel_gpu,1081,1,1,137422,128,0,0,0,0,1,17590000
nn_kernel_gpu_mem,27885,1,1,137422,128,140720000,70360000,70360000,140720000,1,17590000
nn_kernel_cpu,21855,0,1,1,64,0,0,0,0,1,17600000
nn_kernel_gpu,1072,1,1,137500,128,0,0,0,0,1,17600000
nn_kernel_gpu_mem,32568,1,1,137500,128,140800000,70400000,70400000,140800000,1,17600000
nn_kernel_cpu,9796,0,1,1,64,0,0,0,0,1,1760000
nn_kernel_gpu,162,1,1,13750,128,0,0,0,0,1,1760000
nn_kernel_gpu_mem,3187,1,1,13750,128,14080000,7040000,7040000,14080000,1,1760000
nn_kernel_cpu,24475,0,1,1,64,0,0,0,0,1,17610000
nn_kernel_gpu,1077,1,1,137579,128,0,0,0,0,1,17610000
nn_kernel_gpu_mem,26857,1,1,137579,128,140880000,70440000,70440000,140880000,1,17610000
nn_kernel_cpu,23964,0,1,1,64,0,0,0,0,1,17620000
nn_kernel_gpu,1078,1,1,137657,128,0,0,0,0,1,17620000
nn_kernel_gpu_mem,31857,1,1,137657,128,140960000,70480000,70480000,140960000,1,17620000
nn_kernel_cpu,19916,0,1,1,64,0,0,0,0,1,17630000
nn_kernel_gpu,1067,1,1,137735,128,0,0,0,0,1,17630000
nn_kernel_gpu_mem,20317,1,1,137735,128,141040000,70520000,70520000,141040000,1,17630000
nn_kernel_cpu,19951,0,1,1,64,0,0,0,0,1,17640000
nn_kernel_gpu,1059,1,1,137813,128,0,0,0,0,1,17640000
nn_kernel_gpu_mem,29482,1,1,137813,128,141120000,70560000,70560000,141120000,1,17640000
nn_kernel_cpu,29708,0,1,1,64,0,0,0,0,1,17650000
nn_kernel_gpu,1073,1,1,137891,128,0,0,0,0,1,17650000
nn_kernel_gpu_mem,29640,1,1,137891,128,141200000,70600000,70600000,141200000,1,17650000
nn_kernel_cpu,14236,0,1,1,64,0,0,0,0,1,17660000
nn_kernel_gpu,1064,1,1,137969,128,0,0,0,0,1,17660000
nn_kernel_gpu_mem,25286,1,1,137969,128,141280000,70640000,70640000,141280000,1,17660000
nn_kernel_cpu,21294,0,1,1,64,0,0,0,0,1,17670000
nn_kernel_gpu,1078,1,1,138047,128,0,0,0,0,1,17670000
nn_kernel_gpu_mem,19656,1,1,138047,128,141360000,70680000,70680000,141360000,1,17670000
nn_kernel_cpu,25620,0,1,1,64,0,0,0,0,1,17680000
nn_kernel_gpu,1075,1,1,138125,128,0,0,0,0,1,17680000
nn_kernel_gpu_mem,27436,1,1,138125,128,141440000,70720000,70720000,141440000,1,17680000
nn_kernel_cpu,18180,0,1,1,64,0,0,0,0,1,17690000
nn_kernel_gpu,1063,1,1,138204,128,0,0,0,0,1,17690000
nn_kernel_gpu_mem,33189,1,1,138204,128,141520000,70760000,70760000,141520000,1,17690000
nn_kernel_cpu,22680,0,1,1,64,0,0,0,0,1,17700000
nn_kernel_gpu,1072,1,1,138282,128,0,0,0,0,1,17700000
nn_kernel_gpu_mem,25076,1,1,138282,128,141600000,70800000,70800000,141600000,1,17700000
nn_kernel_cpu,19180,0,1,1,64,0,0,0,0,1,1770000
nn_kernel_gpu,146,1,1,13829,128,0,0,0,0,1,1770000
nn_kernel_gpu_mem,2609,1,1,13829,128,14160000,7080000,7080000,14160000,1,1770000
nn_kernel_cpu,23528,0,1,1,64,0,0,0,0,1,17710000
nn_kernel_gpu,1093,1,1,138360,128,0,0,0,0,1,17710000
nn_kernel_gpu_mem,20097,1,1,138360,128,141680000,70840000,70840000,141680000,1,17710000
nn_kernel_cpu,21725,0,1,1,64,0,0,0,0,1,17720000
nn_kernel_gpu,1111,1,1,138438,128,0,0,0,0,1,17720000
nn_kernel_gpu_mem,31120,1,1,138438,128,141760000,70880000,70880000,141760000,1,17720000
nn_kernel_cpu,17462,0,1,1,64,0,0,0,0,1,17730000
nn_kernel_gpu,1076,1,1,138516,128,0,0,0,0,1,17730000
nn_kernel_gpu_mem,30438,1,1,138516,128,141840000,70920000,70920000,141840000,1,17730000
nn_kernel_cpu,26878,0,1,1,64,0,0,0,0,1,17740000
nn_kernel_gpu,1069,1,1,138594,128,0,0,0,0,1,17740000
nn_kernel_gpu_mem,23716,1,1,138594,128,141920000,70960000,70960000,141920000,1,17740000
nn_kernel_cpu,27020,0,1,1,64,0,0,0,0,1,17750000
nn_kernel_gpu,1130,1,1,138672,128,0,0,0,0,1,17750000
nn_kernel_gpu_mem,29928,1,1,138672,128,142000000,71000000,71000000,142000000,1,17750000
nn_kernel_cpu,25022,0,1,1,64,0,0,0,0,1,17760000
nn_kernel_gpu,1077,1,1,138750,128,0,0,0,0,1,17760000
nn_kernel_gpu_mem,22678,1,1,138750,128,142080000,71040000,71040000,142080000,1,17760000
nn_kernel_cpu,25620,0,1,1,64,0,0,0,0,1,17770000
nn_kernel_gpu,1080,1,1,138829,128,0,0,0,0,1,17770000
nn_kernel_gpu_mem,31496,1,1,138829,128,142160000,71080000,71080000,142160000,1,17770000
nn_kernel_cpu,19995,0,1,1,64,0,0,0,0,1,17780000
nn_kernel_gpu,1076,1,1,138907,128,0,0,0,0,1,17780000
nn_kernel_gpu_mem,27922,1,1,138907,128,142240000,71120000,71120000,142240000,1,17780000
nn_kernel_cpu,13869,0,1,1,64,0,0,0,0,1,17790000
nn_kernel_gpu,1106,1,1,138985,128,0,0,0,0,1,17790000
nn_kernel_gpu_mem,27694,1,1,138985,128,142320000,71160000,71160000,142320000,1,17790000
nn_kernel_cpu,19762,0,1,1,64,0,0,0,0,1,17800000
nn_kernel_gpu,1082,1,1,139063,128,0,0,0,0,1,17800000
nn_kernel_gpu_mem,30326,1,1,139063,128,142400000,71200000,71200000,142400000,1,17800000
nn_kernel_cpu,34739,0,1,1,64,0,0,0,0,1,1780000
nn_kernel_gpu,156,1,1,13907,128,0,0,0,0,1,1780000
nn_kernel_gpu_mem,3727,1,1,13907,128,14240000,7120000,7120000,14240000,1,1780000
nn_kernel_cpu,10451,0,1,1,64,0,0,0,0,1,17810000
nn_kernel_gpu,1084,1,1,139141,128,0,0,0,0,1,17810000
nn_kernel_gpu_mem,29645,1,1,139141,128,142480000,71240000,71240000,142480000,1,17810000
nn_kernel_cpu,35647,0,1,1,64,0,0,0,0,1,17820000
nn_kernel_gpu,1072,1,1,139219,128,0,0,0,0,1,17820000
nn_kernel_gpu_mem,30275,1,1,139219,128,142560000,71280000,71280000,142560000,1,17820000
nn_kernel_cpu,13821,0,1,1,64,0,0,0,0,1,17830000
nn_kernel_gpu,1098,1,1,139297,128,0,0,0,0,1,17830000
nn_kernel_gpu_mem,30298,1,1,139297,128,142640000,71320000,71320000,142640000,1,17830000
nn_kernel_cpu,16019,0,1,1,64,0,0,0,0,1,17840000
nn_kernel_gpu,1094,1,1,139375,128,0,0,0,0,1,17840000
nn_kernel_gpu_mem,32869,1,1,139375,128,142720000,71360000,71360000,142720000,1,17840000
nn_kernel_cpu,11937,0,1,1,64,0,0,0,0,1,17850000
nn_kernel_gpu,1079,1,1,139454,128,0,0,0,0,1,17850000
nn_kernel_gpu_mem,19608,1,1,139454,128,142800000,71400000,71400000,142800000,1,17850000
nn_kernel_cpu,10273,0,1,1,64,0,0,0,0,1,17860000
nn_kernel_gpu,1092,1,1,139532,128,0,0,0,0,1,17860000
nn_kernel_gpu_mem,19683,1,1,139532,128,142880000,71440000,71440000,142880000,1,17860000
nn_kernel_cpu,35612,0,1,1,64,0,0,0,0,1,17870000
nn_kernel_gpu,1099,1,1,139610,128,0,0,0,0,1,17870000
nn_kernel_gpu_mem,19585,1,1,139610,128,142960000,71480000,71480000,142960000,1,17870000
nn_kernel_cpu,20408,0,1,1,64,0,0,0,0,1,17880000
nn_kernel_gpu,1095,1,1,139688,128,0,0,0,0,1,17880000
nn_kernel_gpu_mem,28329,1,1,139688,128,143040000,71520000,71520000,143040000,1,17880000
nn_kernel_cpu,32911,0,1,1,64,0,0,0,0,1,17890000
nn_kernel_gpu,1097,1,1,139766,128,0,0,0,0,1,17890000
nn_kernel_gpu_mem,31831,1,1,139766,128,143120000,71560000,71560000,143120000,1,17890000
nn_kernel_cpu,11300,0,1,1,64,0,0,0,0,1,17900000
nn_kernel_gpu,1087,1,1,139844,128,0,0,0,0,1,17900000
nn_kernel_gpu_mem,19596,1,1,139844,128,143200000,71600000,71600000,143200000,1,17900000
nn_kernel_cpu,8014,0,1,1,64,0,0,0,0,1,1790000
nn_kernel_gpu,143,1,1,13985,128,0,0,0,0,1,1790000
nn_kernel_gpu_mem,5415,1,1,13985,128,14320000,7160000,7160000,14320000,1,1790000
nn_kernel_cpu,20586,0,1,1,64,0,0,0,0,1,17910000
nn_kernel_gpu,1094,1,1,139922,128,0,0,0,0,1,17910000
nn_kernel_gpu_mem,20161,1,1,139922,128,143280000,71640000,71640000,143280000,1,17910000
nn_kernel_cpu,15502,0,1,1,64,0,0,0,0,1,17920000
nn_kernel_gpu,1094,1,1,140000,128,0,0,0,0,1,17920000
nn_kernel_gpu_mem,20132,1,1,140000,128,143360000,71680000,71680000,143360000,1,17920000
nn_kernel_cpu,26094,0,1,1,64,0,0,0,0,1,17930000
nn_kernel_gpu,1089,1,1,140079,128,0,0,0,0,1,17930000
nn_kernel_gpu_mem,21321,1,1,140079,128,143440000,71720000,71720000,143440000,1,17930000
nn_kernel_cpu,10548,0,1,1,64,0,0,0,0,1,17940000
nn_kernel_gpu,1101,1,1,140157,128,0,0,0,0,1,17940000
nn_kernel_gpu_mem,29550,1,1,140157,128,143520000,71760000,71760000,143520000,1,17940000
nn_kernel_cpu,18757,0,1,1,64,0,0,0,0,1,17950000
nn_kernel_gpu,1103,1,1,140235,128,0,0,0,0,1,17950000
nn_kernel_gpu_mem,26294,1,1,140235,128,143600000,71800000,71800000,143600000,1,17950000
nn_kernel_cpu,40614,0,1,1,64,0,0,0,0,1,17960000
nn_kernel_gpu,1104,1,1,140313,128,0,0,0,0,1,17960000
nn_kernel_gpu_mem,30506,1,1,140313,128,143680000,71840000,71840000,143680000,1,17960000
nn_kernel_cpu,20080,0,1,1,64,0,0,0,0,1,17970000
nn_kernel_gpu,1092,1,1,140391,128,0,0,0,0,1,17970000
nn_kernel_gpu_mem,30678,1,1,140391,128,143760000,71880000,71880000,143760000,1,17970000
nn_kernel_cpu,23816,0,1,1,64,0,0,0,0,1,17980000
nn_kernel_gpu,1097,1,1,140469,128,0,0,0,0,1,17980000
nn_kernel_gpu_mem,20156,1,1,140469,128,143840000,71920000,71920000,143840000,1,17980000
nn_kernel_cpu,16565,0,1,1,64,0,0,0,0,1,17990000
nn_kernel_gpu,1133,1,1,140547,128,0,0,0,0,1,17990000
nn_kernel_gpu_mem,26945,1,1,140547,128,143920000,71960000,71960000,143920000,1,17990000
nn_kernel_cpu,19036,0,1,1,64,0,0,0,0,1,18000000
nn_kernel_gpu,1097,1,1,140625,128,0,0,0,0,1,18000000
nn_kernel_gpu_mem,19661,1,1,140625,128,144000000,72000000,72000000,144000000,1,18000000
nn_kernel_cpu,4557,0,1,1,64,0,0,0,0,1,1800000
nn_kernel_gpu,169,1,1,14063,128,0,0,0,0,1,1800000
nn_kernel_gpu_mem,3753,1,1,14063,128,14400000,7200000,7200000,14400000,1,1800000
nn_kernel_cpu,3205,0,1,1,64,0,0,0,0,1,180000
nn_kernel_gpu,61,1,1,1407,128,0,0,0,0,1,180000
nn_kernel_gpu_mem,586,1,1,1407,128,1440000,720000,720000,1440000,1,180000
nn_kernel_cpu,29631,0,1,1,64,0,0,0,0,1,18010000
nn_kernel_gpu,1105,1,1,140704,128,0,0,0,0,1,18010000
nn_kernel_gpu_mem,32148,1,1,140704,128,144080000,72040000,72040000,144080000,1,18010000
nn_kernel_cpu,26032,0,1,1,64,0,0,0,0,1,18020000
nn_kernel_gpu,1102,1,1,140782,128,0,0,0,0,1,18020000
nn_kernel_gpu_mem,32208,1,1,140782,128,144160000,72080000,72080000,144160000,1,18020000
nn_kernel_cpu,13666,0,1,1,64,0,0,0,0,1,18030000
nn_kernel_gpu,1092,1,1,140860,128,0,0,0,0,1,18030000
nn_kernel_gpu_mem,20955,1,1,140860,128,144240000,72120000,72120000,144240000,1,18030000
nn_kernel_cpu,8840,0,1,1,64,0,0,0,0,1,18040000
nn_kernel_gpu,1090,1,1,140938,128,0,0,0,0,1,18040000
nn_kernel_gpu_mem,31599,1,1,140938,128,144320000,72160000,72160000,144320000,1,18040000
nn_kernel_cpu,11947,0,1,1,64,0,0,0,0,1,18050000
nn_kernel_gpu,1094,1,1,141016,128,0,0,0,0,1,18050000
nn_kernel_gpu_mem,19942,1,1,141016,128,144400000,72200000,72200000,144400000,1,18050000
nn_kernel_cpu,9332,0,1,1,64,0,0,0,0,1,18060000
nn_kernel_gpu,1107,1,1,141094,128,0,0,0,0,1,18060000
nn_kernel_gpu_mem,20637,1,1,141094,128,144480000,72240000,72240000,144480000,1,18060000
nn_kernel_cpu,34080,0,1,1,64,0,0,0,0,1,18070000
nn_kernel_gpu,1111,1,1,141172,128,0,0,0,0,1,18070000
nn_kernel_gpu_mem,29679,1,1,141172,128,144560000,72280000,72280000,144560000,1,18070000
nn_kernel_cpu,19552,0,1,1,64,0,0,0,0,1,18080000
nn_kernel_gpu,1103,1,1,141250,128,0,0,0,0,1,18080000
nn_kernel_gpu_mem,30965,1,1,141250,128,144640000,72320000,72320000,144640000,1,18080000
nn_kernel_cpu,31755,0,1,1,64,0,0,0,0,1,18090000
nn_kernel_gpu,1142,1,1,141329,128,0,0,0,0,1,18090000
nn_kernel_gpu_mem,31397,1,1,141329,128,144720000,72360000,72360000,144720000,1,18090000
nn_kernel_cpu,23465,0,1,1,64,0,0,0,0,1,18100000
nn_kernel_gpu,1113,1,1,141407,128,0,0,0,0,1,18100000
nn_kernel_gpu_mem,29235,1,1,141407,128,144800000,72400000,72400000,144800000,1,18100000
nn_kernel_cpu,13738,0,1,1,64,0,0,0,0,1,1810000
nn_kernel_gpu,175,1,1,14141,128,0,0,0,0,1,1810000
nn_kernel_gpu_mem,6550,1,1,14141,128,14480000,7240000,7240000,14480000,1,1810000
nn_kernel_cpu,22748,0,1,1,64,0,0,0,0,1,18110000
nn_kernel_gpu,1137,1,1,141485,128,0,0,0,0,1,18110000
nn_kernel_gpu_mem,29122,1,1,141485,128,144880000,72440000,72440000,144880000,1,18110000
nn_kernel_cpu,13713,0,1,1,64,0,0,0,0,1,18120000
nn_kernel_gpu,1112,1,1,141563,128,0,0,0,0,1,18120000
nn_kernel_gpu_mem,28458,1,1,141563,128,144960000,72480000,72480000,144960000,1,18120000
nn_kernel_cpu,9527,0,1,1,64,0,0,0,0,1,18130000
nn_kernel_gpu,1113,1,1,141641,128,0,0,0,0,1,18130000
nn_kernel_gpu_mem,19960,1,1,141641,128,145040000,72520000,72520000,145040000,1,18130000
nn_kernel_cpu,30077,0,1,1,64,0,0,0,0,1,18140000
nn_kernel_gpu,1110,1,1,141719,128,0,0,0,0,1,18140000
nn_kernel_gpu_mem,32933,1,1,141719,128,145120000,72560000,72560000,145120000,1,18140000
nn_kernel_cpu,16184,0,1,1,64,0,0,0,0,1,18150000
nn_kernel_gpu,1117,1,1,141797,128,0,0,0,0,1,18150000
nn_kernel_gpu_mem,19962,1,1,141797,128,145200000,72600000,72600000,145200000,1,18150000
nn_kernel_cpu,27483,0,1,1,64,0,0,0,0,1,18160000
nn_kernel_gpu,1118,1,1,141875,128,0,0,0,0,1,18160000
nn_kernel_gpu_mem,20050,1,1,141875,128,145280000,72640000,72640000,145280000,1,18160000
nn_kernel_cpu,19852,0,1,1,64,0,0,0,0,1,18170000
nn_kernel_gpu,1097,1,1,141954,128,0,0,0,0,1,18170000
nn_kernel_gpu_mem,19719,1,1,141954,128,145360000,72680000,72680000,145360000,1,18170000
nn_kernel_cpu,20395,0,1,1,64,0,0,0,0,1,18180000
nn_kernel_gpu,1136,1,1,142032,128,0,0,0,0,1,18180000
nn_kernel_gpu_mem,20377,1,1,142032,128,145440000,72720000,72720000,145440000,1,18180000
nn_kernel_cpu,25076,0,1,1,64,0,0,0,0,1,18190000
nn_kernel_gpu,1112,1,1,142110,128,0,0,0,0,1,18190000
nn_kernel_gpu_mem,31116,1,1,142110,128,145520000,72760000,72760000,145520000,1,18190000
nn_kernel_cpu,13392,0,1,1,64,0,0,0,0,1,18200000
nn_kernel_gpu,1114,1,1,142188,128,0,0,0,0,1,18200000
nn_kernel_gpu_mem,32924,1,1,142188,128,145600000,72800000,72800000,145600000,1,18200000
nn_kernel_cpu,23397,0,1,1,64,0,0,0,0,1,1820000
nn_kernel_gpu,156,1,1,14219,128,0,0,0,0,1,1820000
nn_kernel_gpu_mem,3027,1,1,14219,128,14560000,7280000,7280000,14560000,1,1820000
nn_kernel_cpu,9646,0,1,1,64,0,0,0,0,1,18210000
nn_kernel_gpu,1107,1,1,142266,128,0,0,0,0,1,18210000
nn_kernel_gpu_mem,20770,1,1,142266,128,145680000,72840000,72840000,145680000,1,18210000
nn_kernel_cpu,30651,0,1,1,64,0,0,0,0,1,18220000
nn_kernel_gpu,1116,1,1,142344,128,0,0,0,0,1,18220000
nn_kernel_gpu_mem,31080,1,1,142344,128,145760000,72880000,72880000,145760000,1,18220000
nn_kernel_cpu,46162,0,1,1,64,0,0,0,0,1,18230000
nn_kernel_gpu,1109,1,1,142422,128,0,0,0,0,1,18230000
nn_kernel_gpu_mem,20236,1,1,142422,128,145840000,72920000,72920000,145840000,1,18230000
nn_kernel_cpu,24525,0,1,1,64,0,0,0,0,1,18240000
nn_kernel_gpu,1120,1,1,142500,128,0,0,0,0,1,18240000
nn_kernel_gpu_mem,31647,1,1,142500,128,145920000,72960000,72960000,145920000,1,18240000
nn_kernel_cpu,22711,0,1,1,64,0,0,0,0,1,18250000
nn_kernel_gpu,1113,1,1,142579,128,0,0,0,0,1,18250000
nn_kernel_gpu_mem,21580,1,1,142579,128,146000000,73000000,73000000,146000000,1,18250000
nn_kernel_cpu,8230,0,1,1,64,0,0,0,0,1,18260000
nn_kernel_gpu,1120,1,1,142657,128,0,0,0,0,1,18260000
nn_kernel_gpu_mem,32601,1,1,142657,128,146080000,73040000,73040000,146080000,1,18260000
nn_kernel_cpu,22575,0,1,1,64,0,0,0,0,1,18270000
nn_kernel_gpu,1114,1,1,142735,128,0,0,0,0,1,18270000
nn_kernel_gpu_mem,19952,1,1,142735,128,146160000,73080000,73080000,146160000,1,18270000
nn_kernel_cpu,24688,0,1,1,64,0,0,0,0,1,18280000
nn_kernel_gpu,1132,1,1,142813,128,0,0,0,0,1,18280000
nn_kernel_gpu_mem,35187,1,1,142813,128,146240000,73120000,73120000,146240000,1,18280000
nn_kernel_cpu,27929,0,1,1,64,0,0,0,0,1,18290000
nn_kernel_gpu,1103,1,1,142891,128,0,0,0,0,1,18290000
nn_kernel_gpu_mem,31824,1,1,142891,128,146320000,73160000,73160000,146320000,1,18290000
nn_kernel_cpu,7687,0,1,1,64,0,0,0,0,1,18300000
nn_kernel_gpu,1119,1,1,142969,128,0,0,0,0,1,18300000
nn_kernel_gpu_mem,20070,1,1,142969,128,146400000,73200000,73200000,146400000,1,18300000
nn_kernel_cpu,4416,0,1,1,64,0,0,0,0,1,1830000
nn_kernel_gpu,178,1,1,14297,128,0,0,0,0,1,1830000
nn_kernel_gpu_mem,7025,1,1,14297,128,14640000,7320000,7320000,14640000,1,1830000
nn_kernel_cpu,12881,0,1,1,64,0,0,0,0,1,18310000
nn_kernel_gpu,1115,1,1,143047,128,0,0,0,0,1,18310000
nn_kernel_gpu_mem,37657,1,1,143047,128,146480000,73240000,73240000,146480000,1,18310000
nn_kernel_cpu,25548,0,1,1,64,0,0,0,0,1,18320000
nn_kernel_gpu,1119,1,1,143125,128,0,0,0,0,1,18320000
nn_kernel_gpu_mem,32333,1,1,143125,128,146560000,73280000,73280000,146560000,1,18320000
nn_kernel_cpu,9967,0,1,1,64,0,0,0,0,1,18330000
nn_kernel_gpu,1124,1,1,143204,128,0,0,0,0,1,18330000
nn_kernel_gpu_mem,30522,1,1,143204,128,146640000,73320000,73320000,146640000,1,18330000
nn_kernel_cpu,24300,0,1,1,64,0,0,0,0,1,18340000
nn_kernel_gpu,1111,1,1,143282,128,0,0,0,0,1,18340000
nn_kernel_gpu_mem,21753,1,1,143282,128,146720000,73360000,73360000,146720000,1,18340000
nn_kernel_cpu,11195,0,1,1,64,0,0,0,0,1,18350000
nn_kernel_gpu,1123,1,1,143360,128,0,0,0,0,1,18350000
nn_kernel_gpu_mem,20412,1,1,143360,128,146800000,73400000,73400000,146800000,1,18350000
nn_kernel_cpu,7557,0,1,1,64,0,0,0,0,1,18360000
nn_kernel_gpu,1117,1,1,143438,128,0,0,0,0,1,18360000
nn_kernel_gpu_mem,32151,1,1,143438,128,146880000,73440000,73440000,146880000,1,18360000
nn_kernel_cpu,8675,0,1,1,64,0,0,0,0,1,18370000
nn_kernel_gpu,1120,1,1,143516,128,0,0,0,0,1,18370000
nn_kernel_gpu_mem,21389,1,1,143516,128,146960000,73480000,73480000,146960000,1,18370000
nn_kernel_cpu,22642,0,1,1,64,0,0,0,0,1,18380000
nn_kernel_gpu,1109,1,1,143594,128,0,0,0,0,1,18380000
nn_kernel_gpu_mem,30252,1,1,143594,128,147040000,73520000,73520000,147040000,1,18380000
nn_kernel_cpu,39787,0,1,1,64,0,0,0,0,1,18390000
nn_kernel_gpu,1122,1,1,143672,128,0,0,0,0,1,18390000
nn_kernel_gpu_mem,23182,1,1,143672,128,147120000,73560000,73560000,147120000,1,18390000
nn_kernel_cpu,28391,0,1,1,64,0,0,0,0,1,18400000
nn_kernel_gpu,1118,1,1,143750,128,0,0,0,0,1,18400000
nn_kernel_gpu_mem,36840,1,1,143750,128,147200000,73600000,73600000,147200000,1,18400000
nn_kernel_cpu,9031,0,1,1,64,0,0,0,0,1,1840000
nn_kernel_gpu,156,1,1,14375,128,0,0,0,0,1,1840000
nn_kernel_gpu_mem,3320,1,1,14375,128,14720000,7360000,7360000,14720000,1,1840000
nn_kernel_cpu,23501,0,1,1,64,0,0,0,0,1,18410000
nn_kernel_gpu,1123,1,1,143829,128,0,0,0,0,1,18410000
nn_kernel_gpu_mem,31354,1,1,143829,128,147280000,73640000,73640000,147280000,1,18410000
nn_kernel_cpu,24754,0,1,1,64,0,0,0,0,1,18420000
nn_kernel_gpu,1126,1,1,143907,128,0,0,0,0,1,18420000
nn_kernel_gpu_mem,35244,1,1,143907,128,147360000,73680000,73680000,147360000,1,18420000
nn_kernel_cpu,15467,0,1,1,64,0,0,0,0,1,18430000
nn_kernel_gpu,1134,1,1,143985,128,0,0,0,0,1,18430000
nn_kernel_gpu_mem,28440,1,1,143985,128,147440000,73720000,73720000,147440000,1,18430000
nn_kernel_cpu,22198,0,1,1,64,0,0,0,0,1,18440000
nn_kernel_gpu,1237,1,1,144063,128,0,0,0,0,1,18440000
nn_kernel_gpu_mem,33310,1,1,144063,128,147520000,73760000,73760000,147520000,1,18440000
nn_kernel_cpu,29122,0,1,1,64,0,0,0,0,1,18450000
nn_kernel_gpu,1127,1,1,144141,128,0,0,0,0,1,18450000
nn_kernel_gpu_mem,33008,1,1,144141,128,147600000,73800000,73800000,147600000,1,18450000
nn_kernel_cpu,15857,0,1,1,64,0,0,0,0,1,18460000
nn_kernel_gpu,1131,1,1,144219,128,0,0,0,0,1,18460000
nn_kernel_gpu_mem,32307,1,1,144219,128,147680000,73840000,73840000,147680000,1,18460000
nn_kernel_cpu,26739,0,1,1,64,0,0,0,0,1,18470000
nn_kernel_gpu,1134,1,1,144297,128,0,0,0,0,1,18470000
nn_kernel_gpu_mem,31246,1,1,144297,128,147760000,73880000,73880000,147760000,1,18470000
nn_kernel_cpu,29741,0,1,1,64,0,0,0,0,1,18480000
nn_kernel_gpu,1168,1,1,144375,128,0,0,0,0,1,18480000
nn_kernel_gpu_mem,31536,1,1,144375,128,147840000,73920000,73920000,147840000,1,18480000
nn_kernel_cpu,24299,0,1,1,64,0,0,0,0,1,18490000
nn_kernel_gpu,1121,1,1,144454,128,0,0,0,0,1,18490000
nn_kernel_gpu_mem,30075,1,1,144454,128,147920000,73960000,73960000,147920000,1,18490000
nn_kernel_cpu,18567,0,1,1,64,0,0,0,0,1,18500000
nn_kernel_gpu,1140,1,1,144532,128,0,0,0,0,1,18500000
nn_kernel_gpu_mem,30019,1,1,144532,128,148000000,74000000,74000000,148000000,1,18500000
nn_kernel_cpu,5475,0,1,1,64,0,0,0,0,1,1850000
nn_kernel_gpu,165,1,1,14454,128,0,0,0,0,1,1850000
nn_kernel_gpu_mem,3056,1,1,14454,128,14800000,7400000,7400000,14800000,1,1850000
nn_kernel_cpu,22375,0,1,1,64,0,0,0,0,1,18510000
nn_kernel_gpu,1129,1,1,144610,128,0,0,0,0,1,18510000
nn_kernel_gpu_mem,35509,1,1,144610,128,148080000,74040000,74040000,148080000,1,18510000
nn_kernel_cpu,25143,0,1,1,64,0,0,0,0,1,18520000
nn_kernel_gpu,1165,1,1,144688,128,0,0,0,0,1,18520000
nn_kernel_gpu_mem,33468,1,1,144688,128,148160000,74080000,74080000,148160000,1,18520000
nn_kernel_cpu,33095,0,1,1,64,0,0,0,0,1,18530000
nn_kernel_gpu,1127,1,1,144766,128,0,0,0,0,1,18530000
nn_kernel_gpu_mem,33667,1,1,144766,128,148240000,74120000,74120000,148240000,1,18530000
nn_kernel_cpu,30439,0,1,1,64,0,0,0,0,1,18540000
nn_kernel_gpu,1124,1,1,144844,128,0,0,0,0,1,18540000
nn_kernel_gpu_mem,22630,1,1,144844,128,148320000,74160000,74160000,148320000,1,18540000
nn_kernel_cpu,19529,0,1,1,64,0,0,0,0,1,18550000
nn_kernel_gpu,1130,1,1,144922,128,0,0,0,0,1,18550000
nn_kernel_gpu_mem,31175,1,1,144922,128,148400000,74200000,74200000,148400000,1,18550000
nn_kernel_cpu,20758,0,1,1,64,0,0,0,0,1,18560000
nn_kernel_gpu,1130,1,1,145000,128,0,0,0,0,1,18560000
nn_kernel_gpu_mem,32335,1,1,145000,128,148480000,74240000,74240000,148480000,1,18560000
nn_kernel_cpu,27001,0,1,1,64,0,0,0,0,1,18570000
nn_kernel_gpu,1133,1,1,145079,128,0,0,0,0,1,18570000
nn_kernel_gpu_mem,23397,1,1,145079,128,148560000,74280000,74280000,148560000,1,18570000
nn_kernel_cpu,6953,0,1,1,64,0,0,0,0,1,18580000
nn_kernel_gpu,1153,1,1,145157,128,0,0,0,0,1,18580000
nn_kernel_gpu_mem,30801,1,1,145157,128,148640000,74320000,74320000,148640000,1,18580000
nn_kernel_cpu,7538,0,1,1,64,0,0,0,0,1,18590000
nn_kernel_gpu,1124,1,1,145235,128,0,0,0,0,1,18590000
nn_kernel_gpu_mem,22495,1,1,145235,128,148720000,74360000,74360000,148720000,1,18590000
nn_kernel_cpu,25471,0,1,1,64,0,0,0,0,1,18600000
nn_kernel_gpu,1136,1,1,145313,128,0,0,0,0,1,18600000
nn_kernel_gpu_mem,35808,1,1,145313,128,148800000,74400000,74400000,148800000,1,18600000
nn_kernel_cpu,22667,0,1,1,64,0,0,0,0,1,1860000
nn_kernel_gpu,157,1,1,14532,128,0,0,0,0,1,1860000
nn_kernel_gpu_mem,3194,1,1,14532,128,14880000,7440000,7440000,14880000,1,1860000
nn_kernel_cpu,23505,0,1,1,64,0,0,0,0,1,18610000
nn_kernel_gpu,1173,1,1,145391,128,0,0,0,0,1,18610000
nn_kernel_gpu_mem,32684,1,1,145391,128,148880000,74440000,74440000,148880000,1,18610000
nn_kernel_cpu,30089,0,1,1,64,0,0,0,0,1,18620000
nn_kernel_gpu,1162,1,1,145469,128,0,0,0,0,1,18620000
nn_kernel_gpu_mem,31239,1,1,145469,128,148960000,74480000,74480000,148960000,1,18620000
nn_kernel_cpu,11046,0,1,1,64,0,0,0,0,1,18630000
nn_kernel_gpu,1136,1,1,145547,128,0,0,0,0,1,18630000
nn_kernel_gpu_mem,22748,1,1,145547,128,149040000,74520000,74520000,149040000,1,18630000
nn_kernel_cpu,26245,0,1,1,64,0,0,0,0,1,18640000
nn_kernel_gpu,1149,1,1,145625,128,0,0,0,0,1,18640000
nn_kernel_gpu_mem,32124,1,1,145625,128,149120000,74560000,74560000,149120000,1,18640000
nn_kernel_cpu,11939,0,1,1,64,0,0,0,0,1,18650000
nn_kernel_gpu,1131,1,1,145704,128,0,0,0,0,1,18650000
nn_kernel_gpu_mem,21745,1,1,145704,128,149200000,74600000,74600000,149200000,1,18650000
nn_kernel_cpu,24841,0,1,1,64,0,0,0,0,1,18660000
nn_kernel_gpu,1149,1,1,145782,128,0,0,0,0,1,18660000
nn_kernel_gpu_mem,31795,1,1,145782,128,149280000,74640000,74640000,149280000,1,18660000
nn_kernel_cpu,31083,0,1,1,64,0,0,0,0,1,18670000
nn_kernel_gpu,1132,1,1,145860,128,0,0,0,0,1,18670000
nn_kernel_gpu_mem,22157,1,1,145860,128,149360000,74680000,74680000,149360000,1,18670000
nn_kernel_cpu,24343,0,1,1,64,0,0,0,0,1,18680000
nn_kernel_gpu,1128,1,1,145938,128,0,0,0,0,1,18680000
nn_kernel_gpu_mem,30859,1,1,145938,128,149440000,74720000,74720000,149440000,1,18680000
nn_kernel_cpu,20582,0,1,1,64,0,0,0,0,1,18690000
nn_kernel_gpu,1134,1,1,146016,128,0,0,0,0,1,18690000
nn_kernel_gpu_mem,31608,1,1,146016,128,149520000,74760000,74760000,149520000,1,18690000
nn_kernel_cpu,24362,0,1,1,64,0,0,0,0,1,18700000
nn_kernel_gpu,1181,1,1,146094,128,0,0,0,0,1,18700000
nn_kernel_gpu_mem,30349,1,1,146094,128,149600000,74800000,74800000,149600000,1,18700000
nn_kernel_cpu,23927,0,1,1,64,0,0,0,0,1,1870000
nn_kernel_gpu,161,1,1,14610,128,0,0,0,0,1,1870000
nn_kernel_gpu_mem,2957,1,1,14610,128,14960000,7480000,7480000,14960000,1,1870000
nn_kernel_cpu,27799,0,1,1,64,0,0,0,0,1,18710000
nn_kernel_gpu,1139,1,1,146172,128,0,0,0,0,1,18710000
nn_kernel_gpu_mem,23738,1,1,146172,128,149680000,74840000,74840000,149680000,1,18710000
nn_kernel_cpu,32319,0,1,1,64,0,0,0,0,1,18720000
nn_kernel_gpu,1137,1,1,146250,128,0,0,0,0,1,18720000
nn_kernel_gpu_mem,21488,1,1,146250,128,149760000,74880000,74880000,149760000,1,18720000
nn_kernel_cpu,13619,0,1,1,64,0,0,0,0,1,18730000
nn_kernel_gpu,1144,1,1,146329,128,0,0,0,0,1,18730000
nn_kernel_gpu_mem,31138,1,1,146329,128,149840000,74920000,74920000,149840000,1,18730000
nn_kernel_cpu,18207,0,1,1,64,0,0,0,0,1,18740000
nn_kernel_gpu,1130,1,1,146407,128,0,0,0,0,1,18740000
nn_kernel_gpu_mem,30457,1,1,146407,128,149920000,74960000,74960000,149920000,1,18740000
nn_kernel_cpu,36804,0,1,1,64,0,0,0,0,1,18750000
nn_kernel_gpu,1142,1,1,146485,128,0,0,0,0,1,18750000
nn_kernel_gpu_mem,35445,1,1,146485,128,150000000,75000000,75000000,150000000,1,18750000
nn_kernel_cpu,14683,0,1,1,64,0,0,0,0,1,18760000
nn_kernel_gpu,1137,1,1,146563,128,0,0,0,0,1,18760000
nn_kernel_gpu_mem,31852,1,1,146563,128,150080000,75040000,75040000,150080000,1,18760000
nn_kernel_cpu,29442,0,1,1,64,0,0,0,0,1,18770000
nn_kernel_gpu,1138,1,1,146641,128,0,0,0,0,1,18770000
nn_kernel_gpu_mem,21748,1,1,146641,128,150160000,75080000,75080000,150160000,1,18770000
nn_kernel_cpu,18290,0,1,1,64,0,0,0,0,1,18780000
nn_kernel_gpu,1135,1,1,146719,128,0,0,0,0,1,18780000
nn_kernel_gpu_mem,21483,1,1,146719,128,150240000,75120000,75120000,150240000,1,18780000
nn_kernel_cpu,26647,0,1,1,64,0,0,0,0,1,18790000
nn_kernel_gpu,1143,1,1,146797,128,0,0,0,0,1,18790000
nn_kernel_gpu_mem,30162,1,1,146797,128,150320000,75160000,75160000,150320000,1,18790000
nn_kernel_cpu,27249,0,1,1,64,0,0,0,0,1,18800000
nn_kernel_gpu,1179,1,1,146875,128,0,0,0,0,1,18800000
nn_kernel_gpu_mem,32347,1,1,146875,128,150400000,75200000,75200000,150400000,1,18800000
nn_kernel_cpu,15798,0,1,1,64,0,0,0,0,1,1880000
nn_kernel_gpu,170,1,1,14688,128,0,0,0,0,1,1880000
nn_kernel_gpu_mem,3152,1,1,14688,128,15040000,7520000,7520000,15040000,1,1880000
nn_kernel_cpu,12202,0,1,1,64,0,0,0,0,1,18810000
nn_kernel_gpu,1145,1,1,146954,128,0,0,0,0,1,18810000
nn_kernel_gpu_mem,22953,1,1,146954,128,150480000,75240000,75240000,150480000,1,18810000
nn_kernel_cpu,15669,0,1,1,64,0,0,0,0,1,18820000
nn_kernel_gpu,1146,1,1,147032,128,0,0,0,0,1,18820000
nn_kernel_gpu_mem,30331,1,1,147032,128,150560000,75280000,75280000,150560000,1,18820000
nn_kernel_cpu,10172,0,1,1,64,0,0,0,0,1,18830000
nn_kernel_gpu,1148,1,1,147110,128,0,0,0,0,1,18830000
nn_kernel_gpu_mem,22435,1,1,147110,128,150640000,75320000,75320000,150640000,1,18830000
nn_kernel_cpu,21188,0,1,1,64,0,0,0,0,1,18840000
nn_kernel_gpu,1145,1,1,147188,128,0,0,0,0,1,18840000
nn_kernel_gpu_mem,39915,1,1,147188,128,150720000,75360000,75360000,150720000,1,18840000
nn_kernel_cpu,24356,0,1,1,64,0,0,0,0,1,18850000
nn_kernel_gpu,1147,1,1,147266,128,0,0,0,0,1,18850000
nn_kernel_gpu_mem,32965,1,1,147266,128,150800000,75400000,75400000,150800000,1,18850000
nn_kernel_cpu,14828,0,1,1,64,0,0,0,0,1,18860000
nn_kernel_gpu,1145,1,1,147344,128,0,0,0,0,1,18860000
nn_kernel_gpu_mem,31132,1,1,147344,128,150880000,75440000,75440000,150880000,1,18860000
nn_kernel_cpu,13696,0,1,1,64,0,0,0,0,1,18870000
nn_kernel_gpu,1151,1,1,147422,128,0,0,0,0,1,18870000
nn_kernel_gpu_mem,30722,1,1,147422,128,150960000,75480000,75480000,150960000,1,18870000
nn_kernel_cpu,29177,0,1,1,64,0,0,0,0,1,18880000
nn_kernel_gpu,1146,1,1,147500,128,0,0,0,0,1,18880000
nn_kernel_gpu_mem,33405,1,1,147500,128,151040000,75520000,75520000,151040000,1,18880000
nn_kernel_cpu,11048,0,1,1,64,0,0,0,0,1,18890000
nn_kernel_gpu,1142,1,1,147579,128,0,0,0,0,1,18890000
nn_kernel_gpu_mem,23375,1,1,147579,128,151120000,75560000,75560000,151120000,1,18890000
nn_kernel_cpu,21381,0,1,1,64,0,0,0,0,1,18900000
nn_kernel_gpu,1159,1,1,147657,128,0,0,0,0,1,18900000
nn_kernel_gpu_mem,23085,1,1,147657,128,151200000,75600000,75600000,151200000,1,18900000
nn_kernel_cpu,7561,0,1,1,64,0,0,0,0,1,1890000
nn_kernel_gpu,167,1,1,14766,128,0,0,0,0,1,1890000
nn_kernel_gpu_mem,3226,1,1,14766,128,15120000,7560000,7560000,15120000,1,1890000
nn_kernel_cpu,9853,0,1,1,64,0,0,0,0,1,18910000
nn_kernel_gpu,1157,1,1,147735,128,0,0,0,0,1,18910000
nn_kernel_gpu_mem,22731,1,1,147735,128,151280000,75640000,75640000,151280000,1,18910000
nn_kernel_cpu,27248,0,1,1,64,0,0,0,0,1,18920000
nn_kernel_gpu,1154,1,1,147813,128,0,0,0,0,1,18920000
nn_kernel_gpu_mem,23366,1,1,147813,128,151360000,75680000,75680000,151360000,1,18920000
nn_kernel_cpu,24819,0,1,1,64,0,0,0,0,1,18930000
nn_kernel_gpu,1145,1,1,147891,128,0,0,0,0,1,18930000
nn_kernel_gpu_mem,25547,1,1,147891,128,151440000,75720000,75720000,151440000,1,18930000
nn_kernel_cpu,14925,0,1,1,64,0,0,0,0,1,18940000
nn_kernel_gpu,1147,1,1,147969,128,0,0,0,0,1,18940000
nn_kernel_gpu_mem,21973,1,1,147969,128,151520000,75760000,75760000,151520000,1,18940000
nn_kernel_cpu,17192,0,1,1,64,0,0,0,0,1,18950000
nn_kernel_gpu,1157,1,1,148047,128,0,0,0,0,1,18950000
nn_kernel_gpu_mem,22374,1,1,148047,128,151600000,75800000,75800000,151600000,1,18950000
nn_kernel_cpu,22292,0,1,1,64,0,0,0,0,1,18960000
nn_kernel_gpu,1160,1,1,148125,128,0,0,0,0,1,18960000
nn_kernel_gpu_mem,23502,1,1,148125,128,151680000,75840000,75840000,151680000,1,18960000
nn_kernel_cpu,42632,0,1,1,64,0,0,0,0,1,18970000
nn_kernel_gpu,1149,1,1,148204,128,0,0,0,0,1,18970000
nn_kernel_gpu_mem,23122,1,1,148204,128,151760000,75880000,75880000,151760000,1,18970000
nn_kernel_cpu,9734,0,1,1,64,0,0,0,0,1,18980000
nn_kernel_gpu,1157,1,1,148282,128,0,0,0,0,1,18980000
nn_kernel_gpu_mem,33660,1,1,148282,128,151840000,75920000,75920000,151840000,1,18980000
nn_kernel_cpu,30112,0,1,1,64,0,0,0,0,1,18990000
nn_kernel_gpu,1168,1,1,148360,128,0,0,0,0,1,18990000
nn_kernel_gpu_mem,31354,1,1,148360,128,151920000,75960000,75960000,151920000,1,18990000
nn_kernel_cpu,28017,0,1,1,64,0,0,0,0,1,19000000
nn_kernel_gpu,1164,1,1,148438,128,0,0,0,0,1,19000000
nn_kernel_gpu_mem,35500,1,1,148438,128,152000000,76000000,76000000,152000000,1,19000000
nn_kernel_cpu,18737,0,1,1,64,0,0,0,0,1,1900000
nn_kernel_gpu,154,1,1,14844,128,0,0,0,0,1,1900000
nn_kernel_gpu_mem,2702,1,1,14844,128,15200000,7600000,7600000,15200000,1,1900000
nn_kernel_cpu,34899,0,1,1,64,0,0,0,0,1,190000
nn_kernel_gpu,52,1,1,1485,128,0,0,0,0,1,190000
nn_kernel_gpu_mem,465,1,1,1485,128,1520000,760000,760000,1520000,1,190000
nn_kernel_cpu,13787,0,1,1,64,0,0,0,0,1,19010000
nn_kernel_gpu,1148,1,1,148516,128,0,0,0,0,1,19010000
nn_kernel_gpu_mem,22617,1,1,148516,128,152080000,76040000,76040000,152080000,1,19010000
nn_kernel_cpu,8297,0,1,1,64,0,0,0,0,1,19020000
nn_kernel_gpu,1160,1,1,148594,128,0,0,0,0,1,19020000
nn_kernel_gpu_mem,31635,1,1,148594,128,152160000,76080000,76080000,152160000,1,19020000
nn_kernel_cpu,28632,0,1,1,64,0,0,0,0,1,19030000
nn_kernel_gpu,1156,1,1,148672,128,0,0,0,0,1,19030000
nn_kernel_gpu_mem,23942,1,1,148672,128,152240000,76120000,76120000,152240000,1,19030000
nn_kernel_cpu,17529,0,1,1,64,0,0,0,0,1,19040000
nn_kernel_gpu,1158,1,1,148750,128,0,0,0,0,1,19040000
nn_kernel_gpu_mem,23861,1,1,148750,128,152320000,76160000,76160000,152320000,1,19040000
nn_kernel_cpu,27379,0,1,1,64,0,0,0,0,1,19050000
nn_kernel_gpu,1165,1,1,148829,128,0,0,0,0,1,19050000
nn_kernel_gpu_mem,32984,1,1,148829,128,152400000,76200000,76200000,152400000,1,19050000
nn_kernel_cpu,20366,0,1,1,64,0,0,0,0,1,19060000
nn_kernel_gpu,1152,1,1,148907,128,0,0,0,0,1,19060000
nn_kernel_gpu_mem,23013,1,1,148907,128,152480000,76240000,76240000,152480000,1,19060000
nn_kernel_cpu,9918,0,1,1,64,0,0,0,0,1,19070000
nn_kernel_gpu,1169,1,1,148985,128,0,0,0,0,1,19070000
nn_kernel_gpu_mem,23012,1,1,148985,128,152560000,76280000,76280000,152560000,1,19070000
nn_kernel_cpu,23964,0,1,1,64,0,0,0,0,1,19080000
nn_kernel_gpu,1157,1,1,149063,128,0,0,0,0,1,19080000
nn_kernel_gpu_mem,31432,1,1,149063,128,152640000,76320000,76320000,152640000,1,19080000
nn_kernel_cpu,24330,0,1,1,64,0,0,0,0,1,19090000
nn_kernel_gpu,1171,1,1,149141,128,0,0,0,0,1,19090000
nn_kernel_gpu_mem,27711,1,1,149141,128,152720000,76360000,76360000,152720000,1,19090000
nn_kernel_cpu,19403,0,1,1,64,0,0,0,0,1,19100000
nn_kernel_gpu,1170,1,1,149219,128,0,0,0,0,1,19100000
nn_kernel_gpu_mem,33005,1,1,149219,128,152800000,76400000,76400000,152800000,1,19100000
nn_kernel_cpu,4589,0,1,1,64,0,0,0,0,1,1910000
nn_kernel_gpu,151,1,1,14922,128,0,0,0,0,1,1910000
nn_kernel_gpu_mem,4890,1,1,14922,128,15280000,7640000,7640000,15280000,1,1910000
nn_kernel_cpu,17548,0,1,1,64,0,0,0,0,1,19110000
nn_kernel_gpu,1162,1,1,149297,128,0,0,0,0,1,19110000
nn_kernel_gpu_mem,23668,1,1,149297,128,152880000,76440000,76440000,152880000,1,19110000
nn_kernel_cpu,6025,0,1,1,64,0,0,0,0,1,19120000
nn_kernel_gpu,1166,1,1,149375,128,0,0,0,0,1,19120000
nn_kernel_gpu_mem,23972,1,1,149375,128,152960000,76480000,76480000,152960000,1,19120000
nn_kernel_cpu,8528,0,1,1,64,0,0,0,0,1,19130000
nn_kernel_gpu,1162,1,1,149454,128,0,0,0,0,1,19130000
nn_kernel_gpu_mem,31749,1,1,149454,128,153040000,76520000,76520000,153040000,1,19130000
nn_kernel_cpu,16670,0,1,1,64,0,0,0,0,1,19140000
nn_kernel_gpu,1148,1,1,149532,128,0,0,0,0,1,19140000
nn_kernel_gpu_mem,23250,1,1,149532,128,153120000,76560000,76560000,153120000,1,19140000
nn_kernel_cpu,18689,0,1,1,64,0,0,0,0,1,19150000
nn_kernel_gpu,1162,1,1,149610,128,0,0,0,0,1,19150000
nn_kernel_gpu_mem,23019,1,1,149610,128,153200000,76600000,76600000,153200000,1,19150000
nn_kernel_cpu,7472,0,1,1,64,0,0,0,0,1,19160000
nn_kernel_gpu,1160,1,1,149688,128,0,0,0,0,1,19160000
nn_kernel_gpu_mem,23128,1,1,149688,128,153280000,76640000,76640000,153280000,1,19160000
nn_kernel_cpu,22548,0,1,1,64,0,0,0,0,1,19170000
nn_kernel_gpu,1164,1,1,149766,128,0,0,0,0,1,19170000
nn_kernel_gpu_mem,25692,1,1,149766,128,153360000,76680000,76680000,153360000,1,19170000
nn_kernel_cpu,10961,0,1,1,64,0,0,0,0,1,19180000
nn_kernel_gpu,1166,1,1,149844,128,0,0,0,0,1,19180000
nn_kernel_gpu_mem,23911,1,1,149844,128,153440000,76720000,76720000,153440000,1,19180000
nn_kernel_cpu,14725,0,1,1,64,0,0,0,0,1,19190000
nn_kernel_gpu,1157,1,1,149922,128,0,0,0,0,1,19190000
nn_kernel_gpu_mem,24681,1,1,149922,128,153520000,76760000,76760000,153520000,1,19190000
nn_kernel_cpu,13426,0,1,1,64,0,0,0,0,1,19200000
nn_kernel_gpu,1158,1,1,150000,128,0,0,0,0,1,19200000
nn_kernel_gpu_mem,24579,1,1,150000,128,153600000,76800000,76800000,153600000,1,19200000
nn_kernel_cpu,6244,0,1,1,64,0,0,0,0,1,1920000
nn_kernel_gpu,162,1,1,15000,128,0,0,0,0,1,1920000
nn_kernel_gpu_mem,3104,1,1,15000,128,15360000,7680000,7680000,15360000,1,1920000
nn_kernel_cpu,18214,0,1,1,64,0,0,0,0,1,19210000
nn_kernel_gpu,1158,1,1,150079,128,0,0,0,0,1,19210000
nn_kernel_gpu_mem,23370,1,1,150079,128,153680000,76840000,76840000,153680000,1,19210000
nn_kernel_cpu,28388,0,1,1,64,0,0,0,0,1,19220000
nn_kernel_gpu,1157,1,1,150157,128,0,0,0,0,1,19220000
nn_kernel_gpu_mem,32858,1,1,150157,128,153760000,76880000,76880000,153760000,1,19220000
nn_kernel_cpu,18590,0,1,1,64,0,0,0,0,1,19230000
nn_kernel_gpu,1168,1,1,150235,128,0,0,0,0,1,19230000
nn_kernel_gpu_mem,31878,1,1,150235,128,153840000,76920000,76920000,153840000,1,19230000
nn_kernel_cpu,11457,0,1,1,64,0,0,0,0,1,19240000
nn_kernel_gpu,1170,1,1,150313,128,0,0,0,0,1,19240000
nn_kernel_gpu_mem,23721,1,1,150313,128,153920000,76960000,76960000,153920000,1,19240000
nn_kernel_cpu,30395,0,1,1,64,0,0,0,0,1,19250000
nn_kernel_gpu,1157,1,1,150391,128,0,0,0,0,1,19250000
nn_kernel_gpu_mem,33525,1,1,150391,128,154000000,77000000,77000000,154000000,1,19250000
nn_kernel_cpu,31815,0,1,1,64,0,0,0,0,1,19260000
nn_kernel_gpu,1177,1,1,150469,128,0,0,0,0,1,19260000
nn_kernel_gpu_mem,24172,1,1,150469,128,154080000,77040000,77040000,154080000,1,19260000
nn_kernel_cpu,22503,0,1,1,64,0,0,0,0,1,19270000
nn_kernel_gpu,1166,1,1,150547,128,0,0,0,0,1,19270000
nn_kernel_gpu_mem,31919,1,1,150547,128,154160000,77080000,77080000,154160000,1,19270000
nn_kernel_cpu,14527,0,1,1,64,0,0,0,0,1,19280000
nn_kernel_gpu,1162,1,1,150625,128,0,0,0,0,1,19280000
nn_kernel_gpu_mem,30891,1,1,150625,128,154240000,77120000,77120000,154240000,1,19280000
nn_kernel_cpu,23697,0,1,1,64,0,0,0,0,1,19290000
nn_kernel_gpu,1166,1,1,150704,128,0,0,0,0,1,19290000
nn_kernel_gpu_mem,33097,1,1,150704,128,154320000,77160000,77160000,154320000,1,19290000
nn_kernel_cpu,14372,0,1,1,64,0,0,0,0,1,19300000
nn_kernel_gpu,1165,1,1,150782,128,0,0,0,0,1,19300000
nn_kernel_gpu_mem,23137,1,1,150782,128,154400000,77200000,77200000,154400000,1,19300000
nn_kernel_cpu,6504,0,1,1,64,0,0,0,0,1,1930000
nn_kernel_gpu,197,1,1,15079,128,0,0,0,0,1,1930000
nn_kernel_gpu_mem,3363,1,1,15079,128,15440000,7720000,7720000,15440000,1,1930000
nn_kernel_cpu,28505,0,1,1,64,0,0,0,0,1,19310000
nn_kernel_gpu,1166,1,1,150860,128,0,0,0,0,1,19310000
nn_kernel_gpu_mem,24671,1,1,150860,128,154480000,77240000,77240000,154480000,1,19310000
nn_kernel_cpu,26389,0,1,1,64,0,0,0,0,1,19320000
nn_kernel_gpu,1184,1,1,150938,128,0,0,0,0,1,19320000
nn_kernel_gpu_mem,23624,1,1,150938,128,154560000,77280000,77280000,154560000,1,19320000
nn_kernel_cpu,8685,0,1,1,64,0,0,0,0,1,19330000
nn_kernel_gpu,1169,1,1,151016,128,0,0,0,0,1,19330000
nn_kernel_gpu_mem,24428,1,1,151016,128,154640000,77320000,77320000,154640000,1,19330000
nn_kernel_cpu,9180,0,1,1,64,0,0,0,0,1,19340000
nn_kernel_gpu,1175,1,1,151094,128,0,0,0,0,1,19340000
nn_kernel_gpu_mem,24642,1,1,151094,128,154720000,77360000,77360000,154720000,1,19340000
nn_kernel_cpu,10002,0,1,1,64,0,0,0,0,1,19350000
nn_kernel_gpu,1174,1,1,151172,128,0,0,0,0,1,19350000
nn_kernel_gpu_mem,37003,1,1,151172,128,154800000,77400000,77400000,154800000,1,19350000
nn_kernel_cpu,15864,0,1,1,64,0,0,0,0,1,19360000
nn_kernel_gpu,1174,1,1,151250,128,0,0,0,0,1,19360000
nn_kernel_gpu_mem,30270,1,1,151250,128,154880000,77440000,77440000,154880000,1,19360000
nn_kernel_cpu,14341,0,1,1,64,0,0,0,0,1,19370000
nn_kernel_gpu,1171,1,1,151329,128,0,0,0,0,1,19370000
nn_kernel_gpu_mem,25029,1,1,151329,128,154960000,77480000,77480000,154960000,1,19370000
nn_kernel_cpu,30279,0,1,1,64,0,0,0,0,1,19380000
nn_kernel_gpu,1168,1,1,151407,128,0,0,0,0,1,19380000
nn_kernel_gpu_mem,23507,1,1,151407,128,155040000,77520000,77520000,155040000,1,19380000
nn_kernel_cpu,20407,0,1,1,64,0,0,0,0,1,19390000
nn_kernel_gpu,1181,1,1,151485,128,0,0,0,0,1,19390000
nn_kernel_gpu_mem,24573,1,1,151485,128,155120000,77560000,77560000,155120000,1,19390000
nn_kernel_cpu,27260,0,1,1,64,0,0,0,0,1,19400000
nn_kernel_gpu,1167,1,1,151563,128,0,0,0,0,1,19400000
nn_kernel_gpu_mem,25297,1,1,151563,128,155200000,77600000,77600000,155200000,1,19400000
nn_kernel_cpu,3587,0,1,1,64,0,0,0,0,1,1940000
nn_kernel_gpu,166,1,1,15157,128,0,0,0,0,1,1940000
nn_kernel_gpu_mem,3262,1,1,15157,128,15520000,7760000,7760000,15520000,1,1940000
nn_kernel_cpu,24773,0,1,1,64,0,0,0,0,1,19410000
nn_kernel_gpu,1169,1,1,151641,128,0,0,0,0,1,19410000
nn_kernel_gpu_mem,26497,1,1,151641,128,155280000,77640000,77640000,155280000,1,19410000
nn_kernel_cpu,17568,0,1,1,64,0,0,0,0,1,19420000
nn_kernel_gpu,1178,1,1,151719,128,0,0,0,0,1,19420000
nn_kernel_gpu_mem,24853,1,1,151719,128,155360000,77680000,77680000,155360000,1,19420000
nn_kernel_cpu,13826,0,1,1,64,0,0,0,0,1,19430000
nn_kernel_gpu,1172,1,1,151797,128,0,0,0,0,1,19430000
nn_kernel_gpu_mem,32979,1,1,151797,128,155440000,77720000,77720000,155440000,1,19430000
nn_kernel_cpu,17166,0,1,1,64,0,0,0,0,1,19440000
nn_kernel_gpu,1174,1,1,151875,128,0,0,0,0,1,19440000
nn_kernel_gpu_mem,34551,1,1,151875,128,155520000,77760000,77760000,155520000,1,19440000
nn_kernel_cpu,12131,0,1,1,64,0,0,0,0,1,19450000
nn_kernel_gpu,1179,1,1,151954,128,0,0,0,0,1,19450000
nn_kernel_gpu_mem,25455,1,1,151954,128,155600000,77800000,77800000,155600000,1,19450000
nn_kernel_cpu,26970,0,1,1,64,0,0,0,0,1,19460000
nn_kernel_gpu,1171,1,1,152032,128,0,0,0,0,1,19460000
nn_kernel_gpu_mem,25411,1,1,152032,128,155680000,77840000,77840000,155680000,1,19460000
nn_kernel_cpu,7581,0,1,1,64,0,0,0,0,1,19470000
nn_kernel_gpu,1172,1,1,152110,128,0,0,0,0,1,19470000
nn_kernel_gpu_mem,25908,1,1,152110,128,155760000,77880000,77880000,155760000,1,19470000
nn_kernel_cpu,22707,0,1,1,64,0,0,0,0,1,19480000
nn_kernel_gpu,1164,1,1,152188,128,0,0,0,0,1,19480000
nn_kernel_gpu_mem,22454,1,1,152188,128,155840000,77920000,77920000,155840000,1,19480000
nn_kernel_cpu,25213,0,1,1,64,0,0,0,0,1,19490000
nn_kernel_gpu,1177,1,1,152266,128,0,0,0,0,1,19490000
nn_kernel_gpu_mem,32891,1,1,152266,128,155920000,77960000,77960000,155920000,1,19490000
nn_kernel_cpu,10571,0,1,1,64,0,0,0,0,1,19500000
nn_kernel_gpu,1169,1,1,152344,128,0,0,0,0,1,19500000
nn_kernel_gpu_mem,35775,1,1,152344,128,156000000,78000000,78000000,156000000,1,19500000
nn_kernel_cpu,4010,0,1,1,64,0,0,0,0,1,1950000
nn_kernel_gpu,151,1,1,15235,128,0,0,0,0,1,1950000
nn_kernel_gpu_mem,3886,1,1,15235,128,15600000,7800000,7800000,15600000,1,1950000
nn_kernel_cpu,29190,0,1,1,64,0,0,0,0,1,19510000
nn_kernel_gpu,1177,1,1,152422,128,0,0,0,0,1,19510000
nn_kernel_gpu_mem,34447,1,1,152422,128,156080000,78040000,78040000,156080000,1,19510000
nn_kernel_cpu,25108,0,1,1,64,0,0,0,0,1,19520000
nn_kernel_gpu,1166,1,1,152500,128,0,0,0,0,1,19520000
nn_kernel_gpu_mem,25811,1,1,152500,128,156160000,78080000,78080000,156160000,1,19520000
nn_kernel_cpu,16123,0,1,1,64,0,0,0,0,1,19530000
nn_kernel_gpu,1193,1,1,152579,128,0,0,0,0,1,19530000
nn_kernel_gpu_mem,34761,1,1,152579,128,156240000,78120000,78120000,156240000,1,19530000
nn_kernel_cpu,23857,0,1,1,64,0,0,0,0,1,19540000
nn_kernel_gpu,1180,1,1,152657,128,0,0,0,0,1,19540000
nn_kernel_gpu_mem,33647,1,1,152657,128,156320000,78160000,78160000,156320000,1,19540000
nn_kernel_cpu,22169,0,1,1,64,0,0,0,0,1,19550000
nn_kernel_gpu,1179,1,1,152735,128,0,0,0,0,1,19550000
nn_kernel_gpu_mem,32795,1,1,152735,128,156400000,78200000,78200000,156400000,1,19550000
nn_kernel_cpu,17218,0,1,1,64,0,0,0,0,1,19560000
nn_kernel_gpu,1189,1,1,152813,128,0,0,0,0,1,19560000
nn_kernel_gpu_mem,26435,1,1,152813,128,156480000,78240000,78240000,156480000,1,19560000
nn_kernel_cpu,15790,0,1,1,64,0,0,0,0,1,19570000
nn_kernel_gpu,1189,1,1,152891,128,0,0,0,0,1,19570000
nn_kernel_gpu_mem,28311,1,1,152891,128,156560000,78280000,78280000,156560000,1,19570000
nn_kernel_cpu,24322,0,1,1,64,0,0,0,0,1,19580000
nn_kernel_gpu,1186,1,1,152969,128,0,0,0,0,1,19580000
nn_kernel_gpu_mem,33099,1,1,152969,128,156640000,78320000,78320000,156640000,1,19580000
nn_kernel_cpu,21983,0,1,1,64,0,0,0,0,1,19590000
nn_kernel_gpu,1189,1,1,153047,128,0,0,0,0,1,19590000
nn_kernel_gpu_mem,32890,1,1,153047,128,156720000,78360000,78360000,156720000,1,19590000
nn_kernel_cpu,13438,0,1,1,64,0,0,0,0,1,19600000
nn_kernel_gpu,1171,1,1,153125,128,0,0,0,0,1,19600000
nn_kernel_gpu_mem,23716,1,1,153125,128,156800000,78400000,78400000,156800000,1,19600000
nn_kernel_cpu,6946,0,1,1,64,0,0,0,0,1,1960000
nn_kernel_gpu,172,1,1,15313,128,0,0,0,0,1,1960000
nn_kernel_gpu_mem,3361,1,1,15313,128,15680000,7840000,7840000,15680000,1,1960000
nn_kernel_cpu,16203,0,1,1,64,0,0,0,0,1,19610000
nn_kernel_gpu,1187,1,1,153204,128,0,0,0,0,1,19610000
nn_kernel_gpu_mem,32854,1,1,153204,128,156880000,78440000,78440000,156880000,1,19610000
nn_kernel_cpu,16181,0,1,1,64,0,0,0,0,1,19620000
nn_kernel_gpu,1203,1,1,153282,128,0,0,0,0,1,19620000
nn_kernel_gpu_mem,25399,1,1,153282,128,156960000,78480000,78480000,156960000,1,19620000
nn_kernel_cpu,13840,0,1,1,64,0,0,0,0,1,19630000
nn_kernel_gpu,1187,1,1,153360,128,0,0,0,0,1,19630000
nn_kernel_gpu_mem,25015,1,1,153360,128,157040000,78520000,78520000,157040000,1,19630000
nn_kernel_cpu,25254,0,1,1,64,0,0,0,0,1,19640000
nn_kernel_gpu,1188,1,1,153438,128,0,0,0,0,1,19640000
nn_kernel_gpu_mem,32531,1,1,153438,128,157120000,78560000,78560000,157120000,1,19640000
nn_kernel_cpu,17223,0,1,1,64,0,0,0,0,1,19650000
nn_kernel_gpu,1195,1,1,153516,128,0,0,0,0,1,19650000
nn_kernel_gpu_mem,23534,1,1,153516,128,157200000,78600000,78600000,157200000,1,19650000
nn_kernel_cpu,26938,0,1,1,64,0,0,0,0,1,19660000
nn_kernel_gpu,1197,1,1,153594,128,0,0,0,0,1,19660000
nn_kernel_gpu_mem,32354,1,1,153594,128,157280000,78640000,78640000,157280000,1,19660000
nn_kernel_cpu,6551,0,1,1,64,0,0,0,0,1,19670000
nn_kernel_gpu,1177,1,1,153672,128,0,0,0,0,1,19670000
nn_kernel_gpu_mem,24944,1,1,153672,128,157360000,78680000,78680000,157360000,1,19670000
nn_kernel_cpu,14636,0,1,1,64,0,0,0,0,1,19680000
nn_kernel_gpu,1190,1,1,153750,128,0,0,0,0,1,19680000
nn_kernel_gpu_mem,31724,1,1,153750,128,157440000,78720000,78720000,157440000,1,19680000
nn_kernel_cpu,8355,0,1,1,64,0,0,0,0,1,19690000
nn_kernel_gpu,1196,1,1,153829,128,0,0,0,0,1,19690000
nn_kernel_gpu_mem,24716,1,1,153829,128,157520000,78760000,78760000,157520000,1,19690000
nn_kernel_cpu,15458,0,1,1,64,0,0,0,0,1,19700000
nn_kernel_gpu,1203,1,1,153907,128,0,0,0,0,1,19700000
nn_kernel_gpu_mem,25080,1,1,153907,128,157600000,78800000,78800000,157600000,1,19700000
nn_kernel_cpu,5056,0,1,1,64,0,0,0,0,1,1970000
nn_kernel_gpu,156,1,1,15391,128,0,0,0,0,1,1970000
nn_kernel_gpu_mem,6357,1,1,15391,128,15760000,7880000,7880000,15760000,1,1970000
nn_kernel_cpu,19022,0,1,1,64,0,0,0,0,1,19710000
nn_kernel_gpu,1188,1,1,153985,128,0,0,0,0,1,19710000
nn_kernel_gpu_mem,23735,1,1,153985,128,157680000,78840000,78840000,157680000,1,19710000
nn_kernel_cpu,19417,0,1,1,64,0,0,0,0,1,19720000
nn_kernel_gpu,1192,1,1,154063,128,0,0,0,0,1,19720000
nn_kernel_gpu_mem,25711,1,1,154063,128,157760000,78880000,78880000,157760000,1,19720000
nn_kernel_cpu,15265,0,1,1,64,0,0,0,0,1,19730000
nn_kernel_gpu,1195,1,1,154141,128,0,0,0,0,1,19730000
nn_kernel_gpu_mem,24983,1,1,154141,128,157840000,78920000,78920000,157840000,1,19730000
nn_kernel_cpu,29044,0,1,1,64,0,0,0,0,1,19740000
nn_kernel_gpu,1194,1,1,154219,128,0,0,0,0,1,19740000
nn_kernel_gpu_mem,31877,1,1,154219,128,157920000,78960000,78960000,157920000,1,19740000
nn_kernel_cpu,27222,0,1,1,64,0,0,0,0,1,19750000
nn_kernel_gpu,1178,1,1,154297,128,0,0,0,0,1,19750000
nn_kernel_gpu_mem,23556,1,1,154297,128,158000000,79000000,79000000,158000000,1,19750000
nn_kernel_cpu,23609,0,1,1,64,0,0,0,0,1,19760000
nn_kernel_gpu,1194,1,1,154375,128,0,0,0,0,1,19760000
nn_kernel_gpu_mem,35119,1,1,154375,128,158080000,79040000,79040000,158080000,1,19760000
nn_kernel_cpu,25081,0,1,1,64,0,0,0,0,1,19770000
nn_kernel_gpu,1188,1,1,154454,128,0,0,0,0,1,19770000
nn_kernel_gpu_mem,23080,1,1,154454,128,158160000,79080000,79080000,158160000,1,19770000
nn_kernel_cpu,35859,0,1,1,64,0,0,0,0,1,19780000
nn_kernel_gpu,1199,1,1,154532,128,0,0,0,0,1,19780000
nn_kernel_gpu_mem,25681,1,1,154532,128,158240000,79120000,79120000,158240000,1,19780000
nn_kernel_cpu,8667,0,1,1,64,0,0,0,0,1,19790000
nn_kernel_gpu,1193,1,1,154610,128,0,0,0,0,1,19790000
nn_kernel_gpu_mem,32631,1,1,154610,128,158320000,79160000,79160000,158320000,1,19790000
nn_kernel_cpu,24627,0,1,1,64,0,0,0,0,1,19800000
nn_kernel_gpu,1191,1,1,154688,128,0,0,0,0,1,19800000
nn_kernel_gpu_mem,25239,1,1,154688,128,158400000,79200000,79200000,158400000,1,19800000
nn_kernel_cpu,4452,0,1,1,64,0,0,0,0,1,1980000
nn_kernel_gpu,173,1,1,15469,128,0,0,0,0,1,1980000
nn_kernel_gpu_mem,7626,1,1,15469,128,15840000,7920000,7920000,15840000,1,1980000
nn_kernel_cpu,27368,0,1,1,64,0,0,0,0,1,19810000
nn_kernel_gpu,1197,1,1,154766,128,0,0,0,0,1,19810000
nn_kernel_gpu_mem,25929,1,1,154766,128,158480000,79240000,79240000,158480000,1,19810000
nn_kernel_cpu,7141,0,1,1,64,0,0,0,0,1,19820000
nn_kernel_gpu,1197,1,1,154844,128,0,0,0,0,1,19820000
nn_kernel_gpu_mem,25655,1,1,154844,128,158560000,79280000,79280000,158560000,1,19820000
nn_kernel_cpu,9538,0,1,1,64,0,0,0,0,1,19830000
nn_kernel_gpu,1191,1,1,154922,128,0,0,0,0,1,19830000
nn_kernel_gpu_mem,25473,1,1,154922,128,158640000,79320000,79320000,158640000,1,19830000
nn_kernel_cpu,28343,0,1,1,64,0,0,0,0,1,19840000
nn_kernel_gpu,1205,1,1,155000,128,0,0,0,0,1,19840000
nn_kernel_gpu_mem,29052,1,1,155000,128,158720000,79360000,79360000,158720000,1,19840000
nn_kernel_cpu,18159,0,1,1,64,0,0,0,0,1,19850000
nn_kernel_gpu,1191,1,1,155079,128,0,0,0,0,1,19850000
nn_kernel_gpu_mem,33370,1,1,155079,128,158800000,79400000,79400000,158800000,1,19850000
nn_kernel_cpu,26247,0,1,1,64,0,0,0,0,1,19860000
nn_kernel_gpu,1186,1,1,155157,128,0,0,0,0,1,19860000
nn_kernel_gpu_mem,26081,1,1,155157,128,158880000,79440000,79440000,158880000,1,19860000
nn_kernel_cpu,13803,0,1,1,64,0,0,0,0,1,19870000
nn_kernel_gpu,1206,1,1,155235,128,0,0,0,0,1,19870000
nn_kernel_gpu_mem,24043,1,1,155235,128,158960000,79480000,79480000,158960000,1,19870000
nn_kernel_cpu,32109,0,1,1,64,0,0,0,0,1,19880000
nn_kernel_gpu,1200,1,1,155313,128,0,0,0,0,1,19880000
nn_kernel_gpu_mem,32143,1,1,155313,128,159040000,79520000,79520000,159040000,1,19880000
nn_kernel_cpu,12402,0,1,1,64,0,0,0,0,1,19890000
nn_kernel_gpu,1208,1,1,155391,128,0,0,0,0,1,19890000
nn_kernel_gpu_mem,27213,1,1,155391,128,159120000,79560000,79560000,159120000,1,19890000
nn_kernel_cpu,12359,0,1,1,64,0,0,0,0,1,19900000
nn_kernel_gpu,1201,1,1,155469,128,0,0,0,0,1,19900000
nn_kernel_gpu_mem,32698,1,1,155469,128,159200000,79600000,79600000,159200000,1,19900000
nn_kernel_cpu,23820,0,1,1,64,0,0,0,0,1,1990000
nn_kernel_gpu,170,1,1,15547,128,0,0,0,0,1,1990000
nn_kernel_gpu_mem,2877,1,1,15547,128,15920000,7960000,7960000,15920000,1,1990000
nn_kernel_cpu,21718,0,1,1,64,0,0,0,0,1,19910000
nn_kernel_gpu,1199,1,1,155547,128,0,0,0,0,1,19910000
nn_kernel_gpu_mem,25022,1,1,155547,128,159280000,79640000,79640000,159280000,1,19910000
nn_kernel_cpu,12317,0,1,1,64,0,0,0,0,1,19920000
nn_kernel_gpu,1218,1,1,155625,128,0,0,0,0,1,19920000
nn_kernel_gpu_mem,35085,1,1,155625,128,159360000,79680000,79680000,159360000,1,19920000
nn_kernel_cpu,7924,0,1,1,64,0,0,0,0,1,19930000
nn_kernel_gpu,1198,1,1,155704,128,0,0,0,0,1,19930000
nn_kernel_gpu_mem,34280,1,1,155704,128,159440000,79720000,79720000,159440000,1,19930000
nn_kernel_cpu,22606,0,1,1,64,0,0,0,0,1,19940000
nn_kernel_gpu,1215,1,1,155782,128,0,0,0,0,1,19940000
nn_kernel_gpu_mem,33041,1,1,155782,128,159520000,79760000,79760000,159520000,1,19940000
nn_kernel_cpu,23218,0,1,1,64,0,0,0,0,1,19950000
nn_kernel_gpu,1201,1,1,155860,128,0,0,0,0,1,19950000
nn_kernel_gpu_mem,34251,1,1,155860,128,159600000,79800000,79800000,159600000,1,19950000
nn_kernel_cpu,13072,0,1,1,64,0,0,0,0,1,19960000
nn_kernel_gpu,1199,1,1,155938,128,0,0,0,0,1,19960000
nn_kernel_gpu_mem,26450,1,1,155938,128,159680000,79840000,79840000,159680000,1,19960000
nn_kernel_cpu,19641,0,1,1,64,0,0,0,0,1,19970000
nn_kernel_gpu,1200,1,1,156016,128,0,0,0,0,1,19970000
nn_kernel_gpu_mem,26573,1,1,156016,128,159760000,79880000,79880000,159760000,1,19970000
nn_kernel_cpu,24301,0,1,1,64,0,0,0,0,1,19980000
nn_kernel_gpu,1210,1,1,156094,128,0,0,0,0,1,19980000
nn_kernel_gpu_mem,33217,1,1,156094,128,159840000,79920000,79920000,159840000,1,19980000
nn_kernel_cpu,34245,0,1,1,64,0,0,0,0,1,19990000
nn_kernel_gpu,1208,1,1,156172,128,0,0,0,0,1,19990000
nn_kernel_gpu_mem,45042,1,1,156172,128,159920000,79960000,79960000,159920000,1,19990000
nn_kernel_cpu,18886,0,1,1,64,0,0,0,0,1,20000000
nn_kernel_gpu,1210,1,1,156250,128,0,0,0,0,1,20000000
nn_kernel_gpu_mem,24839,1,1,156250,128,160000000,80000000,80000000,160000000,1,20000000
nn_kernel_cpu,14573,0,1,1,64,0,0,0,0,1,2000000
nn_kernel_gpu,177,1,1,15625,128,0,0,0,0,1,2000000
nn_kernel_gpu_mem,3178,1,1,15625,128,16000000,8000000,8000000,16000000,1,2000000
nn_kernel_cpu,434,0,1,1,64,0,0,0,0,1,200000
nn_kernel_gpu,58,1,1,1563,128,0,0,0,0,1,200000
nn_kernel_gpu_mem,870,1,1,1563,128,1600000,800000,800000,1600000,1,200000
nn_kernel_cpu,5582,0,1,1,64,0,0,0,0,1,20000
nn_kernel_gpu,27,1,1,157,128,0,0,0,0,1,20000
nn_kernel_gpu_mem,81,1,1,157,128,160000,80000,80000,160000,1,20000
nn_kernel_cpu,15599,0,1,1,64,0,0,0,0,1,20010000
nn_kernel_gpu,1235,1,1,156329,128,0,0,0,0,1,20010000
nn_kernel_gpu_mem,35066,1,1,156329,128,160080000,80040000,80040000,160080000,1,20010000
nn_kernel_cpu,9156,0,1,1,64,0,0,0,0,1,20020000
nn_kernel_gpu,1236,1,1,156407,128,0,0,0,0,1,20020000
nn_kernel_gpu_mem,34465,1,1,156407,128,160160000,80080000,80080000,160160000,1,20020000
nn_kernel_cpu,23206,0,1,1,64,0,0,0,0,1,20030000
nn_kernel_gpu,1216,1,1,156485,128,0,0,0,0,1,20030000
nn_kernel_gpu_mem,26176,1,1,156485,128,160240000,80120000,80120000,160240000,1,20030000
nn_kernel_cpu,22796,0,1,1,64,0,0,0,0,1,20040000
nn_kernel_gpu,1212,1,1,156563,128,0,0,0,0,1,20040000
nn_kernel_gpu_mem,25355,1,1,156563,128,160320000,80160000,80160000,160320000,1,20040000
nn_kernel_cpu,22195,0,1,1,64,0,0,0,0,1,20050000
nn_kernel_gpu,1205,1,1,156641,128,0,0,0,0,1,20050000
nn_kernel_gpu_mem,33513,1,1,156641,128,160400000,80200000,80200000,160400000,1,20050000
nn_kernel_cpu,8925,0,1,1,64,0,0,0,0,1,20060000
nn_kernel_gpu,1215,1,1,156719,128,0,0,0,0,1,20060000
nn_kernel_gpu_mem,25028,1,1,156719,128,160480000,80240000,80240000,160480000,1,20060000
nn_kernel_cpu,9531,0,1,1,64,0,0,0,0,1,20070000
nn_kernel_gpu,1238,1,1,156797,128,0,0,0,0,1,20070000
nn_kernel_gpu_mem,24953,1,1,156797,128,160560000,80280000,80280000,160560000,1,20070000
nn_kernel_cpu,16122,0,1,1,64,0,0,0,0,1,20080000
nn_kernel_gpu,1212,1,1,156875,128,0,0,0,0,1,20080000
nn_kernel_gpu_mem,33333,1,1,156875,128,160640000,80320000,80320000,160640000,1,20080000
nn_kernel_cpu,24064,0,1,1,64,0,0,0,0,1,20090000
nn_kernel_gpu,1235,1,1,156954,128,0,0,0,0,1,20090000
nn_kernel_gpu_mem,32066,1,1,156954,128,160720000,80360000,80360000,160720000,1,20090000
nn_kernel_cpu,7170,0,1,1,64,0,0,0,0,1,20100000
nn_kernel_gpu,1205,1,1,157032,128,0,0,0,0,1,20100000
nn_kernel_gpu_mem,30598,1,1,157032,128,160800000,80400000,80400000,160800000,1,20100000
nn_kernel_cpu,5197,0,1,1,64,0,0,0,0,1,2010000
nn_kernel_gpu,175,1,1,15704,128,0,0,0,0,1,2010000
nn_kernel_gpu_mem,3256,1,1,15704,128,16080000,8040000,8040000,16080000,1,2010000
nn_kernel_cpu,24818,0,1,1,64,0,0,0,0,1,20110000
nn_kernel_gpu,1224,1,1,157110,128,0,0,0,0,1,20110000
nn_kernel_gpu_mem,27400,1,1,157110,128,160880000,80440000,80440000,160880000,1,20110000
nn_kernel_cpu,23399,0,1,1,64,0,0,0,0,1,20120000
nn_kernel_gpu,1204,1,1,157188,128,0,0,0,0,1,20120000
nn_kernel_gpu_mem,30702,1,1,157188,128,160960000,80480000,80480000,160960000,1,20120000
nn_kernel_cpu,14139,0,1,1,64,0,0,0,0,1,20130000
nn_kernel_gpu,1217,1,1,157266,128,0,0,0,0,1,20130000
nn_kernel_gpu_mem,33503,1,1,157266,128,161040000,80520000,80520000,161040000,1,20130000
nn_kernel_cpu,24162,0,1,1,64,0,0,0,0,1,20140000
nn_kernel_gpu,1224,1,1,157344,128,0,0,0,0,1,20140000
nn_kernel_gpu_mem,32905,1,1,157344,128,161120000,80560000,80560000,161120000,1,20140000
nn_kernel_cpu,15524,0,1,1,64,0,0,0,0,1,20150000
nn_kernel_gpu,1221,1,1,157422,128,0,0,0,0,1,20150000
nn_kernel_gpu_mem,38865,1,1,157422,128,161200000,80600000,80600000,161200000,1,20150000
nn_kernel_cpu,27055,0,1,1,64,0,0,0,0,1,20160000
nn_kernel_gpu,1208,1,1,157500,128,0,0,0,0,1,20160000
nn_kernel_gpu_mem,36190,1,1,157500,128,161280000,80640000,80640000,161280000,1,20160000
nn_kernel_cpu,35453,0,1,1,64,0,0,0,0,1,20170000
nn_kernel_gpu,1221,1,1,157579,128,0,0,0,0,1,20170000
nn_kernel_gpu_mem,25175,1,1,157579,128,161360000,80680000,80680000,161360000,1,20170000
nn_kernel_cpu,37039,0,1,1,64,0,0,0,0,1,20180000
nn_kernel_gpu,1203,1,1,157657,128,0,0,0,0,1,20180000
nn_kernel_gpu_mem,24578,1,1,157657,128,161440000,80720000,80720000,161440000,1,20180000
nn_kernel_cpu,25304,0,1,1,64,0,0,0,0,1,20190000
nn_kernel_gpu,1223,1,1,157735,128,0,0,0,0,1,20190000
nn_kernel_gpu_mem,27005,1,1,157735,128,161520000,80760000,80760000,161520000,1,20190000
nn_kernel_cpu,24971,0,1,1,64,0,0,0,0,1,20200000
nn_kernel_gpu,1219,1,1,157813,128,0,0,0,0,1,20200000
nn_kernel_gpu_mem,29336,1,1,157813,128,161600000,80800000,80800000,161600000,1,20200000
nn_kernel_cpu,12981,0,1,1,64,0,0,0,0,1,2020000
nn_kernel_gpu,163,1,1,15782,128,0,0,0,0,1,2020000
nn_kernel_gpu_mem,3499,1,1,15782,128,16160000,8080000,8080000,16160000,1,2020000
nn_kernel_cpu,14913,0,1,1,64,0,0,0,0,1,20210000
nn_kernel_gpu,1217,1,1,157891,128,0,0,0,0,1,20210000
nn_kernel_gpu_mem,25807,1,1,157891,128,161680000,80840000,80840000,161680000,1,20210000
nn_kernel_cpu,12803,0,1,1,64,0,0,0,0,1,20220000
nn_kernel_gpu,1230,1,1,157969,128,0,0,0,0,1,20220000
nn_kernel_gpu_mem,39933,1,1,157969,128,161760000,80880000,80880000,161760000,1,20220000
nn_kernel_cpu,30696,0,1,1,64,0,0,0,0,1,20230000
nn_kernel_gpu,1268,1,1,158047,128,0,0,0,0,1,20230000
nn_kernel_gpu_mem,34620,1,1,158047,128,161840000,80920000,80920000,161840000,1,20230000
nn_kernel_cpu,13849,0,1,1,64,0,0,0,0,1,20240000
nn_kernel_gpu,1225,1,1,158125,128,0,0,0,0,1,20240000
nn_kernel_gpu_mem,33322,1,1,158125,128,161920000,80960000,80960000,161920000,1,20240000
nn_kernel_cpu,25003,0,1,1,64,0,0,0,0,1,20250000
nn_kernel_gpu,1212,1,1,158204,128,0,0,0,0,1,20250000
nn_kernel_gpu_mem,26504,1,1,158204,128,162000000,81000000,81000000,162000000,1,20250000
nn_kernel_cpu,26365,0,1,1,64,0,0,0,0,1,20260000
nn_kernel_gpu,1220,1,1,158282,128,0,0,0,0,1,20260000
nn_kernel_gpu_mem,25589,1,1,158282,128,162080000,81040000,81040000,162080000,1,20260000
nn_kernel_cpu,9119,0,1,1,64,0,0,0,0,1,20270000
nn_kernel_gpu,1223,1,1,158360,128,0,0,0,0,1,20270000
nn_kernel_gpu_mem,33200,1,1,158360,128,162160000,81080000,81080000,162160000,1,20270000
nn_kernel_cpu,17639,0,1,1,64,0,0,0,0,1,20280000
nn_kernel_gpu,1222,1,1,158438,128,0,0,0,0,1,20280000
nn_kernel_gpu_mem,35033,1,1,158438,128,162240000,81120000,81120000,162240000,1,20280000
nn_kernel_cpu,12263,0,1,1,64,0,0,0,0,1,20290000
nn_kernel_gpu,1243,1,1,158516,128,0,0,0,0,1,20290000
nn_kernel_gpu_mem,34213,1,1,158516,128,162320000,81160000,81160000,162320000,1,20290000
nn_kernel_cpu,7531,0,1,1,64,0,0,0,0,1,20300000
nn_kernel_gpu,1225,1,1,158594,128,0,0,0,0,1,20300000
nn_kernel_gpu_mem,33140,1,1,158594,128,162400000,81200000,81200000,162400000,1,20300000
nn_kernel_cpu,9080,0,1,1,64,0,0,0,0,1,2030000
nn_kernel_gpu,189,1,1,15860,128,0,0,0,0,1,2030000
nn_kernel_gpu_mem,5103,1,1,15860,128,16240000,8120000,8120000,16240000,1,2030000
nn_kernel_cpu,14904,0,1,1,64,0,0,0,0,1,20310000
nn_kernel_gpu,1217,1,1,158672,128,0,0,0,0,1,20310000
nn_kernel_gpu_mem,31914,1,1,158672,128,162480000,81240000,81240000,162480000,1,20310000
nn_kernel_cpu,30785,0,1,1,64,0,0,0,0,1,20320000
nn_kernel_gpu,1222,1,1,158750,128,0,0,0,0,1,20320000
nn_kernel_gpu_mem,26784,1,1,158750,128,162560000,81280000,81280000,162560000,1,20320000
nn_kernel_cpu,18058,0,1,1,64,0,0,0,0,1,20330000
nn_kernel_gpu,1224,1,1,158829,128,0,0,0,0,1,20330000
nn_kernel_gpu_mem,25496,1,1,158829,128,162640000,81320000,81320000,162640000,1,20330000
nn_kernel_cpu,21348,0,1,1,64,0,0,0,0,1,20340000
nn_kernel_gpu,1225,1,1,158907,128,0,0,0,0,1,20340000
nn_kernel_gpu_mem,33018,1,1,158907,128,162720000,81360000,81360000,162720000,1,20340000
nn_kernel_cpu,12431,0,1,1,64,0,0,0,0,1,20350000
nn_kernel_gpu,1234,1,1,158985,128,0,0,0,0,1,20350000
nn_kernel_gpu_mem,26928,1,1,158985,128,162800000,81400000,81400000,162800000,1,20350000
nn_kernel_cpu,11600,0,1,1,64,0,0,0,0,1,20360000
nn_kernel_gpu,1229,1,1,159063,128,0,0,0,0,1,20360000
nn_kernel_gpu_mem,33606,1,1,159063,128,162880000,81440000,81440000,162880000,1,20360000
nn_kernel_cpu,27862,0,1,1,64,0,0,0,0,1,20370000
nn_kernel_gpu,1223,1,1,159141,128,0,0,0,0,1,20370000
nn_kernel_gpu_mem,28041,1,1,159141,128,162960000,81480000,81480000,162960000,1,20370000
nn_kernel_cpu,26976,0,1,1,64,0,0,0,0,1,20380000
nn_kernel_gpu,1230,1,1,159219,128,0,0,0,0,1,20380000
nn_kernel_gpu_mem,29915,1,1,159219,128,163040000,81520000,81520000,163040000,1,20380000
nn_kernel_cpu,23192,0,1,1,64,0,0,0,0,1,20390000
nn_kernel_gpu,1220,1,1,159297,128,0,0,0,0,1,20390000
nn_kernel_gpu_mem,26088,1,1,159297,128,163120000,81560000,81560000,163120000,1,20390000
nn_kernel_cpu,10753,0,1,1,64,0,0,0,0,1,20400000
nn_kernel_gpu,1235,1,1,159375,128,0,0,0,0,1,20400000
nn_kernel_gpu_mem,38310,1,1,159375,128,163200000,81600000,81600000,163200000,1,20400000
nn_kernel_cpu,35913,0,1,1,64,0,0,0,0,1,2040000
nn_kernel_gpu,187,1,1,15938,128,0,0,0,0,1,2040000
nn_kernel_gpu_mem,3319,1,1,15938,128,16320000,8160000,8160000,16320000,1,2040000
nn_kernel_cpu,13301,0,1,1,64,0,0,0,0,1,20410000
nn_kernel_gpu,1229,1,1,159454,128,0,0,0,0,1,20410000
nn_kernel_gpu_mem,27188,1,1,159454,128,163280000,81640000,81640000,163280000,1,20410000
nn_kernel_cpu,28128,0,1,1,64,0,0,0,0,1,20420000
nn_kernel_gpu,1232,1,1,159532,128,0,0,0,0,1,20420000
nn_kernel_gpu_mem,36789,1,1,159532,128,163360000,81680000,81680000,163360000,1,20420000
nn_kernel_cpu,22041,0,1,1,64,0,0,0,0,1,20430000
nn_kernel_gpu,1225,1,1,159610,128,0,0,0,0,1,20430000
nn_kernel_gpu_mem,28656,1,1,159610,128,163440000,81720000,81720000,163440000,1,20430000
nn_kernel_cpu,27421,0,1,1,64,0,0,0,0,1,20440000
nn_kernel_gpu,1250,1,1,159688,128,0,0,0,0,1,20440000
nn_kernel_gpu_mem,30493,1,1,159688,128,163520000,81760000,81760000,163520000,1,20440000
nn_kernel_cpu,33269,0,1,1,64,0,0,0,0,1,20450000
nn_kernel_gpu,1217,1,1,159766,128,0,0,0,0,1,20450000
nn_kernel_gpu_mem,49359,1,1,159766,128,163600000,81800000,81800000,163600000,1,20450000
nn_kernel_cpu,32367,0,1,1,64,0,0,0,0,1,20460000
nn_kernel_gpu,1241,1,1,159844,128,0,0,0,0,1,20460000
nn_kernel_gpu_mem,34499,1,1,159844,128,163680000,81840000,81840000,163680000,1,20460000
nn_kernel_cpu,28911,0,1,1,64,0,0,0,0,1,20470000
nn_kernel_gpu,1218,1,1,159922,128,0,0,0,0,1,20470000
nn_kernel_gpu_mem,33534,1,1,159922,128,163760000,81880000,81880000,163760000,1,20470000
nn_kernel_cpu,16810,0,1,1,64,0,0,0,0,1,20480000
nn_kernel_gpu,1222,1,1,160000,128,0,0,0,0,1,20480000
nn_kernel_gpu_mem,24836,1,1,160000,128,163840000,81920000,81920000,163840000,1,20480000
nn_kernel_cpu,14236,0,1,1,64,0,0,0,0,1,20490000
nn_kernel_gpu,1230,1,1,160079,128,0,0,0,0,1,20490000
nn_kernel_gpu_mem,29602,1,1,160079,128,163920000,81960000,81960000,163920000,1,20490000
nn_kernel_cpu,30976,0,1,1,64,0,0,0,0,1,20500000
nn_kernel_gpu,1230,1,1,160157,128,0,0,0,0,1,20500000
nn_kernel_gpu_mem,34581,1,1,160157,128,164000000,82000000,82000000,164000000,1,20500000
nn_kernel_cpu,4115,0,1,1,64,0,0,0,0,1,2050000
nn_kernel_gpu,181,1,1,16016,128,0,0,0,0,1,2050000
nn_kernel_gpu_mem,3564,1,1,16016,128,16400000,8200000,8200000,16400000,1,2050000
nn_kernel_cpu,13912,0,1,1,64,0,0,0,0,1,20510000
nn_kernel_gpu,1227,1,1,160235,128,0,0,0,0,1,20510000
nn_kernel_gpu_mem,27594,1,1,160235,128,164080000,82040000,82040000,164080000,1,20510000
nn_kernel_cpu,12149,0,1,1,64,0,0,0,0,1,20520000
nn_kernel_gpu,1222,1,1,160313,128,0,0,0,0,1,20520000
nn_kernel_gpu_mem,25821,1,1,160313,128,164160000,82080000,82080000,164160000,1,20520000
nn_kernel_cpu,12049,0,1,1,64,0,0,0,0,1,20530000
nn_kernel_gpu,1236,1,1,160391,128,0,0,0,0,1,20530000
nn_kernel_gpu_mem,25030,1,1,160391,128,164240000,82120000,82120000,164240000,1,20530000
nn_kernel_cpu,27321,0,1,1,64,0,0,0,0,1,20540000
nn_kernel_gpu,1236,1,1,160469,128,0,0,0,0,1,20540000
nn_kernel_gpu_mem,33685,1,1,160469,128,164320000,82160000,82160000,164320000,1,20540000
nn_kernel_cpu,12967,0,1,1,64,0,0,0,0,1,20550000
nn_kernel_gpu,1224,1,1,160547,128,0,0,0,0,1,20550000
nn_kernel_gpu_mem,27329,1,1,160547,128,164400000,82200000,82200000,164400000,1,20550000
nn_kernel_cpu,11654,0,1,1,64,0,0,0,0,1,20560000
nn_kernel_gpu,1239,1,1,160625,128,0,0,0,0,1,20560000
nn_kernel_gpu_mem,32657,1,1,160625,128,164480000,82240000,82240000,164480000,1,20560000
nn_kernel_cpu,22458,0,1,1,64,0,0,0,0,1,20570000
nn_kernel_gpu,1230,1,1,160704,128,0,0,0,0,1,20570000
nn_kernel_gpu_mem,24991,1,1,160704,128,164560000,82280000,82280000,164560000,1,20570000
nn_kernel_cpu,26697,0,1,1,64,0,0,0,0,1,20580000
nn_kernel_gpu,1231,1,1,160782,128,0,0,0,0,1,20580000
nn_kernel_gpu_mem,32608,1,1,160782,128,164640000,82320000,82320000,164640000,1,20580000
nn_kernel_cpu,16512,0,1,1,64,0,0,0,0,1,20590000
nn_kernel_gpu,1236,1,1,160860,128,0,0,0,0,1,20590000
nn_kernel_gpu_mem,26572,1,1,160860,128,164720000,82360000,82360000,164720000,1,20590000
nn_kernel_cpu,17065,0,1,1,64,0,0,0,0,1,20600000
nn_kernel_gpu,1244,1,1,160938,128,0,0,0,0,1,20600000
nn_kernel_gpu_mem,30036,1,1,160938,128,164800000,82400000,82400000,164800000,1,20600000
nn_kernel_cpu,3800,0,1,1,64,0,0,0,0,1,2060000
nn_kernel_gpu,191,1,1,16094,128,0,0,0,0,1,2060000
nn_kernel_gpu_mem,3339,1,1,16094,128,16480000,8240000,8240000,16480000,1,2060000
nn_kernel_cpu,26206,0,1,1,64,0,0,0,0,1,20610000
nn_kernel_gpu,1230,1,1,161016,128,0,0,0,0,1,20610000
nn_kernel_gpu_mem,35675,1,1,161016,128,164880000,82440000,82440000,164880000,1,20610000
nn_kernel_cpu,14690,0,1,1,64,0,0,0,0,1,20620000
nn_kernel_gpu,1241,1,1,161094,128,0,0,0,0,1,20620000
nn_kernel_gpu_mem,29934,1,1,161094,128,164960000,82480000,82480000,164960000,1,20620000
nn_kernel_cpu,20387,0,1,1,64,0,0,0,0,1,20630000
nn_kernel_gpu,1248,1,1,161172,128,0,0,0,0,1,20630000
nn_kernel_gpu_mem,33719,1,1,161172,128,165040000,82520000,82520000,165040000,1,20630000
nn_kernel_cpu,25441,0,1,1,64,0,0,0,0,1,20640000
nn_kernel_gpu,1236,1,1,161250,128,0,0,0,0,1,20640000
nn_kernel_gpu_mem,35075,1,1,161250,128,165120000,82560000,82560000,165120000,1,20640000
nn_kernel_cpu,12308,0,1,1,64,0,0,0,0,1,20650000
nn_kernel_gpu,1239,1,1,161329,128,0,0,0,0,1,20650000
nn_kernel_gpu_mem,35251,1,1,161329,128,165200000,82600000,82600000,165200000,1,20650000
nn_kernel_cpu,14499,0,1,1,64,0,0,0,0,1,20660000
nn_kernel_gpu,1239,1,1,161407,128,0,0,0,0,1,20660000
nn_kernel_gpu_mem,33651,1,1,161407,128,165280000,82640000,82640000,165280000,1,20660000
nn_kernel_cpu,25117,0,1,1,64,0,0,0,0,1,20670000
nn_kernel_gpu,1241,1,1,161485,128,0,0,0,0,1,20670000
nn_kernel_gpu_mem,32939,1,1,161485,128,165360000,82680000,82680000,165360000,1,20670000
nn_kernel_cpu,22767,0,1,1,64,0,0,0,0,1,20680000
nn_kernel_gpu,1239,1,1,161563,128,0,0,0,0,1,20680000
nn_kernel_gpu_mem,36025,1,1,161563,128,165440000,82720000,82720000,165440000,1,20680000
nn_kernel_cpu,25341,0,1,1,64,0,0,0,0,1,20690000
nn_kernel_gpu,1229,1,1,161641,128,0,0,0,0,1,20690000
nn_kernel_gpu_mem,26418,1,1,161641,128,165520000,82760000,82760000,165520000,1,20690000
nn_kernel_cpu,21196,0,1,1,64,0,0,0,0,1,20700000
nn_kernel_gpu,1238,1,1,161719,128,0,0,0,0,1,20700000
nn_kernel_gpu_mem,33348,1,1,161719,128,165600000,82800000,82800000,165600000,1,20700000
nn_kernel_cpu,16432,0,1,1,64,0,0,0,0,1,2070000
nn_kernel_gpu,166,1,1,16172,128,0,0,0,0,1,2070000
nn_kernel_gpu_mem,3355,1,1,16172,128,16560000,8280000,8280000,16560000,1,2070000
nn_kernel_cpu,18916,0,1,1,64,0,0,0,0,1,20710000
nn_kernel_gpu,1245,1,1,161797,128,0,0,0,0,1,20710000
nn_kernel_gpu_mem,29456,1,1,161797,128,165680000,82840000,82840000,165680000,1,20710000
nn_kernel_cpu,25408,0,1,1,64,0,0,0,0,1,20720000
nn_kernel_gpu,1282,1,1,161875,128,0,0,0,0,1,20720000
nn_kernel_gpu_mem,29102,1,1,161875,128,165760000,82880000,82880000,165760000,1,20720000
nn_kernel_cpu,25822,0,1,1,64,0,0,0,0,1,20730000
nn_kernel_gpu,1238,1,1,161954,128,0,0,0,0,1,20730000
nn_kernel_gpu_mem,32404,1,1,161954,128,165840000,82920000,82920000,165840000,1,20730000
nn_kernel_cpu,25037,0,1,1,64,0,0,0,0,1,20740000
nn_kernel_gpu,1242,1,1,162032,128,0,0,0,0,1,20740000
nn_kernel_gpu_mem,37742,1,1,162032,128,165920000,82960000,82960000,165920000,1,20740000
nn_kernel_cpu,24496,0,1,1,64,0,0,0,0,1,20750000
nn_kernel_gpu,1233,1,1,162110,128,0,0,0,0,1,20750000
nn_kernel_gpu_mem,36036,1,1,162110,128,166000000,83000000,83000000,166000000,1,20750000
nn_kernel_cpu,24979,0,1,1,64,0,0,0,0,1,20760000
nn_kernel_gpu,1238,1,1,162188,128,0,0,0,0,1,20760000
nn_kernel_gpu_mem,33950,1,1,162188,128,166080000,83040000,83040000,166080000,1,20760000
nn_kernel_cpu,17378,0,1,1,64,0,0,0,0,1,20770000
nn_kernel_gpu,1233,1,1,162266,128,0,0,0,0,1,20770000
nn_kernel_gpu_mem,32537,1,1,162266,128,166160000,83080000,83080000,166160000,1,20770000
nn_kernel_cpu,27861,0,1,1,64,0,0,0,0,1,20780000
nn_kernel_gpu,1241,1,1,162344,128,0,0,0,0,1,20780000
nn_kernel_gpu_mem,35341,1,1,162344,128,166240000,83120000,83120000,166240000,1,20780000
nn_kernel_cpu,27200,0,1,1,64,0,0,0,0,1,20790000
nn_kernel_gpu,1235,1,1,162422,128,0,0,0,0,1,20790000
nn_kernel_gpu_mem,36078,1,1,162422,128,166320000,83160000,83160000,166320000,1,20790000
nn_kernel_cpu,22781,0,1,1,64,0,0,0,0,1,20800000
nn_kernel_gpu,1249,1,1,162500,128,0,0,0,0,1,20800000
nn_kernel_gpu_mem,33650,1,1,162500,128,166400000,83200000,83200000,166400000,1,20800000
nn_kernel_cpu,15177,0,1,1,64,0,0,0,0,1,2080000
nn_kernel_gpu,176,1,1,16250,128,0,0,0,0,1,2080000
nn_kernel_gpu_mem,2959,1,1,16250,128,16640000,8320000,8320000,16640000,1,2080000
nn_kernel_cpu,19982,0,1,1,64,0,0,0,0,1,20810000
nn_kernel_gpu,1271,1,1,162579,128,0,0,0,0,1,20810000
nn_kernel_gpu_mem,34200,1,1,162579,128,166480000,83240000,83240000,166480000,1,20810000
nn_kernel_cpu,15166,0,1,1,64,0,0,0,0,1,20820000
nn_kernel_gpu,1244,1,1,162657,128,0,0,0,0,1,20820000
nn_kernel_gpu_mem,40046,1,1,162657,128,166560000,83280000,83280000,166560000,1,20820000
nn_kernel_cpu,21204,0,1,1,64,0,0,0,0,1,20830000
nn_kernel_gpu,1244,1,1,162735,128,0,0,0,0,1,20830000
nn_kernel_gpu_mem,32678,1,1,162735,128,166640000,83320000,83320000,166640000,1,20830000
nn_kernel_cpu,22830,0,1,1,64,0,0,0,0,1,20840000
nn_kernel_gpu,1254,1,1,162813,128,0,0,0,0,1,20840000
nn_kernel_gpu_mem,36290,1,1,162813,128,166720000,83360000,83360000,166720000,1,20840000
nn_kernel_cpu,27605,0,1,1,64,0,0,0,0,1,20850000
nn_kernel_gpu,1256,1,1,162891,128,0,0,0,0,1,20850000
nn_kernel_gpu_mem,34990,1,1,162891,128,166800000,83400000,83400000,166800000,1,20850000
nn_kernel_cpu,16388,0,1,1,64,0,0,0,0,1,20860000
nn_kernel_gpu,1259,1,1,162969,128,0,0,0,0,1,20860000
nn_kernel_gpu_mem,36761,1,1,162969,128,166880000,83440000,83440000,166880000,1,20860000
nn_kernel_cpu,22354,0,1,1,64,0,0,0,0,1,20870000
nn_kernel_gpu,1241,1,1,163047,128,0,0,0,0,1,20870000
nn_kernel_gpu_mem,29364,1,1,163047,128,166960000,83480000,83480000,166960000,1,20870000
nn_kernel_cpu,18235,0,1,1,64,0,0,0,0,1,20880000
nn_kernel_gpu,1256,1,1,163125,128,0,0,0,0,1,20880000
nn_kernel_gpu_mem,30768,1,1,163125,128,167040000,83520000,83520000,167040000,1,20880000
nn_kernel_cpu,18476,0,1,1,64,0,0,0,0,1,20890000
nn_kernel_gpu,1253,1,1,163204,128,0,0,0,0,1,20890000
nn_kernel_gpu_mem,27731,1,1,163204,128,167120000,83560000,83560000,167120000,1,20890000
nn_kernel_cpu,9088,0,1,1,64,0,0,0,0,1,20900000
nn_kernel_gpu,1258,1,1,163282,128,0,0,0,0,1,20900000
nn_kernel_gpu_mem,34339,1,1,163282,128,167200000,83600000,83600000,167200000,1,20900000
nn_kernel_cpu,8130,0,1,1,64,0,0,0,0,1,2090000
nn_kernel_gpu,181,1,1,16329,128,0,0,0,0,1,2090000
nn_kernel_gpu_mem,3571,1,1,16329,128,16720000,8360000,8360000,16720000,1,2090000
nn_kernel_cpu,26491,0,1,1,64,0,0,0,0,1,20910000
nn_kernel_gpu,1251,1,1,163360,128,0,0,0,0,1,20910000
nn_kernel_gpu_mem,35141,1,1,163360,128,167280000,83640000,83640000,167280000,1,20910000
nn_kernel_cpu,22228,0,1,1,64,0,0,0,0,1,20920000
nn_kernel_gpu,1249,1,1,163438,128,0,0,0,0,1,20920000
nn_kernel_gpu_mem,25655,1,1,163438,128,167360000,83680000,83680000,167360000,1,20920000
nn_kernel_cpu,15763,0,1,1,64,0,0,0,0,1,20930000
nn_kernel_gpu,1260,1,1,163516,128,0,0,0,0,1,20930000
nn_kernel_gpu_mem,34562,1,1,163516,128,167440000,83720000,83720000,167440000,1,20930000
nn_kernel_cpu,22486,0,1,1,64,0,0,0,0,1,20940000
nn_kernel_gpu,1258,1,1,163594,128,0,0,0,0,1,20940000
nn_kernel_gpu_mem,30962,1,1,163594,128,167520000,83760000,83760000,167520000,1,20940000
nn_kernel_cpu,16316,0,1,1,64,0,0,0,0,1,20950000
nn_kernel_gpu,1261,1,1,163672,128,0,0,0,0,1,20950000
nn_kernel_gpu_mem,26258,1,1,163672,128,167600000,83800000,83800000,167600000,1,20950000
nn_kernel_cpu,14859,0,1,1,64,0,0,0,0,1,20960000
nn_kernel_gpu,1264,1,1,163750,128,0,0,0,0,1,20960000
nn_kernel_gpu_mem,34826,1,1,163750,128,167680000,83840000,83840000,167680000,1,20960000
nn_kernel_cpu,25518,0,1,1,64,0,0,0,0,1,20970000
nn_kernel_gpu,1255,1,1,163829,128,0,0,0,0,1,20970000
nn_kernel_gpu_mem,35522,1,1,163829,128,167760000,83880000,83880000,167760000,1,20970000
nn_kernel_cpu,14496,0,1,1,64,0,0,0,0,1,20980000
nn_kernel_gpu,1268,1,1,163907,128,0,0,0,0,1,20980000
nn_kernel_gpu_mem,35161,1,1,163907,128,167840000,83920000,83920000,167840000,1,20980000
nn_kernel_cpu,27089,0,1,1,64,0,0,0,0,1,20990000
nn_kernel_gpu,1260,1,1,163985,128,0,0,0,0,1,20990000
nn_kernel_gpu_mem,28528,1,1,163985,128,167920000,83960000,83960000,167920000,1,20990000
nn_kernel_cpu,25264,0,1,1,64,0,0,0,0,1,21000000
nn_kernel_gpu,1260,1,1,164063,128,0,0,0,0,1,21000000
nn_kernel_gpu_mem,38751,1,1,164063,128,168000000,84000000,84000000,168000000,1,21000000
nn_kernel_cpu,16120,0,1,1,64,0,0,0,0,1,2100000
nn_kernel_gpu,185,1,1,16407,128,0,0,0,0,1,2100000
nn_kernel_gpu_mem,3377,1,1,16407,128,16800000,8400000,8400000,16800000,1,2100000
nn_kernel_cpu,23622,0,1,1,64,0,0,0,0,1,210000
nn_kernel_gpu,42,1,1,1641,128,0,0,0,0,1,210000
nn_kernel_gpu_mem,492,1,1,1641,128,1680000,840000,840000,1680000,1,210000
nn_kernel_cpu,22561,0,1,1,64,0,0,0,0,1,21010000
nn_kernel_gpu,1258,1,1,164141,128,0,0,0,0,1,21010000
nn_kernel_gpu_mem,29931,1,1,164141,128,168080000,84040000,84040000,168080000,1,21010000
nn_kernel_cpu,22048,0,1,1,64,0,0,0,0,1,21020000
nn_kernel_gpu,1275,1,1,164219,128,0,0,0,0,1,21020000
nn_kernel_gpu_mem,35049,1,1,164219,128,168160000,84080000,84080000,168160000,1,21020000
nn_kernel_cpu,16760,0,1,1,64,0,0,0,0,1,21030000
nn_kernel_gpu,1264,1,1,164297,128,0,0,0,0,1,21030000
nn_kernel_gpu_mem,28026,1,1,164297,128,168240000,84120000,84120000,168240000,1,21030000
nn_kernel_cpu,17601,0,1,1,64,0,0,0,0,1,21040000
nn_kernel_gpu,1267,1,1,164375,128,0,0,0,0,1,21040000
nn_kernel_gpu_mem,27578,1,1,164375,128,168320000,84160000,84160000,168320000,1,21040000
nn_kernel_cpu,8376,0,1,1,64,0,0,0,0,1,21050000
nn_kernel_gpu,1271,1,1,164454,128,0,0,0,0,1,21050000
nn_kernel_gpu_mem,34741,1,1,164454,128,168400000,84200000,84200000,168400000,1,21050000
nn_kernel_cpu,10363,0,1,1,64,0,0,0,0,1,21060000
nn_kernel_gpu,1302,1,1,164532,128,0,0,0,0,1,21060000
nn_kernel_gpu_mem,31706,1,1,164532,128,168480000,84240000,84240000,168480000,1,21060000
nn_kernel_cpu,16139,0,1,1,64,0,0,0,0,1,21070000
nn_kernel_gpu,1282,1,1,164610,128,0,0,0,0,1,21070000
nn_kernel_gpu_mem,33096,1,1,164610,128,168560000,84280000,84280000,168560000,1,21070000
nn_kernel_cpu,8806,0,1,1,64,0,0,0,0,1,21080000
nn_kernel_gpu,1278,1,1,164688,128,0,0,0,0,1,21080000
nn_kernel_gpu_mem,34239,1,1,164688,128,168640000,84320000,84320000,168640000,1,21080000
nn_kernel_cpu,20757,0,1,1,64,0,0,0,0,1,21090000
nn_kernel_gpu,1307,1,1,164766,128,0,0,0,0,1,21090000
nn_kernel_gpu_mem,34019,1,1,164766,128,168720000,84360000,84360000,168720000,1,21090000
nn_kernel_cpu,21569,0,1,1,64,0,0,0,0,1,21100000
nn_kernel_gpu,1269,1,1,164844,128,0,0,0,0,1,21100000
nn_kernel_gpu_mem,35982,1,1,164844,128,168800000,84400000,84400000,168800000,1,21100000
nn_kernel_cpu,3166,0,1,1,64,0,0,0,0,1,2110000
nn_kernel_gpu,169,1,1,16485,128,0,0,0,0,1,2110000
nn_kernel_gpu_mem,3568,1,1,16485,128,16880000,8440000,8440000,16880000,1,2110000
nn_kernel_cpu,25297,0,1,1,64,0,0,0,0,1,21110000
nn_kernel_gpu,1276,1,1,164922,128,0,0,0,0,1,21110000
nn_kernel_gpu_mem,27862,1,1,164922,128,168880000,84440000,84440000,168880000,1,21110000
nn_kernel_cpu,35216,0,1,1,64,0,0,0,0,1,21120000
nn_kernel_gpu,1291,1,1,165000,128,0,0,0,0,1,21120000
nn_kernel_gpu_mem,38978,1,1,165000,128,168960000,84480000,84480000,168960000,1,21120000
nn_kernel_cpu,17048,0,1,1,64,0,0,0,0,1,21130000
nn_kernel_gpu,1275,1,1,165079,128,0,0,0,0,1,21130000
nn_kernel_gpu_mem,29506,1,1,165079,128,169040000,84520000,84520000,169040000,1,21130000
nn_kernel_cpu,14021,0,1,1,64,0,0,0,0,1,21140000
nn_kernel_gpu,1281,1,1,165157,128,0,0,0,0,1,21140000
nn_kernel_gpu_mem,35620,1,1,165157,128,169120000,84560000,84560000,169120000,1,21140000
nn_kernel_cpu,6205,0,1,1,64,0,0,0,0,1,21150000
nn_kernel_gpu,1281,1,1,165235,128,0,0,0,0,1,21150000
nn_kernel_gpu_mem,34470,1,1,165235,128,169200000,84600000,84600000,169200000,1,21150000
nn_kernel_cpu,14727,0,1,1,64,0,0,0,0,1,21160000
nn_kernel_gpu,1305,1,1,165313,128,0,0,0,0,1,21160000
nn_kernel_gpu_mem,33948,1,1,165313,128,169280000,84640000,84640000,169280000,1,21160000
nn_kernel_cpu,27254,0,1,1,64,0,0,0,0,1,21170000
nn_kernel_gpu,1278,1,1,165391,128,0,0,0,0,1,21170000
nn_kernel_gpu_mem,34896,1,1,165391,128,169360000,84680000,84680000,169360000,1,21170000
nn_kernel_cpu,21642,0,1,1,64,0,0,0,0,1,21180000
nn_kernel_gpu,1279,1,1,165469,128,0,0,0,0,1,21180000
nn_kernel_gpu_mem,34719,1,1,165469,128,169440000,84720000,84720000,169440000,1,21180000
nn_kernel_cpu,15590,0,1,1,64,0,0,0,0,1,21190000
nn_kernel_gpu,1264,1,1,165547,128,0,0,0,0,1,21190000
nn_kernel_gpu_mem,26254,1,1,165547,128,169520000,84760000,84760000,169520000,1,21190000
nn_kernel_cpu,31417,0,1,1,64,0,0,0,0,1,21200000
nn_kernel_gpu,1278,1,1,165625,128,0,0,0,0,1,21200000
nn_kernel_gpu_mem,30853,1,1,165625,128,169600000,84800000,84800000,169600000,1,21200000
nn_kernel_cpu,8058,0,1,1,64,0,0,0,0,1,2120000
nn_kernel_gpu,183,1,1,16563,128,0,0,0,0,1,2120000
nn_kernel_gpu_mem,3212,1,1,16563,128,16960000,8480000,8480000,16960000,1,2120000
nn_kernel_cpu,12851,0,1,1,64,0,0,0,0,1,21210000
nn_kernel_gpu,1277,1,1,165704,128,0,0,0,0,1,21210000
nn_kernel_gpu_mem,29454,1,1,165704,128,169680000,84840000,84840000,169680000,1,21210000
nn_kernel_cpu,21264,0,1,1,64,0,0,0,0,1,21220000
nn_kernel_gpu,1280,1,1,165782,128,0,0,0,0,1,21220000
nn_kernel_gpu_mem,30380,1,1,165782,128,169760000,84880000,84880000,169760000,1,21220000
nn_kernel_cpu,15111,0,1,1,64,0,0,0,0,1,21230000
nn_kernel_gpu,1275,1,1,165860,128,0,0,0,0,1,21230000
nn_kernel_gpu_mem,32841,1,1,165860,128,169840000,84920000,84920000,169840000,1,21230000
nn_kernel_cpu,12228,0,1,1,64,0,0,0,0,1,21240000
nn_kernel_gpu,1280,1,1,165938,128,0,0,0,0,1,21240000
nn_kernel_gpu_mem,29061,1,1,165938,128,169920000,84960000,84960000,169920000,1,21240000
nn_kernel_cpu,16498,0,1,1,64,0,0,0,0,1,21250000
nn_kernel_gpu,1274,1,1,166016,128,0,0,0,0,1,21250000
nn_kernel_gpu_mem,35446,1,1,166016,128,170000000,85000000,85000000,170000000,1,21250000
nn_kernel_cpu,26418,0,1,1,64,0,0,0,0,1,21260000
nn_kernel_gpu,1288,1,1,166094,128,0,0,0,0,1,21260000
nn_kernel_gpu_mem,34956,1,1,166094,128,170080000,85040000,85040000,170080000,1,21260000
nn_kernel_cpu,22948,0,1,1,64,0,0,0,0,1,21270000
nn_kernel_gpu,1311,1,1,166172,128,0,0,0,0,1,21270000
nn_kernel_gpu_mem,34938,1,1,166172,128,170160000,85080000,85080000,170160000,1,21270000
nn_kernel_cpu,8452,0,1,1,64,0,0,0,0,1,21280000
nn_kernel_gpu,1295,1,1,166250,128,0,0,0,0,1,21280000
nn_kernel_gpu_mem,35734,1,1,166250,128,170240000,85120000,85120000,170240000,1,21280000
nn_kernel_cpu,12404,0,1,1,64,0,0,0,0,1,21290000
nn_kernel_gpu,1284,1,1,166329,128,0,0,0,0,1,21290000
nn_kernel_gpu_mem,32109,1,1,166329,128,170320000,85160000,85160000,170320000,1,21290000
nn_kernel_cpu,23320,0,1,1,64,0,0,0,0,1,21300000
nn_kernel_gpu,1286,1,1,166407,128,0,0,0,0,1,21300000
nn_kernel_gpu_mem,33987,1,1,166407,128,170400000,85200000,85200000,170400000,1,21300000
nn_kernel_cpu,5638,0,1,1,64,0,0,0,0,1,2130000
nn_kernel_gpu,183,1,1,16641,128,0,0,0,0,1,2130000
nn_kernel_gpu_mem,5719,1,1,16641,128,17040000,8520000,8520000,17040000,1,2130000
nn_kernel_cpu,16633,0,1,1,64,0,0,0,0,1,21310000
nn_kernel_gpu,1278,1,1,166485,128,0,0,0,0,1,21310000
nn_kernel_gpu_mem,30169,1,1,166485,128,170480000,85240000,85240000,170480000,1,21310000
nn_kernel_cpu,24264,0,1,1,64,0,0,0,0,1,21320000
nn_kernel_gpu,1288,1,1,166563,128,0,0,0,0,1,21320000
nn_kernel_gpu_mem,34668,1,1,166563,128,170560000,85280000,85280000,170560000,1,21320000
nn_kernel_cpu,11398,0,1,1,64,0,0,0,0,1,21330000
nn_kernel_gpu,1273,1,1,166641,128,0,0,0,0,1,21330000
nn_kernel_gpu_mem,27321,1,1,166641,128,170640000,85320000,85320000,170640000,1,21330000
nn_kernel_cpu,19432,0,1,1,64,0,0,0,0,1,21340000
nn_kernel_gpu,1289,1,1,166719,128,0,0,0,0,1,21340000
nn_kernel_gpu_mem,34819,1,1,166719,128,170720000,85360000,85360000,170720000,1,21340000
nn_kernel_cpu,18306,0,1,1,64,0,0,0,0,1,21350000
nn_kernel_gpu,1285,1,1,166797,128,0,0,0,0,1,21350000
nn_kernel_gpu_mem,29598,1,1,166797,128,170800000,85400000,85400000,170800000,1,21350000
nn_kernel_cpu,24218,0,1,1,64,0,0,0,0,1,21360000
nn_kernel_gpu,1289,1,1,166875,128,0,0,0,0,1,21360000
nn_kernel_gpu_mem,35327,1,1,166875,128,170880000,85440000,85440000,170880000,1,21360000
nn_kernel_cpu,13576,0,1,1,64,0,0,0,0,1,21370000
nn_kernel_gpu,1325,1,1,166954,128,0,0,0,0,1,21370000
nn_kernel_gpu_mem,34699,1,1,166954,128,170960000,85480000,85480000,170960000,1,21370000
nn_kernel_cpu,9720,0,1,1,64,0,0,0,0,1,21380000
nn_kernel_gpu,1273,1,1,167032,128,0,0,0,0,1,21380000
nn_kernel_gpu_mem,37201,1,1,167032,128,171040000,85520000,85520000,171040000,1,21380000
nn_kernel_cpu,36515,0,1,1,64,0,0,0,0,1,21390000
nn_kernel_gpu,1291,1,1,167110,128,0,0,0,0,1,21390000
nn_kernel_gpu_mem,35009,1,1,167110,128,171120000,85560000,85560000,171120000,1,21390000
nn_kernel_cpu,26030,0,1,1,64,0,0,0,0,1,21400000
nn_kernel_gpu,1297,1,1,167188,128,0,0,0,0,1,21400000
nn_kernel_gpu_mem,32708,1,1,167188,128,171200000,85600000,85600000,171200000,1,21400000
nn_kernel_cpu,61143,0,1,1,64,0,0,0,0,1,2140000
nn_kernel_gpu,182,1,1,16719,128,0,0,0,0,1,2140000
nn_kernel_gpu_mem,3461,1,1,16719,128,17120000,8560000,8560000,17120000,1,2140000
nn_kernel_cpu,23940,0,1,1,64,0,0,0,0,1,21410000
nn_kernel_gpu,1287,1,1,167266,128,0,0,0,0,1,21410000
nn_kernel_gpu_mem,35447,1,1,167266,128,171280000,85640000,85640000,171280000,1,21410000
nn_kernel_cpu,22675,0,1,1,64,0,0,0,0,1,21420000
nn_kernel_gpu,1292,1,1,167344,128,0,0,0,0,1,21420000
nn_kernel_gpu_mem,31316,1,1,167344,128,171360000,85680000,85680000,171360000,1,21420000
nn_kernel_cpu,25133,0,1,1,64,0,0,0,0,1,21430000
nn_kernel_gpu,1325,1,1,167422,128,0,0,0,0,1,21430000
nn_kernel_gpu_mem,34770,1,1,167422,128,171440000,85720000,85720000,171440000,1,21430000
nn_kernel_cpu,8379,0,1,1,64,0,0,0,0,1,21440000
nn_kernel_gpu,1298,1,1,167500,128,0,0,0,0,1,21440000
nn_kernel_gpu_mem,33809,1,1,167500,128,171520000,85760000,85760000,171520000,1,21440000
nn_kernel_cpu,29580,0,1,1,64,0,0,0,0,1,21450000
nn_kernel_gpu,1289,1,1,167579,128,0,0,0,0,1,21450000
nn_kernel_gpu_mem,37731,1,1,167579,128,171600000,85800000,85800000,171600000,1,21450000
nn_kernel_cpu,12553,0,1,1,64,0,0,0,0,1,21460000
nn_kernel_gpu,1291,1,1,167657,128,0,0,0,0,1,21460000
nn_kernel_gpu_mem,32008,1,1,167657,128,171680000,85840000,85840000,171680000,1,21460000
nn_kernel_cpu,17977,0,1,1,64,0,0,0,0,1,21470000
nn_kernel_gpu,1292,1,1,167735,128,0,0,0,0,1,21470000
nn_kernel_gpu_mem,34504,1,1,167735,128,171760000,85880000,85880000,171760000,1,21470000
nn_kernel_cpu,12504,0,1,1,64,0,0,0,0,1,21480000
nn_kernel_gpu,1300,1,1,167813,128,0,0,0,0,1,21480000
nn_kernel_gpu_mem,35175,1,1,167813,128,171840000,85920000,85920000,171840000,1,21480000
nn_kernel_cpu,21226,0,1,1,64,0,0,0,0,1,21490000
nn_kernel_gpu,1324,1,1,167891,128,0,0,0,0,1,21490000
nn_kernel_gpu_mem,36147,1,1,167891,128,171920000,85960000,85960000,171920000,1,21490000
nn_kernel_cpu,38136,0,1,1,64,0,0,0,0,1,21500000
nn_kernel_gpu,1299,1,1,167969,128,0,0,0,0,1,21500000
nn_kernel_gpu_mem,35638,1,1,167969,128,172000000,86000000,86000000,172000000,1,21500000
nn_kernel_cpu,4369,0,1,1,64,0,0,0,0,1,2150000
nn_kernel_gpu,199,1,1,16797,128,0,0,0,0,1,2150000
nn_kernel_gpu_mem,8152,1,1,16797,128,17200000,8600000,8600000,17200000,1,2150000
nn_kernel_cpu,19834,0,1,1,64,0,0,0,0,1,21510000
nn_kernel_gpu,1295,1,1,168047,128,0,0,0,0,1,21510000
nn_kernel_gpu_mem,30755,1,1,168047,128,172080000,86040000,86040000,172080000,1,21510000
nn_kernel_cpu,13145,0,1,1,64,0,0,0,0,1,21520000
nn_kernel_gpu,1281,1,1,168125,128,0,0,0,0,1,21520000
nn_kernel_gpu_mem,31713,1,1,168125,128,172160000,86080000,86080000,172160000,1,21520000
nn_kernel_cpu,39228,0,1,1,64,0,0,0,0,1,21530000
nn_kernel_gpu,1294,1,1,168204,128,0,0,0,0,1,21530000
nn_kernel_gpu_mem,35879,1,1,168204,128,172240000,86120000,86120000,172240000,1,21530000
nn_kernel_cpu,12620,0,1,1,64,0,0,0,0,1,21540000
nn_kernel_gpu,1281,1,1,168282,128,0,0,0,0,1,21540000
nn_kernel_gpu_mem,30370,1,1,168282,128,172320000,86160000,86160000,172320000,1,21540000
nn_kernel_cpu,11719,0,1,1,64,0,0,0,0,1,21550000
nn_kernel_gpu,1291,1,1,168360,128,0,0,0,0,1,21550000
nn_kernel_gpu_mem,30216,1,1,168360,128,172400000,86200000,86200000,172400000,1,21550000
nn_kernel_cpu,11301,0,1,1,64,0,0,0,0,1,21560000
nn_kernel_gpu,1291,1,1,168438,128,0,0,0,0,1,21560000
nn_kernel_gpu_mem,32624,1,1,168438,128,172480000,86240000,86240000,172480000,1,21560000
nn_kernel_cpu,31962,0,1,1,64,0,0,0,0,1,21570000
nn_kernel_gpu,1302,1,1,168516,128,0,0,0,0,1,21570000
nn_kernel_gpu_mem,35367,1,1,168516,128,172560000,86280000,86280000,172560000,1,21570000
nn_kernel_cpu,16218,0,1,1,64,0,0,0,0,1,21580000
nn_kernel_gpu,1301,1,1,168594,128,0,0,0,0,1,21580000
nn_kernel_gpu_mem,28917,1,1,168594,128,172640000,86320000,86320000,172640000,1,21580000
nn_kernel_cpu,9925,0,1,1,64,0,0,0,0,1,21590000
nn_kernel_gpu,1298,1,1,168672,128,0,0,0,0,1,21590000
nn_kernel_gpu_mem,28914,1,1,168672,128,172720000,86360000,86360000,172720000,1,21590000
nn_kernel_cpu,21954,0,1,1,64,0,0,0,0,1,21600000
nn_kernel_gpu,1307,1,1,168750,128,0,0,0,0,1,21600000
nn_kernel_gpu_mem,34554,1,1,168750,128,172800000,86400000,86400000,172800000,1,21600000
nn_kernel_cpu,23973,0,1,1,64,0,0,0,0,1,2160000
nn_kernel_gpu,185,1,1,16875,128,0,0,0,0,1,2160000
nn_kernel_gpu_mem,10258,1,1,16875,128,17280000,8640000,8640000,17280000,1,2160000
nn_kernel_cpu,20569,0,1,1,64,0,0,0,0,1,21610000
nn_kernel_gpu,1306,1,1,168829,128,0,0,0,0,1,21610000
nn_kernel_gpu_mem,28756,1,1,168829,128,172880000,86440000,86440000,172880000,1,21610000
nn_kernel_cpu,9628,0,1,1,64,0,0,0,0,1,21620000
nn_kernel_gpu,1291,1,1,168907,128,0,0,0,0,1,21620000
nn_kernel_gpu_mem,29754,1,1,168907,128,172960000,86480000,86480000,172960000,1,21620000
nn_kernel_cpu,27498,0,1,1,64,0,0,0,0,1,21630000
nn_kernel_gpu,1302,1,1,168985,128,0,0,0,0,1,21630000
nn_kernel_gpu_mem,36459,1,1,168985,128,173040000,86520000,86520000,173040000,1,21630000
nn_kernel_cpu,16335,0,1,1,64,0,0,0,0,1,21640000
nn_kernel_gpu,1306,1,1,169063,128,0,0,0,0,1,21640000
nn_kernel_gpu_mem,35000,1,1,169063,128,173120000,86560000,86560000,173120000,1,21640000
nn_kernel_cpu,10163,0,1,1,64,0,0,0,0,1,21650000
nn_kernel_gpu,1296,1,1,169141,128,0,0,0,0,1,21650000
nn_kernel_gpu_mem,31663,1,1,169141,128,173200000,86600000,86600000,173200000,1,21650000
nn_kernel_cpu,24485,0,1,1,64,0,0,0,0,1,21660000
nn_kernel_gpu,1299,1,1,169219,128,0,0,0,0,1,21660000
nn_kernel_gpu_mem,32954,1,1,169219,128,173280000,86640000,86640000,173280000,1,21660000
nn_kernel_cpu,24686,0,1,1,64,0,0,0,0,1,21670000
nn_kernel_gpu,1300,1,1,169297,128,0,0,0,0,1,21670000
nn_kernel_gpu_mem,29946,1,1,169297,128,173360000,86680000,86680000,173360000,1,21670000
nn_kernel_cpu,65318,0,1,1,64,0,0,0,0,1,21680000
nn_kernel_gpu,1312,1,1,169375,128,0,0,0,0,1,21680000
nn_kernel_gpu_mem,32293,1,1,169375,128,173440000,86720000,86720000,173440000,1,21680000
nn_kernel_cpu,6193,0,1,1,64,0,0,0,0,1,21690000
nn_kernel_gpu,1299,1,1,169454,128,0,0,0,0,1,21690000
nn_kernel_gpu_mem,31255,1,1,169454,128,173520000,86760000,86760000,173520000,1,21690000
nn_kernel_cpu,8773,0,1,1,64,0,0,0,0,1,21700000
nn_kernel_gpu,1318,1,1,169532,128,0,0,0,0,1,21700000
nn_kernel_gpu_mem,40608,1,1,169532,128,173600000,86800000,86800000,173600000,1,21700000
nn_kernel_cpu,23441,0,1,1,64,0,0,0,0,1,2170000
nn_kernel_gpu,185,1,1,16954,128,0,0,0,0,1,2170000
nn_kernel_gpu_mem,3004,1,1,16954,128,17360000,8680000,8680000,17360000,1,2170000
nn_kernel_cpu,26549,0,1,1,64,0,0,0,0,1,21710000
nn_kernel_gpu,1297,1,1,169610,128,0,0,0,0,1,21710000
nn_kernel_gpu_mem,33733,1,1,169610,128,173680000,86840000,86840000,173680000,1,21710000
nn_kernel_cpu,15694,0,1,1,64,0,0,0,0,1,21720000
nn_kernel_gpu,1334,1,1,169688,128,0,0,0,0,1,21720000
nn_kernel_gpu_mem,30968,1,1,169688,128,173760000,86880000,86880000,173760000,1,21720000
nn_kernel_cpu,25507,0,1,1,64,0,0,0,0,1,21730000
nn_kernel_gpu,1314,1,1,169766,128,0,0,0,0,1,21730000
nn_kernel_gpu_mem,33202,1,1,169766,128,173840000,86920000,86920000,173840000,1,21730000
nn_kernel_cpu,21949,0,1,1,64,0,0,0,0,1,21740000
nn_kernel_gpu,1330,1,1,169844,128,0,0,0,0,1,21740000
nn_kernel_gpu_mem,31722,1,1,169844,128,173920000,86960000,86960000,173920000,1,21740000
nn_kernel_cpu,24577,0,1,1,64,0,0,0,0,1,21750000
nn_kernel_gpu,1295,1,1,169922,128,0,0,0,0,1,21750000
nn_kernel_gpu_mem,30468,1,1,169922,128,174000000,87000000,87000000,174000000,1,21750000
nn_kernel_cpu,29128,0,1,1,64,0,0,0,0,1,21760000
nn_kernel_gpu,1302,1,1,170000,128,0,0,0,0,1,21760000
nn_kernel_gpu_mem,26618,1,1,170000,128,174080000,87040000,87040000,174080000,1,21760000
nn_kernel_cpu,35375,0,1,1,64,0,0,0,0,1,21770000
nn_kernel_gpu,1306,1,1,170079,128,0,0,0,0,1,21770000
nn_kernel_gpu_mem,30594,1,1,170079,128,174160000,87080000,87080000,174160000,1,21770000
nn_kernel_cpu,16265,0,1,1,64,0,0,0,0,1,21780000
nn_kernel_gpu,1305,1,1,170157,128,0,0,0,0,1,21780000
nn_kernel_gpu_mem,31600,1,1,170157,128,174240000,87120000,87120000,174240000,1,21780000
nn_kernel_cpu,21036,0,1,1,64,0,0,0,0,1,21790000
nn_kernel_gpu,1299,1,1,170235,128,0,0,0,0,1,21790000
nn_kernel_gpu_mem,42856,1,1,170235,128,174320000,87160000,87160000,174320000,1,21790000
nn_kernel_cpu,15503,0,1,1,64,0,0,0,0,1,21800000
nn_kernel_gpu,1312,1,1,170313,128,0,0,0,0,1,21800000
nn_kernel_gpu_mem,35094,1,1,170313,128,174400000,87200000,87200000,174400000,1,21800000
nn_kernel_cpu,4573,0,1,1,64,0,0,0,0,1,2180000
nn_kernel_gpu,209,1,1,17032,128,0,0,0,0,1,2180000
nn_kernel_gpu_mem,9270,1,1,17032,128,17440000,8720000,8720000,17440000,1,2180000
nn_kernel_cpu,10916,0,1,1,64,0,0,0,0,1,21810000
nn_kernel_gpu,1313,1,1,170391,128,0,0,0,0,1,21810000
nn_kernel_gpu_mem,31822,1,1,170391,128,174480000,87240000,87240000,174480000,1,21810000
nn_kernel_cpu,11640,0,1,1,64,0,0,0,0,1,21820000
nn_kernel_gpu,1307,1,1,170469,128,0,0,0,0,1,21820000
nn_kernel_gpu_mem,30670,1,1,170469,128,174560000,87280000,87280000,174560000,1,21820000
nn_kernel_cpu,9507,0,1,1,64,0,0,0,0,1,21830000
nn_kernel_gpu,1327,1,1,170547,128,0,0,0,0,1,21830000
nn_kernel_gpu_mem,30272,1,1,170547,128,174640000,87320000,87320000,174640000,1,21830000
nn_kernel_cpu,20762,0,1,1,64,0,0,0,0,1,21840000
nn_kernel_gpu,1316,1,1,170625,128,0,0,0,0,1,21840000
nn_kernel_gpu_mem,33640,1,1,170625,128,174720000,87360000,87360000,174720000,1,21840000
nn_kernel_cpu,16554,0,1,1,64,0,0,0,0,1,21850000
nn_kernel_gpu,1315,1,1,170704,128,0,0,0,0,1,21850000
nn_kernel_gpu_mem,40435,1,1,170704,128,174800000,87400000,87400000,174800000,1,21850000
nn_kernel_cpu,28042,0,1,1,64,0,0,0,0,1,21860000
nn_kernel_gpu,1316,1,1,170782,128,0,0,0,0,1,21860000
nn_kernel_gpu_mem,35966,1,1,170782,128,174880000,87440000,87440000,174880000,1,21860000
nn_kernel_cpu,49534,0,1,1,64,0,0,0,0,1,21870000
nn_kernel_gpu,1305,1,1,170860,128,0,0,0,0,1,21870000
nn_kernel_gpu_mem,35911,1,1,170860,128,174960000,87480000,87480000,174960000,1,21870000
nn_kernel_cpu,15574,0,1,1,64,0,0,0,0,1,21880000
nn_kernel_gpu,1318,1,1,170938,128,0,0,0,0,1,21880000
nn_kernel_gpu_mem,36470,1,1,170938,128,175040000,87520000,87520000,175040000,1,21880000
nn_kernel_cpu,20983,0,1,1,64,0,0,0,0,1,21890000
nn_kernel_gpu,1313,1,1,171016,128,0,0,0,0,1,21890000
nn_kernel_gpu_mem,31440,1,1,171016,128,175120000,87560000,87560000,175120000,1,21890000
nn_kernel_cpu,23839,0,1,1,64,0,0,0,0,1,21900000
nn_kernel_gpu,1319,1,1,171094,128,0,0,0,0,1,21900000
nn_kernel_gpu_mem,34536,1,1,171094,128,175200000,87600000,87600000,175200000,1,21900000
nn_kernel_cpu,14038,0,1,1,64,0,0,0,0,1,2190000
nn_kernel_gpu,178,1,1,17110,128,0,0,0,0,1,2190000
nn_kernel_gpu_mem,3557,1,1,17110,128,17520000,8760000,8760000,17520000,1,2190000
nn_kernel_cpu,15457,0,1,1,64,0,0,0,0,1,21910000
nn_kernel_gpu,1297,1,1,171172,128,0,0,0,0,1,21910000
nn_kernel_gpu_mem,30300,1,1,171172,128,175280000,87640000,87640000,175280000,1,21910000
nn_kernel_cpu,13966,0,1,1,64,0,0,0,0,1,21920000
nn_kernel_gpu,1347,1,1,171250,128,0,0,0,0,1,21920000
nn_kernel_gpu_mem,35318,1,1,171250,128,175360000,87680000,87680000,175360000,1,21920000
nn_kernel_cpu,11311,0,1,1,64,0,0,0,0,1,21930000
nn_kernel_gpu,1317,1,1,171329,128,0,0,0,0,1,21930000
nn_kernel_gpu_mem,31286,1,1,171329,128,175440000,87720000,87720000,175440000,1,21930000
nn_kernel_cpu,20557,0,1,1,64,0,0,0,0,1,21940000
nn_kernel_gpu,1318,1,1,171407,128,0,0,0,0,1,21940000
nn_kernel_gpu_mem,33928,1,1,171407,128,175520000,87760000,87760000,175520000,1,21940000
nn_kernel_cpu,12539,0,1,1,64,0,0,0,0,1,21950000
nn_kernel_gpu,1313,1,1,171485,128,0,0,0,0,1,21950000
nn_kernel_gpu_mem,35043,1,1,171485,128,175600000,87800000,87800000,175600000,1,21950000
nn_kernel_cpu,27471,0,1,1,64,0,0,0,0,1,21960000
nn_kernel_gpu,1312,1,1,171563,128,0,0,0,0,1,21960000
nn_kernel_gpu_mem,34181,1,1,171563,128,175680000,87840000,87840000,175680000,1,21960000
nn_kernel_cpu,23743,0,1,1,64,0,0,0,0,1,21970000
nn_kernel_gpu,1313,1,1,171641,128,0,0,0,0,1,21970000
nn_kernel_gpu_mem,38630,1,1,171641,128,175760000,87880000,87880000,175760000,1,21970000
nn_kernel_cpu,18146,0,1,1,64,0,0,0,0,1,21980000
nn_kernel_gpu,1318,1,1,171719,128,0,0,0,0,1,21980000
nn_kernel_gpu_mem,34805,1,1,171719,128,175840000,87920000,87920000,175840000,1,21980000
nn_kernel_cpu,28126,0,1,1,64,0,0,0,0,1,21990000
nn_kernel_gpu,1314,1,1,171797,128,0,0,0,0,1,21990000
nn_kernel_gpu_mem,35176,1,1,171797,128,175920000,87960000,87960000,175920000,1,21990000
nn_kernel_cpu,25733,0,1,1,64,0,0,0,0,1,22000000
nn_kernel_gpu,1326,1,1,171875,128,0,0,0,0,1,22000000
nn_kernel_gpu_mem,34798,1,1,171875,128,176000000,88000000,88000000,176000000,1,22000000
nn_kernel_cpu,23181,0,1,1,64,0,0,0,0,1,2200000
nn_kernel_gpu,189,1,1,17188,128,0,0,0,0,1,2200000
nn_kernel_gpu_mem,3640,1,1,17188,128,17600000,8800000,8800000,17600000,1,2200000
nn_kernel_cpu,1226,0,1,1,64,0,0,0,0,1,220000
nn_kernel_gpu,55,1,1,1719,128,0,0,0,0,1,220000
nn_kernel_gpu_mem,773,1,1,1719,128,1760000,880000,880000,1760000,1,220000
nn_kernel_cpu,15345,0,1,1,64,0,0,0,0,1,22010000
nn_kernel_gpu,1321,1,1,171954,128,0,0,0,0,1,22010000
nn_kernel_gpu_mem,38914,1,1,171954,128,176080000,88040000,88040000,176080000,1,22010000
nn_kernel_cpu,5737,0,1,1,64,0,0,0,0,1,22020000
nn_kernel_gpu,1322,1,1,172032,128,0,0,0,0,1,22020000
nn_kernel_gpu_mem,34885,1,1,172032,128,176160000,88080000,88080000,176160000,1,22020000
nn_kernel_cpu,20455,0,1,1,64,0,0,0,0,1,22030000
nn_kernel_gpu,1330,1,1,172110,128,0,0,0,0,1,22030000
nn_kernel_gpu_mem,41479,1,1,172110,128,176240000,88120000,88120000,176240000,1,22030000
nn_kernel_cpu,9356,0,1,1,64,0,0,0,0,1,22040000
nn_kernel_gpu,1355,1,1,172188,128,0,0,0,0,1,22040000
nn_kernel_gpu_mem,38121,1,1,172188,128,176320000,88160000,88160000,176320000,1,22040000
nn_kernel_cpu,17538,0,1,1,64,0,0,0,0,1,22050000
nn_kernel_gpu,1360,1,1,172266,128,0,0,0,0,1,22050000
nn_kernel_gpu_mem,38340,1,1,172266,128,176400000,88200000,88200000,176400000,1,22050000
nn_kernel_cpu,10585,0,1,1,64,0,0,0,0,1,22060000
nn_kernel_gpu,1324,1,1,172344,128,0,0,0,0,1,22060000
nn_kernel_gpu_mem,28808,1,1,172344,128,176480000,88240000,88240000,176480000,1,22060000
nn_kernel_cpu,16634,0,1,1,64,0,0,0,0,1,22070000
nn_kernel_gpu,1337,1,1,172422,128,0,0,0,0,1,22070000
nn_kernel_gpu_mem,35175,1,1,172422,128,176560000,88280000,88280000,176560000,1,22070000
nn_kernel_cpu,20529,0,1,1,64,0,0,0,0,1,22080000
nn_kernel_gpu,1322,1,1,172500,128,0,0,0,0,1,22080000
nn_kernel_gpu_mem,32037,1,1,172500,128,176640000,88320000,88320000,176640000,1,22080000
nn_kernel_cpu,22928,0,1,1,64,0,0,0,0,1,22090000
nn_kernel_gpu,1338,1,1,172579,128,0,0,0,0,1,22090000
nn_kernel_gpu_mem,40421,1,1,172579,128,176720000,88360000,88360000,176720000,1,22090000
nn_kernel_cpu,8859,0,1,1,64,0,0,0,0,1,22100000
nn_kernel_gpu,1316,1,1,172657,128,0,0,0,0,1,22100000
nn_kernel_gpu_mem,36168,1,1,172657,128,176800000,88400000,88400000,176800000,1,22100000
nn_kernel_cpu,11369,0,1,1,64,0,0,0,0,1,2210000
nn_kernel_gpu,169,1,1,17266,128,0,0,0,0,1,2210000
nn_kernel_gpu_mem,7932,1,1,17266,128,17680000,8840000,8840000,17680000,1,2210000
nn_kernel_cpu,23309,0,1,1,64,0,0,0,0,1,22110000
nn_kernel_gpu,1343,1,1,172735,128,0,0,0,0,1,22110000
nn_kernel_gpu_mem,36539,1,1,172735,128,176880000,88440000,88440000,176880000,1,22110000
nn_kernel_cpu,19137,0,1,1,64,0,0,0,0,1,22120000
nn_kernel_gpu,1330,1,1,172813,128,0,0,0,0,1,22120000
nn_kernel_gpu_mem,32511,1,1,172813,128,176960000,88480000,88480000,176960000,1,22120000
nn_kernel_cpu,32104,0,1,1,64,0,0,0,0,1,22130000
nn_kernel_gpu,1327,1,1,172891,128,0,0,0,0,1,22130000
nn_kernel_gpu_mem,32664,1,1,172891,128,177040000,88520000,88520000,177040000,1,22130000
nn_kernel_cpu,10985,0,1,1,64,0,0,0,0,1,22140000
nn_kernel_gpu,1337,1,1,172969,128,0,0,0,0,1,22140000
nn_kernel_gpu_mem,30598,1,1,172969,128,177120000,88560000,88560000,177120000,1,22140000
nn_kernel_cpu,24556,0,1,1,64,0,0,0,0,1,22150000
nn_kernel_gpu,1344,1,1,173047,128,0,0,0,0,1,22150000
nn_kernel_gpu_mem,37666,1,1,173047,128,177200000,88600000,88600000,177200000,1,22150000
nn_kernel_cpu,25452,0,1,1,64,0,0,0,0,1,22160000
nn_kernel_gpu,1341,1,1,173125,128,0,0,0,0,1,22160000
nn_kernel_gpu_mem,35221,1,1,173125,128,177280000,88640000,88640000,177280000,1,22160000
nn_kernel_cpu,19898,0,1,1,64,0,0,0,0,1,22170000
nn_kernel_gpu,1321,1,1,173204,128,0,0,0,0,1,22170000
nn_kernel_gpu_mem,38712,1,1,173204,128,177360000,88680000,88680000,177360000,1,22170000
nn_kernel_cpu,26937,0,1,1,64,0,0,0,0,1,22180000
nn_kernel_gpu,1331,1,1,173282,128,0,0,0,0,1,22180000
nn_kernel_gpu_mem,39778,1,1,173282,128,177440000,88720000,88720000,177440000,1,22180000
nn_kernel_cpu,27233,0,1,1,64,0,0,0,0,1,22190000
nn_kernel_gpu,1332,1,1,173360,128,0,0,0,0,1,22190000
nn_kernel_gpu_mem,31286,1,1,173360,128,177520000,88760000,88760000,177520000,1,22190000
nn_kernel_cpu,23290,0,1,1,64,0,0,0,0,1,22200000
nn_kernel_gpu,1335,1,1,173438,128,0,0,0,0,1,22200000
nn_kernel_gpu_mem,36087,1,1,173438,128,177600000,88800000,88800000,177600000,1,22200000
nn_kernel_cpu,28643,0,1,1,64,0,0,0,0,1,2220000
nn_kernel_gpu,190,1,1,17344,128,0,0,0,0,1,2220000
nn_kernel_gpu_mem,3367,1,1,17344,128,17760000,8880000,8880000,17760000,1,2220000
nn_kernel_cpu,5692,0,1,1,64,0,0,0,0,1,22210000
nn_kernel_gpu,1337,1,1,173516,128,0,0,0,0,1,22210000
nn_kernel_gpu_mem,34148,1,1,173516,128,177680000,88840000,88840000,177680000,1,22210000
nn_kernel_cpu,14016,0,1,1,64,0,0,0,0,1,22220000
nn_kernel_gpu,1339,1,1,173594,128,0,0,0,0,1,22220000
nn_kernel_gpu_mem,33076,1,1,173594,128,177760000,88880000,88880000,177760000,1,22220000
nn_kernel_cpu,33751,0,1,1,64,0,0,0,0,1,22230000
nn_kernel_gpu,1333,1,1,173672,128,0,0,0,0,1,22230000
nn_kernel_gpu_mem,38082,1,1,173672,128,177840000,88920000,88920000,177840000,1,22230000
nn_kernel_cpu,12548,0,1,1,64,0,0,0,0,1,22240000
nn_kernel_gpu,1334,1,1,173750,128,0,0,0,0,1,22240000
nn_kernel_gpu_mem,46151,1,1,173750,128,177920000,88960000,88960000,177920000,1,22240000
nn_kernel_cpu,16771,0,1,1,64,0,0,0,0,1,22250000
nn_kernel_gpu,1339,1,1,173829,128,0,0,0,0,1,22250000
nn_kernel_gpu_mem,40472,1,1,173829,128,178000000,89000000,89000000,178000000,1,22250000
nn_kernel_cpu,22899,0,1,1,64,0,0,0,0,1,22260000
nn_kernel_gpu,1334,1,1,173907,128,0,0,0,0,1,22260000
nn_kernel_gpu_mem,36707,1,1,173907,128,178080000,89040000,89040000,178080000,1,22260000
nn_kernel_cpu,42760,0,1,1,64,0,0,0,0,1,22270000
nn_kernel_gpu,1342,1,1,173985,128,0,0,0,0,1,22270000
nn_kernel_gpu_mem,36475,1,1,173985,128,178160000,89080000,89080000,178160000,1,22270000
nn_kernel_cpu,8805,0,1,1,64,0,0,0,0,1,22280000
nn_kernel_gpu,1365,1,1,174063,128,0,0,0,0,1,22280000
nn_kernel_gpu_mem,34486,1,1,174063,128,178240000,89120000,89120000,178240000,1,22280000
nn_kernel_cpu,35878,0,1,1,64,0,0,0,0,1,22290000
nn_kernel_gpu,1329,1,1,174141,128,0,0,0,0,1,22290000
nn_kernel_gpu_mem,37344,1,1,174141,128,178320000,89160000,89160000,178320000,1,22290000
nn_kernel_cpu,17828,0,1,1,64,0,0,0,0,1,22300000
nn_kernel_gpu,1340,1,1,174219,128,0,0,0,0,1,22300000
nn_kernel_gpu_mem,34539,1,1,174219,128,178400000,89200000,89200000,178400000,1,22300000
nn_kernel_cpu,27684,0,1,1,64,0,0,0,0,1,2230000
nn_kernel_gpu,186,1,1,17422,128,0,0,0,0,1,2230000
nn_kernel_gpu_mem,3664,1,1,17422,128,17840000,8920000,8920000,17840000,1,2230000
nn_kernel_cpu,16430,0,1,1,64,0,0,0,0,1,22310000
nn_kernel_gpu,1343,1,1,174297,128,0,0,0,0,1,22310000
nn_kernel_gpu_mem,36805,1,1,174297,128,178480000,89240000,89240000,178480000,1,22310000
nn_kernel_cpu,10282,0,1,1,64,0,0,0,0,1,22320000
nn_kernel_gpu,1343,1,1,174375,128,0,0,0,0,1,22320000
nn_kernel_gpu_mem,31960,1,1,174375,128,178560000,89280000,89280000,178560000,1,22320000
nn_kernel_cpu,64039,0,1,1,64,0,0,0,0,1,22330000
nn_kernel_gpu,1334,1,1,174454,128,0,0,0,0,1,22330000
nn_kernel_gpu_mem,37928,1,1,174454,128,178640000,89320000,89320000,178640000,1,22330000
nn_kernel_cpu,11220,0,1,1,64,0,0,0,0,1,22340000
nn_kernel_gpu,1334,1,1,174532,128,0,0,0,0,1,22340000
nn_kernel_gpu_mem,38645,1,1,174532,128,178720000,89360000,89360000,178720000,1,22340000
nn_kernel_cpu,10242,0,1,1,64,0,0,0,0,1,22350000
nn_kernel_gpu,1341,1,1,174610,128,0,0,0,0,1,22350000
nn_kernel_gpu_mem,36245,1,1,174610,128,178800000,89400000,89400000,178800000,1,22350000
nn_kernel_cpu,12989,0,1,1,64,0,0,0,0,1,22360000
nn_kernel_gpu,1339,1,1,174688,128,0,0,0,0,1,22360000
nn_kernel_gpu_mem,34671,1,1,174688,128,178880000,89440000,89440000,178880000,1,22360000
nn_kernel_cpu,32061,0,1,1,64,0,0,0,0,1,22370000
nn_kernel_gpu,1360,1,1,174766,128,0,0,0,0,1,22370000
nn_kernel_gpu_mem,35949,1,1,174766,128,178960000,89480000,89480000,178960000,1,22370000
nn_kernel_cpu,23948,0,1,1,64,0,0,0,0,1,22380000
nn_kernel_gpu,1364,1,1,174844,128,0,0,0,0,1,22380000
nn_kernel_gpu_mem,37594,1,1,174844,128,179040000,89520000,89520000,179040000,1,22380000
nn_kernel_cpu,9394,0,1,1,64,0,0,0,0,1,22390000
nn_kernel_gpu,1383,1,1,174922,128,0,0,0,0,1,22390000
nn_kernel_gpu_mem,35593,1,1,174922,128,179120000,89560000,89560000,179120000,1,22390000
nn_kernel_cpu,6504,0,1,1,64,0,0,0,0,1,22400000
nn_kernel_gpu,1335,1,1,175000,128,0,0,0,0,1,22400000
nn_kernel_gpu_mem,32646,1,1,175000,128,179200000,89600000,89600000,179200000,1,22400000
nn_kernel_cpu,27736,0,1,1,64,0,0,0,0,1,2240000
nn_kernel_gpu,171,1,1,17500,128,0,0,0,0,1,2240000
nn_kernel_gpu_mem,3446,1,1,17500,128,17920000,8960000,8960000,17920000,1,2240000
nn_kernel_cpu,17793,0,1,1,64,0,0,0,0,1,22410000
nn_kernel_gpu,1337,1,1,175079,128,0,0,0,0,1,22410000
nn_kernel_gpu_mem,43038,1,1,175079,128,179280000,89640000,89640000,179280000,1,22410000
nn_kernel_cpu,24194,0,1,1,64,0,0,0,0,1,22420000
nn_kernel_gpu,1347,1,1,175157,128,0,0,0,0,1,22420000
nn_kernel_gpu_mem,34431,1,1,175157,128,179360000,89680000,89680000,179360000,1,22420000
nn_kernel_cpu,23423,0,1,1,64,0,0,0,0,1,22430000
nn_kernel_gpu,1351,1,1,175235,128,0,0,0,0,1,22430000
nn_kernel_gpu_mem,39233,1,1,175235,128,179440000,89720000,89720000,179440000,1,22430000
nn_kernel_cpu,8500,0,1,1,64,0,0,0,0,1,22440000
nn_kernel_gpu,1368,1,1,175313,128,0,0,0,0,1,22440000
nn_kernel_gpu_mem,40116,1,1,175313,128,179520000,89760000,89760000,179520000,1,22440000
nn_kernel_cpu,13803,0,1,1,64,0,0,0,0,1,22450000
nn_kernel_gpu,1402,1,1,175391,128,0,0,0,0,1,22450000
nn_kernel_gpu_mem,41357,1,1,175391,128,179600000,89800000,89800000,179600000,1,22450000
nn_kernel_cpu,24666,0,1,1,64,0,0,0,0,1,22460000
nn_kernel_gpu,1359,1,1,175469,128,0,0,0,0,1,22460000
nn_kernel_gpu_mem,37350,1,1,175469,128,179680000,89840000,89840000,179680000,1,22460000
nn_kernel_cpu,11333,0,1,1,64,0,0,0,0,1,22470000
nn_kernel_gpu,1353,1,1,175547,128,0,0,0,0,1,22470000
nn_kernel_gpu_mem,37201,1,1,175547,128,179760000,89880000,89880000,179760000,1,22470000
nn_kernel_cpu,24302,0,1,1,64,0,0,0,0,1,22480000
nn_kernel_gpu,1344,1,1,175625,128,0,0,0,0,1,22480000
nn_kernel_gpu_mem,37109,1,1,175625,128,179840000,89920000,89920000,179840000,1,22480000
nn_kernel_cpu,13205,0,1,1,64,0,0,0,0,1,22490000
nn_kernel_gpu,1351,1,1,175704,128,0,0,0,0,1,22490000
nn_kernel_gpu_mem,39934,1,1,175704,128,179920000,89960000,89960000,179920000,1,22490000
nn_kernel_cpu,28325,0,1,1,64,0,0,0,0,1,22500000
nn_kernel_gpu,1363,1,1,175782,128,0,0,0,0,1,22500000
nn_kernel_gpu_mem,40506,1,1,175782,128,180000000,90000000,90000000,180000000,1,22500000
nn_kernel_cpu,9574,0,1,1,64,0,0,0,0,1,2250000
nn_kernel_gpu,182,1,1,17579,128,0,0,0,0,1,2250000
nn_kernel_gpu_mem,3668,1,1,17579,128,18000000,9000000,9000000,18000000,1,2250000
nn_kernel_cpu,24012,0,1,1,64,0,0,0,0,1,22510000
nn_kernel_gpu,1348,1,1,175860,128,0,0,0,0,1,22510000
nn_kernel_gpu_mem,38702,1,1,175860,128,180080000,90040000,90040000,180080000,1,22510000
nn_kernel_cpu,21277,0,1,1,64,0,0,0,0,1,22520000
nn_kernel_gpu,1348,1,1,175938,128,0,0,0,0,1,22520000
nn_kernel_gpu_mem,36840,1,1,175938,128,180160000,90080000,90080000,180160000,1,22520000
nn_kernel_cpu,24670,0,1,1,64,0,0,0,0,1,22530000
nn_kernel_gpu,1355,1,1,176016,128,0,0,0,0,1,22530000
nn_kernel_gpu_mem,37507,1,1,176016,128,180240000,90120000,90120000,180240000,1,22530000
nn_kernel_cpu,25420,0,1,1,64,0,0,0,0,1,22540000
nn_kernel_gpu,1352,1,1,176094,128,0,0,0,0,1,22540000
nn_kernel_gpu_mem,39483,1,1,176094,128,180320000,90160000,90160000,180320000,1,22540000
nn_kernel_cpu,16266,0,1,1,64,0,0,0,0,1,22550000
nn_kernel_gpu,1349,1,1,176172,128,0,0,0,0,1,22550000
nn_kernel_gpu_mem,35846,1,1,176172,128,180400000,90200000,90200000,180400000,1,22550000
nn_kernel_cpu,15156,0,1,1,64,0,0,0,0,1,22560000
nn_kernel_gpu,1362,1,1,176250,128,0,0,0,0,1,22560000
nn_kernel_gpu_mem,37317,1,1,176250,128,180480000,90240000,90240000,180480000,1,22560000
nn_kernel_cpu,12521,0,1,1,64,0,0,0,0,1,22570000
nn_kernel_gpu,1358,1,1,176329,128,0,0,0,0,1,22570000
nn_kernel_gpu_mem,31821,1,1,176329,128,180560000,90280000,90280000,180560000,1,22570000
nn_kernel_cpu,22313,0,1,1,64,0,0,0,0,1,22580000
nn_kernel_gpu,1356,1,1,176407,128,0,0,0,0,1,22580000
nn_kernel_gpu_mem,38678,1,1,176407,128,180640000,90320000,90320000,180640000,1,22580000
nn_kernel_cpu,12516,0,1,1,64,0,0,0,0,1,22590000
nn_kernel_gpu,1348,1,1,176485,128,0,0,0,0,1,22590000
nn_kernel_gpu_mem,34737,1,1,176485,128,180720000,90360000,90360000,180720000,1,22590000
nn_kernel_cpu,9595,0,1,1,64,0,0,0,0,1,22600000
nn_kernel_gpu,1348,1,1,176563,128,0,0,0,0,1,22600000
nn_kernel_gpu_mem,36169,1,1,176563,128,180800000,90400000,90400000,180800000,1,22600000
nn_kernel_cpu,22447,0,1,1,64,0,0,0,0,1,2260000
nn_kernel_gpu,175,1,1,17657,128,0,0,0,0,1,2260000
nn_kernel_gpu_mem,3484,1,1,17657,128,18080000,9040000,9040000,18080000,1,2260000
nn_kernel_cpu,17877,0,1,1,64,0,0,0,0,1,22610000
nn_kernel_gpu,1350,1,1,176641,128,0,0,0,0,1,22610000
nn_kernel_gpu_mem,38297,1,1,176641,128,180880000,90440000,90440000,180880000,1,22610000
nn_kernel_cpu,29199,0,1,1,64,0,0,0,0,1,22620000
nn_kernel_gpu,1342,1,1,176719,128,0,0,0,0,1,22620000
nn_kernel_gpu_mem,30829,1,1,176719,128,180960000,90480000,90480000,180960000,1,22620000
nn_kernel_cpu,28151,0,1,1,64,0,0,0,0,1,22630000
nn_kernel_gpu,1358,1,1,176797,128,0,0,0,0,1,22630000
nn_kernel_gpu_mem,35804,1,1,176797,128,181040000,90520000,90520000,181040000,1,22630000
nn_kernel_cpu,35575,0,1,1,64,0,0,0,0,1,22640000
nn_kernel_gpu,1354,1,1,176875,128,0,0,0,0,1,22640000
nn_kernel_gpu_mem,38330,1,1,176875,128,181120000,90560000,90560000,181120000,1,22640000
nn_kernel_cpu,16550,0,1,1,64,0,0,0,0,1,22650000
nn_kernel_gpu,1360,1,1,176954,128,0,0,0,0,1,22650000
nn_kernel_gpu_mem,35516,1,1,176954,128,181200000,90600000,90600000,181200000,1,22650000
nn_kernel_cpu,16063,0,1,1,64,0,0,0,0,1,22660000
nn_kernel_gpu,1359,1,1,177032,128,0,0,0,0,1,22660000
nn_kernel_gpu_mem,34184,1,1,177032,128,181280000,90640000,90640000,181280000,1,22660000
nn_kernel_cpu,25081,0,1,1,64,0,0,0,0,1,22670000
nn_kernel_gpu,1353,1,1,177110,128,0,0,0,0,1,22670000
nn_kernel_gpu_mem,36913,1,1,177110,128,181360000,90680000,90680000,181360000,1,22670000
nn_kernel_cpu,39208,0,1,1,64,0,0,0,0,1,22680000
nn_kernel_gpu,1361,1,1,177188,128,0,0,0,0,1,22680000
nn_kernel_gpu_mem,35951,1,1,177188,128,181440000,90720000,90720000,181440000,1,22680000
nn_kernel_cpu,15530,0,1,1,64,0,0,0,0,1,22690000
nn_kernel_gpu,1367,1,1,177266,128,0,0,0,0,1,22690000
nn_kernel_gpu_mem,36358,1,1,177266,128,181520000,90760000,90760000,181520000,1,22690000
nn_kernel_cpu,12654,0,1,1,64,0,0,0,0,1,22700000
nn_kernel_gpu,1376,1,1,177344,128,0,0,0,0,1,22700000
nn_kernel_gpu_mem,38447,1,1,177344,128,181600000,90800000,90800000,181600000,1,22700000
nn_kernel_cpu,28450,0,1,1,64,0,0,0,0,1,2270000
nn_kernel_gpu,179,1,1,17735,128,0,0,0,0,1,2270000
nn_kernel_gpu_mem,3717,1,1,17735,128,18160000,9080000,9080000,18160000,1,2270000
nn_kernel_cpu,10045,0,1,1,64,0,0,0,0,1,22710000
nn_kernel_gpu,1357,1,1,177422,128,0,0,0,0,1,22710000
nn_kernel_gpu_mem,38460,1,1,177422,128,181680000,90840000,90840000,181680000,1,22710000
nn_kernel_cpu,19093,0,1,1,64,0,0,0,0,1,22720000
nn_kernel_gpu,1367,1,1,177500,128,0,0,0,0,1,22720000
nn_kernel_gpu_mem,38270,1,1,177500,128,181760000,90880000,90880000,181760000,1,22720000
nn_kernel_cpu,17299,0,1,1,64,0,0,0,0,1,22730000
nn_kernel_gpu,1359,1,1,177579,128,0,0,0,0,1,22730000
nn_kernel_gpu_mem,36490,1,1,177579,128,181840000,90920000,90920000,181840000,1,22730000
nn_kernel_cpu,16481,0,1,1,64,0,0,0,0,1,22740000
nn_kernel_gpu,1359,1,1,177657,128,0,0,0,0,1,22740000
nn_kernel_gpu_mem,40562,1,1,177657,128,181920000,90960000,90960000,181920000,1,22740000
nn_kernel_cpu,26483,0,1,1,64,0,0,0,0,1,22750000
nn_kernel_gpu,1360,1,1,177735,128,0,0,0,0,1,22750000
nn_kernel_gpu_mem,27683,1,1,177735,128,182000000,91000000,91000000,182000000,1,22750000
nn_kernel_cpu,17898,0,1,1,64,0,0,0,0,1,22760000
nn_kernel_gpu,1368,1,1,177813,128,0,0,0,0,1,22760000
nn_kernel_gpu_mem,35286,1,1,177813,128,182080000,91040000,91040000,182080000,1,22760000
nn_kernel_cpu,22951,0,1,1,64,0,0,0,0,1,22770000
nn_kernel_gpu,1365,1,1,177891,128,0,0,0,0,1,22770000
nn_kernel_gpu_mem,33106,1,1,177891,128,182160000,91080000,91080000,182160000,1,22770000
nn_kernel_cpu,9126,0,1,1,64,0,0,0,0,1,22780000
nn_kernel_gpu,1397,1,1,177969,128,0,0,0,0,1,22780000
nn_kernel_gpu_mem,36454,1,1,177969,128,182240000,91120000,91120000,182240000,1,22780000
nn_kernel_cpu,23156,0,1,1,64,0,0,0,0,1,22790000
nn_kernel_gpu,1369,1,1,178047,128,0,0,0,0,1,22790000
nn_kernel_gpu_mem,38786,1,1,178047,128,182320000,91160000,91160000,182320000,1,22790000
nn_kernel_cpu,48657,0,1,1,64,0,0,0,0,1,22800000
nn_kernel_gpu,1377,1,1,178125,128,0,0,0,0,1,22800000
nn_kernel_gpu_mem,35986,1,1,178125,128,182400000,91200000,91200000,182400000,1,22800000
nn_kernel_cpu,23480,0,1,1,64,0,0,0,0,1,2280000
nn_kernel_gpu,200,1,1,17813,128,0,0,0,0,1,2280000
nn_kernel_gpu_mem,6655,1,1,17813,128,18240000,9120000,9120000,18240000,1,2280000
nn_kernel_cpu,23125,0,1,1,64,0,0,0,0,1,22810000
nn_kernel_gpu,1374,1,1,178204,128,0,0,0,0,1,22810000
nn_kernel_gpu_mem,35746,1,1,178204,128,182480000,91240000,91240000,182480000,1,22810000
nn_kernel_cpu,12865,0,1,1,64,0,0,0,0,1,22820000
nn_kernel_gpu,1372,1,1,178282,128,0,0,0,0,1,22820000
nn_kernel_gpu_mem,39119,1,1,178282,128,182560000,91280000,91280000,182560000,1,22820000
nn_kernel_cpu,8670,0,1,1,64,0,0,0,0,1,22830000
nn_kernel_gpu,1373,1,1,178360,128,0,0,0,0,1,22830000
nn_kernel_gpu_mem,36031,1,1,178360,128,182640000,91320000,91320000,182640000,1,22830000
nn_kernel_cpu,10803,0,1,1,64,0,0,0,0,1,22840000
nn_kernel_gpu,1398,1,1,178438,128,0,0,0,0,1,22840000
nn_kernel_gpu_mem,42139,1,1,178438,128,182720000,91360000,91360000,182720000,1,22840000
nn_kernel_cpu,19860,0,1,1,64,0,0,0,0,1,22850000
nn_kernel_gpu,1365,1,1,178516,128,0,0,0,0,1,22850000
nn_kernel_gpu_mem,36556,1,1,178516,128,182800000,91400000,91400000,182800000,1,22850000
nn_kernel_cpu,35370,0,1,1,64,0,0,0,0,1,22860000
nn_kernel_gpu,1381,1,1,178594,128,0,0,0,0,1,22860000
nn_kernel_gpu_mem,36264,1,1,178594,128,182880000,91440000,91440000,182880000,1,22860000
nn_kernel_cpu,8402,0,1,1,64,0,0,0,0,1,22870000
nn_kernel_gpu,1369,1,1,178672,128,0,0,0,0,1,22870000
nn_kernel_gpu_mem,27604,1,1,178672,128,182960000,91480000,91480000,182960000,1,22870000
nn_kernel_cpu,29841,0,1,1,64,0,0,0,0,1,22880000
nn_kernel_gpu,1375,1,1,178750,128,0,0,0,0,1,22880000
nn_kernel_gpu_mem,39326,1,1,178750,128,183040000,91520000,91520000,183040000,1,22880000
nn_kernel_cpu,14971,0,1,1,64,0,0,0,0,1,22890000
nn_kernel_gpu,1413,1,1,178829,128,0,0,0,0,1,22890000
nn_kernel_gpu_mem,37786,1,1,178829,128,183120000,91560000,91560000,183120000,1,22890000
nn_kernel_cpu,39764,0,1,1,64,0,0,0,0,1,22900000
nn_kernel_gpu,1376,1,1,178907,128,0,0,0,0,1,22900000
nn_kernel_gpu_mem,35014,1,1,178907,128,183200000,91600000,91600000,183200000,1,22900000
nn_kernel_cpu,24060,0,1,1,64,0,0,0,0,1,2290000
nn_kernel_gpu,180,1,1,17891,128,0,0,0,0,1,2290000
nn_kernel_gpu_mem,3691,1,1,17891,128,18320000,9160000,9160000,18320000,1,2290000
nn_kernel_cpu,25293,0,1,1,64,0,0,0,0,1,22910000
nn_kernel_gpu,1373,1,1,178985,128,0,0,0,0,1,22910000
nn_kernel_gpu_mem,38694,1,1,178985,128,183280000,91640000,91640000,183280000,1,22910000
nn_kernel_cpu,12098,0,1,1,64,0,0,0,0,1,22920000
nn_kernel_gpu,1376,1,1,179063,128,0,0,0,0,1,22920000
nn_kernel_gpu_mem,31406,1,1,179063,128,183360000,91680000,91680000,183360000,1,22920000
nn_kernel_cpu,10912,0,1,1,64,0,0,0,0,1,22930000
nn_kernel_gpu,1375,1,1,179141,128,0,0,0,0,1,22930000
nn_kernel_gpu_mem,32402,1,1,179141,128,183440000,91720000,91720000,183440000,1,22930000
nn_kernel_cpu,23761,0,1,1,64,0,0,0,0,1,22940000
nn_kernel_gpu,1384,1,1,179219,128,0,0,0,0,1,22940000
nn_kernel_gpu_mem,34487,1,1,179219,128,183520000,91760000,91760000,183520000,1,22940000
nn_kernel_cpu,13755,0,1,1,64,0,0,0,0,1,22950000
nn_kernel_gpu,1382,1,1,179297,128,0,0,0,0,1,22950000
nn_kernel_gpu_mem,36155,1,1,179297,128,183600000,91800000,91800000,183600000,1,22950000
nn_kernel_cpu,15638,0,1,1,64,0,0,0,0,1,22960000
nn_kernel_gpu,1389,1,1,179375,128,0,0,0,0,1,22960000
nn_kernel_gpu_mem,31323,1,1,179375,128,183680000,91840000,91840000,183680000,1,22960000
nn_kernel_cpu,11227,0,1,1,64,0,0,0,0,1,22970000
nn_kernel_gpu,1382,1,1,179454,128,0,0,0,0,1,22970000
nn_kernel_gpu_mem,36555,1,1,179454,128,183760000,91880000,91880000,183760000,1,22970000
nn_kernel_cpu,14608,0,1,1,64,0,0,0,0,1,22980000
nn_kernel_gpu,1374,1,1,179532,128,0,0,0,0,1,22980000
nn_kernel_gpu_mem,38475,1,1,179532,128,183840000,91920000,91920000,183840000,1,22980000
nn_kernel_cpu,12358,0,1,1,64,0,0,0,0,1,22990000
nn_kernel_gpu,1370,1,1,179610,128,0,0,0,0,1,22990000
nn_kernel_gpu_mem,34421,1,1,179610,128,183920000,91960000,91960000,183920000,1,22990000
nn_kernel_cpu,9861,0,1,1,64,0,0,0,0,1,23000000
nn_kernel_gpu,1380,1,1,179688,128,0,0,0,0,1,23000000
nn_kernel_gpu_mem,38867,1,1,179688,128,184000000,92000000,92000000,184000000,1,23000000
nn_kernel_cpu,2401,0,1,1,64,0,0,0,0,1,2300000
nn_kernel_gpu,183,1,1,17969,128,0,0,0,0,1,2300000
nn_kernel_gpu_mem,4027,1,1,17969,128,18400000,9200000,9200000,18400000,1,2300000
nn_kernel_cpu,491,0,1,1,64,0,0,0,0,1,230000
nn_kernel_gpu,64,1,1,1797,128,0,0,0,0,1,230000
nn_kernel_gpu_mem,524,1,1,1797,128,1840000,920000,920000,1840000,1,230000
nn_kernel_cpu,17021,0,1,1,64,0,0,0,0,1,23010000
nn_kernel_gpu,1381,1,1,179766,128,0,0,0,0,1,23010000
nn_kernel_gpu_mem,37343,1,1,179766,128,184080000,92040000,92040000,184080000,1,23010000
nn_kernel_cpu,15634,0,1,1,64,0,0,0,0,1,23020000
nn_kernel_gpu,1381,1,1,179844,128,0,0,0,0,1,23020000
nn_kernel_gpu_mem,37584,1,1,179844,128,184160000,92080000,92080000,184160000,1,23020000
nn_kernel_cpu,31716,0,1,1,64,0,0,0,0,1,23030000
nn_kernel_gpu,1387,1,1,179922,128,0,0,0,0,1,23030000
nn_kernel_gpu_mem,37712,1,1,179922,128,184240000,92120000,92120000,184240000,1,23030000
nn_kernel_cpu,22851,0,1,1,64,0,0,0,0,1,23040000
nn_kernel_gpu,1383,1,1,180000,128,0,0,0,0,1,23040000
nn_kernel_gpu_mem,38538,1,1,180000,128,184320000,92160000,92160000,184320000,1,23040000
nn_kernel_cpu,24415,0,1,1,64,0,0,0,0,1,23050000
nn_kernel_gpu,1397,1,1,180079,128,0,0,0,0,1,23050000
nn_kernel_gpu_mem,37226,1,1,180079,128,184400000,92200000,92200000,184400000,1,23050000
nn_kernel_cpu,25877,0,1,1,64,0,0,0,0,1,23060000
nn_kernel_gpu,1393,1,1,180157,128,0,0,0,0,1,23060000
nn_kernel_gpu_mem,37760,1,1,180157,128,184480000,92240000,92240000,184480000,1,23060000
nn_kernel_cpu,27699,0,1,1,64,0,0,0,0,1,23070000
nn_kernel_gpu,1397,1,1,180235,128,0,0,0,0,1,23070000
nn_kernel_gpu_mem,36313,1,1,180235,128,184560000,92280000,92280000,184560000,1,23070000
nn_kernel_cpu,29815,0,1,1,64,0,0,0,0,1,23080000
nn_kernel_gpu,1390,1,1,180313,128,0,0,0,0,1,23080000
nn_kernel_gpu_mem,44152,1,1,180313,128,184640000,92320000,92320000,184640000,1,23080000
nn_kernel_cpu,11366,0,1,1,64,0,0,0,0,1,23090000
nn_kernel_gpu,1386,1,1,180391,128,0,0,0,0,1,23090000
nn_kernel_gpu_mem,33487,1,1,180391,128,184720000,92360000,92360000,184720000,1,23090000
nn_kernel_cpu,22198,0,1,1,64,0,0,0,0,1,23100000
nn_kernel_gpu,1392,1,1,180469,128,0,0,0,0,1,23100000
nn_kernel_gpu_mem,35834,1,1,180469,128,184800000,92400000,92400000,184800000,1,23100000
nn_kernel_cpu,8056,0,1,1,64,0,0,0,0,1,2310000
nn_kernel_gpu,204,1,1,18047,128,0,0,0,0,1,2310000
nn_kernel_gpu_mem,8616,1,1,18047,128,18480000,9240000,9240000,18480000,1,2310000
nn_kernel_cpu,23949,0,1,1,64,0,0,0,0,1,23110000
nn_kernel_gpu,1404,1,1,180547,128,0,0,0,0,1,23110000
nn_kernel_gpu_mem,36877,1,1,180547,128,184880000,92440000,92440000,184880000,1,23110000
nn_kernel_cpu,29805,0,1,1,64,0,0,0,0,1,23120000
nn_kernel_gpu,1386,1,1,180625,128,0,0,0,0,1,23120000
nn_kernel_gpu_mem,34019,1,1,180625,128,184960000,92480000,92480000,184960000,1,23120000
nn_kernel_cpu,26273,0,1,1,64,0,0,0,0,1,23130000
nn_kernel_gpu,1397,1,1,180704,128,0,0,0,0,1,23130000
nn_kernel_gpu_mem,45765,1,1,180704,128,185040000,92520000,92520000,185040000,1,23130000
nn_kernel_cpu,39781,0,1,1,64,0,0,0,0,1,23140000
nn_kernel_gpu,1388,1,1,180782,128,0,0,0,0,1,23140000
nn_kernel_gpu_mem,39625,1,1,180782,128,185120000,92560000,92560000,185120000,1,23140000
nn_kernel_cpu,34070,0,1,1,64,0,0,0,0,1,23150000
nn_kernel_gpu,1394,1,1,180860,128,0,0,0,0,1,23150000
nn_kernel_gpu_mem,45250,1,1,180860,128,185200000,92600000,92600000,185200000,1,23150000
nn_kernel_cpu,27302,0,1,1,64,0,0,0,0,1,23160000
nn_kernel_gpu,1392,1,1,180938,128,0,0,0,0,1,23160000
nn_kernel_gpu_mem,38755,1,1,180938,128,185280000,92640000,92640000,185280000,1,23160000
nn_kernel_cpu,18301,0,1,1,64,0,0,0,0,1,23170000
nn_kernel_gpu,1396,1,1,181016,128,0,0,0,0,1,23170000
nn_kernel_gpu_mem,37378,1,1,181016,128,185360000,92680000,92680000,185360000,1,23170000
nn_kernel_cpu,23189,0,1,1,64,0,0,0,0,1,23180000
nn_kernel_gpu,1388,1,1,181094,128,0,0,0,0,1,23180000
nn_kernel_gpu_mem,37751,1,1,181094,128,185440000,92720000,92720000,185440000,1,23180000
nn_kernel_cpu,27799,0,1,1,64,0,0,0,0,1,23190000
nn_kernel_gpu,1386,1,1,181172,128,0,0,0,0,1,23190000
nn_kernel_gpu_mem,37126,1,1,181172,128,185520000,92760000,92760000,185520000,1,23190000
nn_kernel_cpu,37755,0,1,1,64,0,0,0,0,1,23200000
nn_kernel_gpu,1416,1,1,181250,128,0,0,0,0,1,23200000
nn_kernel_gpu_mem,38963,1,1,181250,128,185600000,92800000,92800000,185600000,1,23200000
nn_kernel_cpu,21373,0,1,1,64,0,0,0,0,1,2320000
nn_kernel_gpu,185,1,1,18125,128,0,0,0,0,1,2320000
nn_kernel_gpu_mem,4281,1,1,18125,128,18560000,9280000,9280000,18560000,1,2320000
nn_kernel_cpu,26530,0,1,1,64,0,0,0,0,1,23210000
nn_kernel_gpu,1398,1,1,181329,128,0,0,0,0,1,23210000
nn_kernel_gpu_mem,32612,1,1,181329,128,185680000,92840000,92840000,185680000,1,23210000
nn_kernel_cpu,23585,0,1,1,64,0,0,0,0,1,23220000
nn_kernel_gpu,1399,1,1,181407,128,0,0,0,0,1,23220000
nn_kernel_gpu_mem,39425,1,1,181407,128,185760000,92880000,92880000,185760000,1,23220000
nn_kernel_cpu,22738,0,1,1,64,0,0,0,0,1,23230000
nn_kernel_gpu,1440,1,1,181485,128,0,0,0,0,1,23230000
nn_kernel_gpu_mem,32220,1,1,181485,128,185840000,92920000,92920000,185840000,1,23230000
nn_kernel_cpu,26422,0,1,1,64,0,0,0,0,1,23240000
nn_kernel_gpu,1427,1,1,181563,128,0,0,0,0,1,23240000
nn_kernel_gpu_mem,37867,1,1,181563,128,185920000,92960000,92960000,185920000,1,23240000
nn_kernel_cpu,18596,0,1,1,64,0,0,0,0,1,23250000
nn_kernel_gpu,1419,1,1,181641,128,0,0,0,0,1,23250000
nn_kernel_gpu_mem,32178,1,1,181641,128,186000000,93000000,93000000,186000000,1,23250000
nn_kernel_cpu,23898,0,1,1,64,0,0,0,0,1,23260000
nn_kernel_gpu,1400,1,1,181719,128,0,0,0,0,1,23260000
nn_kernel_gpu_mem,36976,1,1,181719,128,186080000,93040000,93040000,186080000,1,23260000
nn_kernel_cpu,34638,0,1,1,64,0,0,0,0,1,23270000
nn_kernel_gpu,1414,1,1,181797,128,0,0,0,0,1,23270000
nn_kernel_gpu_mem,33028,1,1,181797,128,186160000,93080000,93080000,186160000,1,23270000
nn_kernel_cpu,22796,0,1,1,64,0,0,0,0,1,23280000
nn_kernel_gpu,1409,1,1,181875,128,0,0,0,0,1,23280000
nn_kernel_gpu_mem,38443,1,1,181875,128,186240000,93120000,93120000,186240000,1,23280000
nn_kernel_cpu,27938,0,1,1,64,0,0,0,0,1,23290000
nn_kernel_gpu,1398,1,1,181954,128,0,0,0,0,1,23290000
nn_kernel_gpu_mem,37232,1,1,181954,128,186320000,93160000,93160000,186320000,1,23290000
nn_kernel_cpu,25642,0,1,1,64,0,0,0,0,1,23300000
nn_kernel_gpu,1390,1,1,182032,128,0,0,0,0,1,23300000
nn_kernel_gpu_mem,38420,1,1,182032,128,186400000,93200000,93200000,186400000,1,23300000
nn_kernel_cpu,25590,0,1,1,64,0,0,0,0,1,2330000
nn_kernel_gpu,198,1,1,18204,128,0,0,0,0,1,2330000
nn_kernel_gpu_mem,8094,1,1,18204,128,18640000,9320000,9320000,18640000,1,2330000
nn_kernel_cpu,27200,0,1,1,64,0,0,0,0,1,23310000
nn_kernel_gpu,1407,1,1,182110,128,0,0,0,0,1,23310000
nn_kernel_gpu_mem,37698,1,1,182110,128,186480000,93240000,93240000,186480000,1,23310000
nn_kernel_cpu,24126,0,1,1,64,0,0,0,0,1,23320000
nn_kernel_gpu,1396,1,1,182188,128,0,0,0,0,1,23320000
nn_kernel_gpu_mem,35957,1,1,182188,128,186560000,93280000,93280000,186560000,1,23320000
nn_kernel_cpu,35830,0,1,1,64,0,0,0,0,1,23330000
nn_kernel_gpu,1391,1,1,182266,128,0,0,0,0,1,23330000
nn_kernel_gpu_mem,41966,1,1,182266,128,186640000,93320000,93320000,186640000,1,23330000
nn_kernel_cpu,31719,0,1,1,64,0,0,0,0,1,23340000
nn_kernel_gpu,1418,1,1,182344,128,0,0,0,0,1,23340000
nn_kernel_gpu_mem,38890,1,1,182344,128,186720000,93360000,93360000,186720000,1,23340000
nn_kernel_cpu,31055,0,1,1,64,0,0,0,0,1,23350000
nn_kernel_gpu,1422,1,1,182422,128,0,0,0,0,1,23350000
nn_kernel_gpu_mem,39897,1,1,182422,128,186800000,93400000,93400000,186800000,1,23350000
nn_kernel_cpu,32764,0,1,1,64,0,0,0,0,1,23360000
nn_kernel_gpu,1396,1,1,182500,128,0,0,0,0,1,23360000
nn_kernel_gpu_mem,42935,1,1,182500,128,186880000,93440000,93440000,186880000,1,23360000
nn_kernel_cpu,23071,0,1,1,64,0,0,0,0,1,23370000
nn_kernel_gpu,1406,1,1,182579,128,0,0,0,0,1,23370000
nn_kernel_gpu_mem,45578,1,1,182579,128,186960000,93480000,93480000,186960000,1,23370000
nn_kernel_cpu,25935,0,1,1,64,0,0,0,0,1,23380000
nn_kernel_gpu,1407,1,1,182657,128,0,0,0,0,1,23380000
nn_kernel_gpu_mem,38601,1,1,182657,128,187040000,93520000,93520000,187040000,1,23380000
nn_kernel_cpu,12389,0,1,1,64,0,0,0,0,1,23390000
nn_kernel_gpu,1440,1,1,182735,128,0,0,0,0,1,23390000
nn_kernel_gpu_mem,38232,1,1,182735,128,187120000,93560000,93560000,187120000,1,23390000
nn_kernel_cpu,30235,0,1,1,64,0,0,0,0,1,23400000
nn_kernel_gpu,1406,1,1,182813,128,0,0,0,0,1,23400000
nn_kernel_gpu_mem,40007,1,1,182813,128,187200000,93600000,93600000,187200000,1,23400000
nn_kernel_cpu,14075,0,1,1,64,0,0,0,0,1,2340000
nn_kernel_gpu,180,1,1,18282,128,0,0,0,0,1,2340000
nn_kernel_gpu_mem,9854,1,1,18282,128,18720000,9360000,9360000,18720000,1,2340000
nn_kernel_cpu,13199,0,1,1,64,0,0,0,0,1,23410000
nn_kernel_gpu,1408,1,1,182891,128,0,0,0,0,1,23410000
nn_kernel_gpu_mem,39761,1,1,182891,128,187280000,93640000,93640000,187280000,1,23410000
nn_kernel_cpu,15944,0,1,1,64,0,0,0,0,1,23420000
nn_kernel_gpu,1406,1,1,182969,128,0,0,0,0,1,23420000
nn_kernel_gpu_mem,37229,1,1,182969,128,187360000,93680000,93680000,187360000,1,23420000
nn_kernel_cpu,18693,0,1,1,64,0,0,0,0,1,23430000
nn_kernel_gpu,1405,1,1,183047,128,0,0,0,0,1,23430000
nn_kernel_gpu_mem,37243,1,1,183047,128,187440000,93720000,93720000,187440000,1,23430000
nn_kernel_cpu,32646,0,1,1,64,0,0,0,0,1,23440000
nn_kernel_gpu,1402,1,1,183125,128,0,0,0,0,1,23440000
nn_kernel_gpu_mem,36800,1,1,183125,128,187520000,93760000,93760000,187520000,1,23440000
nn_kernel_cpu,12095,0,1,1,64,0,0,0,0,1,23450000
nn_kernel_gpu,1423,1,1,183204,128,0,0,0,0,1,23450000
nn_kernel_gpu_mem,37679,1,1,183204,128,187600000,93800000,93800000,187600000,1,23450000
nn_kernel_cpu,16055,0,1,1,64,0,0,0,0,1,23460000
nn_kernel_gpu,1409,1,1,183282,128,0,0,0,0,1,23460000
nn_kernel_gpu_mem,36271,1,1,183282,128,187680000,93840000,93840000,187680000,1,23460000
nn_kernel_cpu,10695,0,1,1,64,0,0,0,0,1,23470000
nn_kernel_gpu,1403,1,1,183360,128,0,0,0,0,1,23470000
nn_kernel_gpu_mem,34897,1,1,183360,128,187760000,93880000,93880000,187760000,1,23470000
nn_kernel_cpu,17536,0,1,1,64,0,0,0,0,1,23480000
nn_kernel_gpu,1411,1,1,183438,128,0,0,0,0,1,23480000
nn_kernel_gpu_mem,36749,1,1,183438,128,187840000,93920000,93920000,187840000,1,23480000
nn_kernel_cpu,23749,0,1,1,64,0,0,0,0,1,23490000
nn_kernel_gpu,1417,1,1,183516,128,0,0,0,0,1,23490000
nn_kernel_gpu_mem,36614,1,1,183516,128,187920000,93960000,93960000,187920000,1,23490000
nn_kernel_cpu,14317,0,1,1,64,0,0,0,0,1,23500000
nn_kernel_gpu,1419,1,1,183594,128,0,0,0,0,1,23500000
nn_kernel_gpu_mem,44771,1,1,183594,128,188000000,94000000,94000000,188000000,1,23500000
nn_kernel_cpu,24249,0,1,1,64,0,0,0,0,1,2350000
nn_kernel_gpu,187,1,1,18360,128,0,0,0,0,1,2350000
nn_kernel_gpu_mem,3978,1,1,18360,128,18800000,9400000,9400000,18800000,1,2350000
nn_kernel_cpu,38388,0,1,1,64,0,0,0,0,1,23510000
nn_kernel_gpu,1413,1,1,183672,128,0,0,0,0,1,23510000
nn_kernel_gpu_mem,48667,1,1,183672,128,188080000,94040000,94040000,188080000,1,23510000
nn_kernel_cpu,20980,0,1,1,64,0,0,0,0,1,23520000
nn_kernel_gpu,1414,1,1,183750,128,0,0,0,0,1,23520000
nn_kernel_gpu_mem,37143,1,1,183750,128,188160000,94080000,94080000,188160000,1,23520000
nn_kernel_cpu,13550,0,1,1,64,0,0,0,0,1,23530000
nn_kernel_gpu,1427,1,1,183829,128,0,0,0,0,1,23530000
nn_kernel_gpu_mem,35779,1,1,183829,128,188240000,94120000,94120000,188240000,1,23530000
nn_kernel_cpu,27467,0,1,1,64,0,0,0,0,1,23540000
nn_kernel_gpu,1425,1,1,183907,128,0,0,0,0,1,23540000
nn_kernel_gpu_mem,33939,1,1,183907,128,188320000,94160000,94160000,188320000,1,23540000
nn_kernel_cpu,47263,0,1,1,64,0,0,0,0,1,23550000
nn_kernel_gpu,1406,1,1,183985,128,0,0,0,0,1,23550000
nn_kernel_gpu_mem,30458,1,1,183985,128,188400000,94200000,94200000,188400000,1,23550000
nn_kernel_cpu,17380,0,1,1,64,0,0,0,0,1,23560000
nn_kernel_gpu,1412,1,1,184063,128,0,0,0,0,1,23560000
nn_kernel_gpu_mem,41404,1,1,184063,128,188480000,94240000,94240000,188480000,1,23560000
nn_kernel_cpu,31874,0,1,1,64,0,0,0,0,1,23570000
nn_kernel_gpu,1411,1,1,184141,128,0,0,0,0,1,23570000
nn_kernel_gpu_mem,37826,1,1,184141,128,188560000,94280000,94280000,188560000,1,23570000
nn_kernel_cpu,13557,0,1,1,64,0,0,0,0,1,23580000
nn_kernel_gpu,1410,1,1,184219,128,0,0,0,0,1,23580000
nn_kernel_gpu_mem,39784,1,1,184219,128,188640000,94320000,94320000,188640000,1,23580000
nn_kernel_cpu,37576,0,1,1,64,0,0,0,0,1,23590000
nn_kernel_gpu,1412,1,1,184297,128,0,0,0,0,1,23590000
nn_kernel_gpu_mem,38054,1,1,184297,128,188720000,94360000,94360000,188720000,1,23590000
nn_kernel_cpu,21011,0,1,1,64,0,0,0,0,1,23600000
nn_kernel_gpu,1426,1,1,184375,128,0,0,0,0,1,23600000
nn_kernel_gpu_mem,37223,1,1,184375,128,188800000,94400000,94400000,188800000,1,23600000
nn_kernel_cpu,3723,0,1,1,64,0,0,0,0,1,2360000
nn_kernel_gpu,181,1,1,18438,128,0,0,0,0,1,2360000
nn_kernel_gpu_mem,3968,1,1,18438,128,18880000,9440000,9440000,18880000,1,2360000
nn_kernel_cpu,7889,0,1,1,64,0,0,0,0,1,23610000
nn_kernel_gpu,1429,1,1,184454,128,0,0,0,0,1,23610000
nn_kernel_gpu_mem,39944,1,1,184454,128,188880000,94440000,94440000,188880000,1,23610000
nn_kernel_cpu,26863,0,1,1,64,0,0,0,0,1,23620000
nn_kernel_gpu,1423,1,1,184532,128,0,0,0,0,1,23620000
nn_kernel_gpu_mem,39031,1,1,184532,128,188960000,94480000,94480000,188960000,1,23620000
nn_kernel_cpu,25808,0,1,1,64,0,0,0,0,1,23630000
nn_kernel_gpu,1463,1,1,184610,128,0,0,0,0,1,23630000
nn_kernel_gpu_mem,32448,1,1,184610,128,189040000,94520000,94520000,189040000,1,23630000
nn_kernel_cpu,23966,0,1,1,64,0,0,0,0,1,23640000
nn_kernel_gpu,1436,1,1,184688,128,0,0,0,0,1,23640000
nn_kernel_gpu_mem,37853,1,1,184688,128,189120000,94560000,94560000,189120000,1,23640000
nn_kernel_cpu,16592,0,1,1,64,0,0,0,0,1,23650000
nn_kernel_gpu,1426,1,1,184766,128,0,0,0,0,1,23650000
nn_kernel_gpu_mem,37990,1,1,184766,128,189200000,94600000,94600000,189200000,1,23650000
nn_kernel_cpu,21129,0,1,1,64,0,0,0,0,1,23660000
nn_kernel_gpu,1412,1,1,184844,128,0,0,0,0,1,23660000
nn_kernel_gpu_mem,39014,1,1,184844,128,189280000,94640000,94640000,189280000,1,23660000
nn_kernel_cpu,12674,0,1,1,64,0,0,0,0,1,23670000
nn_kernel_gpu,1427,1,1,184922,128,0,0,0,0,1,23670000
nn_kernel_gpu_mem,33334,1,1,184922,128,189360000,94680000,94680000,189360000,1,23670000
nn_kernel_cpu,22815,0,1,1,64,0,0,0,0,1,23680000
nn_kernel_gpu,1449,1,1,185000,128,0,0,0,0,1,23680000
nn_kernel_gpu_mem,42916,1,1,185000,128,189440000,94720000,94720000,189440000,1,23680000
nn_kernel_cpu,34247,0,1,1,64,0,0,0,0,1,23690000
nn_kernel_gpu,1423,1,1,185079,128,0,0,0,0,1,23690000
nn_kernel_gpu_mem,36534,1,1,185079,128,189520000,94760000,94760000,189520000,1,23690000
nn_kernel_cpu,14694,0,1,1,64,0,0,0,0,1,23700000
nn_kernel_gpu,1431,1,1,185157,128,0,0,0,0,1,23700000
nn_kernel_gpu_mem,28830,1,1,185157,128,189600000,94800000,94800000,189600000,1,23700000
nn_kernel_cpu,11235,0,1,1,64,0,0,0,0,1,2370000
nn_kernel_gpu,216,1,1,18516,128,0,0,0,0,1,2370000
nn_kernel_gpu_mem,7016,1,1,18516,128,18960000,9480000,9480000,18960000,1,2370000
nn_kernel_cpu,20017,0,1,1,64,0,0,0,0,1,23710000
nn_kernel_gpu,1461,1,1,185235,128,0,0,0,0,1,23710000
nn_kernel_gpu_mem,34270,1,1,185235,128,189680000,94840000,94840000,189680000,1,23710000
nn_kernel_cpu,22997,0,1,1,64,0,0,0,0,1,23720000
nn_kernel_gpu,1421,1,1,185313,128,0,0,0,0,1,23720000
nn_kernel_gpu_mem,32747,1,1,185313,128,189760000,94880000,94880000,189760000,1,23720000
nn_kernel_cpu,23594,0,1,1,64,0,0,0,0,1,23730000
nn_kernel_gpu,1434,1,1,185391,128,0,0,0,0,1,23730000
nn_kernel_gpu_mem,38371,1,1,185391,128,189840000,94920000,94920000,189840000,1,23730000
nn_kernel_cpu,15269,0,1,1,64,0,0,0,0,1,23740000
nn_kernel_gpu,1422,1,1,185469,128,0,0,0,0,1,23740000
nn_kernel_gpu_mem,40073,1,1,185469,128,189920000,94960000,94960000,189920000,1,23740000
nn_kernel_cpu,35834,0,1,1,64,0,0,0,0,1,23750000
nn_kernel_gpu,1438,1,1,185547,128,0,0,0,0,1,23750000
nn_kernel_gpu_mem,37845,1,1,185547,128,190000000,95000000,95000000,190000000,1,23750000
nn_kernel_cpu,12884,0,1,1,64,0,0,0,0,1,23760000
nn_kernel_gpu,1439,1,1,185625,128,0,0,0,0,1,23760000
nn_kernel_gpu_mem,39098,1,1,185625,128,190080000,95040000,95040000,190080000,1,23760000
nn_kernel_cpu,17890,0,1,1,64,0,0,0,0,1,23770000
nn_kernel_gpu,1432,1,1,185704,128,0,0,0,0,1,23770000
nn_kernel_gpu_mem,29424,1,1,185704,128,190160000,95080000,95080000,190160000,1,23770000
nn_kernel_cpu,18350,0,1,1,64,0,0,0,0,1,23780000
nn_kernel_gpu,1428,1,1,185782,128,0,0,0,0,1,23780000
nn_kernel_gpu_mem,41634,1,1,185782,128,190240000,95120000,95120000,190240000,1,23780000
nn_kernel_cpu,25280,0,1,1,64,0,0,0,0,1,23790000
nn_kernel_gpu,1445,1,1,185860,128,0,0,0,0,1,23790000
nn_kernel_gpu_mem,41272,1,1,185860,128,190320000,95160000,95160000,190320000,1,23790000
nn_kernel_cpu,28132,0,1,1,64,0,0,0,0,1,23800000
nn_kernel_gpu,1438,1,1,185938,128,0,0,0,0,1,23800000
nn_kernel_gpu_mem,37226,1,1,185938,128,190400000,95200000,95200000,190400000,1,23800000
nn_kernel_cpu,10089,0,1,1,64,0,0,0,0,1,2380000
nn_kernel_gpu,179,1,1,18594,128,0,0,0,0,1,2380000
nn_kernel_gpu_mem,7059,1,1,18594,128,19040000,9520000,9520000,19040000,1,2380000
nn_kernel_cpu,24338,0,1,1,64,0,0,0,0,1,23810000
nn_kernel_gpu,1432,1,1,186016,128,0,0,0,0,1,23810000
nn_kernel_gpu_mem,39106,1,1,186016,128,190480000,95240000,95240000,190480000,1,23810000
nn_kernel_cpu,23570,0,1,1,64,0,0,0,0,1,23820000
nn_kernel_gpu,1436,1,1,186094,128,0,0,0,0,1,23820000
nn_kernel_gpu_mem,33521,1,1,186094,128,190560000,95280000,95280000,190560000,1,23820000
nn_kernel_cpu,13183,0,1,1,64,0,0,0,0,1,23830000
nn_kernel_gpu,1435,1,1,186172,128,0,0,0,0,1,23830000
nn_kernel_gpu_mem,31414,1,1,186172,128,190640000,95320000,95320000,190640000,1,23830000
nn_kernel_cpu,15695,0,1,1,64,0,0,0,0,1,23840000
nn_kernel_gpu,1437,1,1,186250,128,0,0,0,0,1,23840000
nn_kernel_gpu_mem,41228,1,1,186250,128,190720000,95360000,95360000,190720000,1,23840000
nn_kernel_cpu,9694,0,1,1,64,0,0,0,0,1,23850000
nn_kernel_gpu,1434,1,1,186329,128,0,0,0,0,1,23850000
nn_kernel_gpu_mem,32591,1,1,186329,128,190800000,95400000,95400000,190800000,1,23850000
nn_kernel_cpu,35437,0,1,1,64,0,0,0,0,1,23860000
nn_kernel_gpu,1442,1,1,186407,128,0,0,0,0,1,23860000
nn_kernel_gpu_mem,38139,1,1,186407,128,190880000,95440000,95440000,190880000,1,23860000
nn_kernel_cpu,25577,0,1,1,64,0,0,0,0,1,23870000
nn_kernel_gpu,1464,1,1,186485,128,0,0,0,0,1,23870000
nn_kernel_gpu_mem,33859,1,1,186485,128,190960000,95480000,95480000,190960000,1,23870000
nn_kernel_cpu,10435,0,1,1,64,0,0,0,0,1,23880000
nn_kernel_gpu,1434,1,1,186563,128,0,0,0,0,1,23880000
nn_kernel_gpu_mem,43275,1,1,186563,128,191040000,95520000,95520000,191040000,1,23880000
nn_kernel_cpu,23528,0,1,1,64,0,0,0,0,1,23890000
nn_kernel_gpu,1460,1,1,186641,128,0,0,0,0,1,23890000
nn_kernel_gpu_mem,34490,1,1,186641,128,191120000,95560000,95560000,191120000,1,23890000
nn_kernel_cpu,11470,0,1,1,64,0,0,0,0,1,23900000
nn_kernel_gpu,1452,1,1,186719,128,0,0,0,0,1,23900000
nn_kernel_gpu_mem,38601,1,1,186719,128,191200000,95600000,95600000,191200000,1,23900000
nn_kernel_cpu,23498,0,1,1,64,0,0,0,0,1,2390000
nn_kernel_gpu,208,1,1,18672,128,0,0,0,0,1,2390000
nn_kernel_gpu_mem,8618,1,1,18672,128,19120000,9560000,9560000,19120000,1,2390000
nn_kernel_cpu,25579,0,1,1,64,0,0,0,0,1,23910000
nn_kernel_gpu,1446,1,1,186797,128,0,0,0,0,1,23910000
nn_kernel_gpu_mem,41392,1,1,186797,128,191280000,95640000,95640000,191280000,1,23910000
nn_kernel_cpu,17618,0,1,1,64,0,0,0,0,1,23920000
nn_kernel_gpu,1449,1,1,186875,128,0,0,0,0,1,23920000
nn_kernel_gpu_mem,38216,1,1,186875,128,191360000,95680000,95680000,191360000,1,23920000
nn_kernel_cpu,8312,0,1,1,64,0,0,0,0,1,23930000
nn_kernel_gpu,1441,1,1,186954,128,0,0,0,0,1,23930000
nn_kernel_gpu_mem,41689,1,1,186954,128,191440000,95720000,95720000,191440000,1,23930000
nn_kernel_cpu,18893,0,1,1,64,0,0,0,0,1,23940000
nn_kernel_gpu,1446,1,1,187032,128,0,0,0,0,1,23940000
nn_kernel_gpu_mem,36882,1,1,187032,128,191520000,95760000,95760000,191520000,1,23940000
nn_kernel_cpu,17503,0,1,1,64,0,0,0,0,1,23950000
nn_kernel_gpu,1450,1,1,187110,128,0,0,0,0,1,23950000
nn_kernel_gpu_mem,34590,1,1,187110,128,191600000,95800000,95800000,191600000,1,23950000
nn_kernel_cpu,24471,0,1,1,64,0,0,0,0,1,23960000
nn_kernel_gpu,1478,1,1,187188,128,0,0,0,0,1,23960000
nn_kernel_gpu_mem,38057,1,1,187188,128,191680000,95840000,95840000,191680000,1,23960000
nn_kernel_cpu,18924,0,1,1,64,0,0,0,0,1,23970000
nn_kernel_gpu,1450,1,1,187266,128,0,0,0,0,1,23970000
nn_kernel_gpu_mem,38402,1,1,187266,128,191760000,95880000,95880000,191760000,1,23970000
nn_kernel_cpu,41435,0,1,1,64,0,0,0,0,1,23980000
nn_kernel_gpu,1446,1,1,187344,128,0,0,0,0,1,23980000
nn_kernel_gpu_mem,35709,1,1,187344,128,191840000,95920000,95920000,191840000,1,23980000
nn_kernel_cpu,29483,0,1,1,64,0,0,0,0,1,23990000
nn_kernel_gpu,1441,1,1,187422,128,0,0,0,0,1,23990000
nn_kernel_gpu_mem,39129,1,1,187422,128,191920000,95960000,95960000,191920000,1,23990000
nn_kernel_cpu,17273,0,1,1,64,0,0,0,0,1,24000000
nn_kernel_gpu,1445,1,1,187500,128,0,0,0,0,1,24000000
nn_kernel_gpu_mem,38692,1,1,187500,128,192000000,96000000,96000000,192000000,1,24000000
nn_kernel_cpu,7853,0,1,1,64,0,0,0,0,1,2400000
nn_kernel_gpu,196,1,1,18750,128,0,0,0,0,1,2400000
nn_kernel_gpu_mem,3324,1,1,18750,128,19200000,9600000,9600000,19200000,1,2400000
nn_kernel_cpu,28595,0,1,1,64,0,0,0,0,1,240000
nn_kernel_gpu,68,1,1,1875,128,0,0,0,0,1,240000
nn_kernel_gpu_mem,839,1,1,1875,128,1920000,960000,960000,1920000,1,240000
nn_kernel_cpu,25063,0,1,1,64,0,0,0,0,1,24010000
nn_kernel_gpu,1436,1,1,187579,128,0,0,0,0,1,24010000
nn_kernel_gpu_mem,33371,1,1,187579,128,192080000,96040000,96040000,192080000,1,24010000
nn_kernel_cpu,28451,0,1,1,64,0,0,0,0,1,24020000
nn_kernel_gpu,1453,1,1,187657,128,0,0,0,0,1,24020000
nn_kernel_gpu_mem,38478,1,1,187657,128,192160000,96080000,96080000,192160000,1,24020000
nn_kernel_cpu,10723,0,1,1,64,0,0,0,0,1,24030000
nn_kernel_gpu,1448,1,1,187735,128,0,0,0,0,1,24030000
nn_kernel_gpu_mem,40590,1,1,187735,128,192240000,96120000,96120000,192240000,1,24030000
nn_kernel_cpu,24392,0,1,1,64,0,0,0,0,1,24040000
nn_kernel_gpu,1456,1,1,187813,128,0,0,0,0,1,24040000
nn_kernel_gpu_mem,38585,1,1,187813,128,192320000,96160000,96160000,192320000,1,24040000
nn_kernel_cpu,21470,0,1,1,64,0,0,0,0,1,24050000
nn_kernel_gpu,1453,1,1,187891,128,0,0,0,0,1,24050000
nn_kernel_gpu_mem,41670,1,1,187891,128,192400000,96200000,96200000,192400000,1,24050000
nn_kernel_cpu,20463,0,1,1,64,0,0,0,0,1,24060000
nn_kernel_gpu,1439,1,1,187969,128,0,0,0,0,1,24060000
nn_kernel_gpu_mem,32613,1,1,187969,128,192480000,96240000,96240000,192480000,1,24060000
nn_kernel_cpu,28126,0,1,1,64,0,0,0,0,1,24070000
nn_kernel_gpu,1470,1,1,188047,128,0,0,0,0,1,24070000
nn_kernel_gpu_mem,34953,1,1,188047,128,192560000,96280000,96280000,192560000,1,24070000
nn_kernel_cpu,16106,0,1,1,64,0,0,0,0,1,24080000
nn_kernel_gpu,1438,1,1,188125,128,0,0,0,0,1,24080000
nn_kernel_gpu_mem,40850,1,1,188125,128,192640000,96320000,96320000,192640000,1,24080000
nn_kernel_cpu,21222,0,1,1,64,0,0,0,0,1,24090000
nn_kernel_gpu,1459,1,1,188204,128,0,0,0,0,1,24090000
nn_kernel_gpu_mem,38057,1,1,188204,128,192720000,96360000,96360000,192720000,1,24090000
nn_kernel_cpu,26292,0,1,1,64,0,0,0,0,1,24100000
nn_kernel_gpu,1457,1,1,188282,128,0,0,0,0,1,24100000
nn_kernel_gpu_mem,37717,1,1,188282,128,192800000,96400000,96400000,192800000,1,24100000
nn_kernel_cpu,6840,0,1,1,64,0,0,0,0,1,2410000
nn_kernel_gpu,193,1,1,18829,128,0,0,0,0,1,2410000
nn_kernel_gpu_mem,3798,1,1,18829,128,19280000,9640000,9640000,19280000,1,2410000
nn_kernel_cpu,17632,0,1,1,64,0,0,0,0,1,24110000
nn_kernel_gpu,1444,1,1,188360,128,0,0,0,0,1,24110000
nn_kernel_gpu_mem,33082,1,1,188360,128,192880000,96440000,96440000,192880000,1,24110000
nn_kernel_cpu,35508,0,1,1,64,0,0,0,0,1,24120000
nn_kernel_gpu,1437,1,1,188438,128,0,0,0,0,1,24120000
nn_kernel_gpu_mem,32388,1,1,188438,128,192960000,96480000,96480000,192960000,1,24120000
nn_kernel_cpu,7875,0,1,1,64,0,0,0,0,1,24130000
nn_kernel_gpu,1449,1,1,188516,128,0,0,0,0,1,24130000
nn_kernel_gpu_mem,40059,1,1,188516,128,193040000,96520000,96520000,193040000,1,24130000
nn_kernel_cpu,25237,0,1,1,64,0,0,0,0,1,24140000
nn_kernel_gpu,1447,1,1,188594,128,0,0,0,0,1,24140000
nn_kernel_gpu_mem,29579,1,1,188594,128,193120000,96560000,96560000,193120000,1,24140000
nn_kernel_cpu,26712,0,1,1,64,0,0,0,0,1,24150000
nn_kernel_gpu,1438,1,1,188672,128,0,0,0,0,1,24150000
nn_kernel_gpu_mem,33968,1,1,188672,128,193200000,96600000,96600000,193200000,1,24150000
nn_kernel_cpu,29286,0,1,1,64,0,0,0,0,1,24160000
nn_kernel_gpu,1440,1,1,188750,128,0,0,0,0,1,24160000
nn_kernel_gpu_mem,33944,1,1,188750,128,193280000,96640000,96640000,193280000,1,24160000
nn_kernel_cpu,13287,0,1,1,64,0,0,0,0,1,24170000
nn_kernel_gpu,1436,1,1,188829,128,0,0,0,0,1,24170000
nn_kernel_gpu_mem,28346,1,1,188829,128,193360000,96680000,96680000,193360000,1,24170000
nn_kernel_cpu,30687,0,1,1,64,0,0,0,0,1,24180000
nn_kernel_gpu,1443,1,1,188907,128,0,0,0,0,1,24180000
nn_kernel_gpu_mem,39906,1,1,188907,128,193440000,96720000,96720000,193440000,1,24180000
nn_kernel_cpu,12900,0,1,1,64,0,0,0,0,1,24190000
nn_kernel_gpu,1473,1,1,188985,128,0,0,0,0,1,24190000
nn_kernel_gpu_mem,38073,1,1,188985,128,193520000,96760000,96760000,193520000,1,24190000
nn_kernel_cpu,33161,0,1,1,64,0,0,0,0,1,24200000
nn_kernel_gpu,1452,1,1,189063,128,0,0,0,0,1,24200000
nn_kernel_gpu_mem,39515,1,1,189063,128,193600000,96800000,96800000,193600000,1,24200000
nn_kernel_cpu,5125,0,1,1,64,0,0,0,0,1,2420000
nn_kernel_gpu,181,1,1,18907,128,0,0,0,0,1,2420000
nn_kernel_gpu_mem,4047,1,1,18907,128,19360000,9680000,9680000,19360000,1,2420000
nn_kernel_cpu,51565,0,1,1,64,0,0,0,0,1,24210000
nn_kernel_gpu,1451,1,1,189141,128,0,0,0,0,1,24210000
nn_kernel_gpu_mem,41213,1,1,189141,128,193680000,96840000,96840000,193680000,1,24210000
nn_kernel_cpu,10087,0,1,1,64,0,0,0,0,1,24220000
nn_kernel_gpu,1458,1,1,189219,128,0,0,0,0,1,24220000
nn_kernel_gpu_mem,32240,1,1,189219,128,193760000,96880000,96880000,193760000,1,24220000
nn_kernel_cpu,11724,0,1,1,64,0,0,0,0,1,24230000
nn_kernel_gpu,1438,1,1,189297,128,0,0,0,0,1,24230000
nn_kernel_gpu_mem,38144,1,1,189297,128,193840000,96920000,96920000,193840000,1,24230000
nn_kernel_cpu,25992,0,1,1,64,0,0,0,0,1,24240000
nn_kernel_gpu,1458,1,1,189375,128,0,0,0,0,1,24240000
nn_kernel_gpu_mem,38868,1,1,189375,128,193920000,96960000,96960000,193920000,1,24240000
nn_kernel_cpu,27185,0,1,1,64,0,0,0,0,1,24250000
nn_kernel_gpu,1452,1,1,189454,128,0,0,0,0,1,24250000
nn_kernel_gpu_mem,40826,1,1,189454,128,194000000,97000000,97000000,194000000,1,24250000
nn_kernel_cpu,39850,0,1,1,64,0,0,0,0,1,24260000
nn_kernel_gpu,1458,1,1,189532,128,0,0,0,0,1,24260000
nn_kernel_gpu_mem,29355,1,1,189532,128,194080000,97040000,97040000,194080000,1,24260000
nn_kernel_cpu,9840,0,1,1,64,0,0,0,0,1,24270000
nn_kernel_gpu,1455,1,1,189610,128,0,0,0,0,1,24270000
nn_kernel_gpu_mem,41204,1,1,189610,128,194160000,97080000,97080000,194160000,1,24270000
nn_kernel_cpu,9310,0,1,1,64,0,0,0,0,1,24280000
nn_kernel_gpu,1450,1,1,189688,128,0,0,0,0,1,24280000
nn_kernel_gpu_mem,32413,1,1,189688,128,194240000,97120000,97120000,194240000,1,24280000
nn_kernel_cpu,12590,0,1,1,64,0,0,0,0,1,24290000
nn_kernel_gpu,1484,1,1,189766,128,0,0,0,0,1,24290000
nn_kernel_gpu_mem,38758,1,1,189766,128,194320000,97160000,97160000,194320000,1,24290000
nn_kernel_cpu,13471,0,1,1,64,0,0,0,0,1,24300000
nn_kernel_gpu,1455,1,1,189844,128,0,0,0,0,1,24300000
nn_kernel_gpu_mem,39265,1,1,189844,128,194400000,97200000,97200000,194400000,1,24300000
nn_kernel_cpu,10941,0,1,1,64,0,0,0,0,1,2430000
nn_kernel_gpu,200,1,1,18985,128,0,0,0,0,1,2430000
nn_kernel_gpu_mem,9472,1,1,18985,128,19440000,9720000,9720000,19440000,1,2430000
nn_kernel_cpu,5754,0,1,1,64,0,0,0,0,1,24310000
nn_kernel_gpu,1454,1,1,189922,128,0,0,0,0,1,24310000
nn_kernel_gpu_mem,35153,1,1,189922,128,194480000,97240000,97240000,194480000,1,24310000
nn_kernel_cpu,17553,0,1,1,64,0,0,0,0,1,24320000
nn_kernel_gpu,1467,1,1,190000,128,0,0,0,0,1,24320000
nn_kernel_gpu_mem,38296,1,1,190000,128,194560000,97280000,97280000,194560000,1,24320000
nn_kernel_cpu,22613,0,1,1,64,0,0,0,0,1,24330000
nn_kernel_gpu,1477,1,1,190079,128,0,0,0,0,1,24330000
nn_kernel_gpu_mem,43820,1,1,190079,128,194640000,97320000,97320000,194640000,1,24330000
nn_kernel_cpu,9469,0,1,1,64,0,0,0,0,1,24340000
nn_kernel_gpu,1454,1,1,190157,128,0,0,0,0,1,24340000
nn_kernel_gpu_mem,39082,1,1,190157,128,194720000,97360000,97360000,194720000,1,24340000
nn_kernel_cpu,35685,0,1,1,64,0,0,0,0,1,24350000
nn_kernel_gpu,1453,1,1,190235,128,0,0,0,0,1,24350000
nn_kernel_gpu_mem,41696,1,1,190235,128,194800000,97400000,97400000,194800000,1,24350000
nn_kernel_cpu,14502,0,1,1,64,0,0,0,0,1,24360000
nn_kernel_gpu,1454,1,1,190313,128,0,0,0,0,1,24360000
nn_kernel_gpu_mem,40897,1,1,190313,128,194880000,97440000,97440000,194880000,1,24360000
nn_kernel_cpu,24760,0,1,1,64,0,0,0,0,1,24370000
nn_kernel_gpu,1469,1,1,190391,128,0,0,0,0,1,24370000
nn_kernel_gpu_mem,40825,1,1,190391,128,194960000,97480000,97480000,194960000,1,24370000
nn_kernel_cpu,35787,0,1,1,64,0,0,0,0,1,24380000
nn_kernel_gpu,1492,1,1,190469,128,0,0,0,0,1,24380000
nn_kernel_gpu_mem,40258,1,1,190469,128,195040000,97520000,97520000,195040000,1,24380000
nn_kernel_cpu,13114,0,1,1,64,0,0,0,0,1,24390000
nn_kernel_gpu,1461,1,1,190547,128,0,0,0,0,1,24390000
nn_kernel_gpu_mem,38411,1,1,190547,128,195120000,97560000,97560000,195120000,1,24390000
nn_kernel_cpu,14658,0,1,1,64,0,0,0,0,1,24400000
nn_kernel_gpu,1462,1,1,190625,128,0,0,0,0,1,24400000
nn_kernel_gpu_mem,39286,1,1,190625,128,195200000,97600000,97600000,195200000,1,24400000
nn_kernel_cpu,7160,0,1,1,64,0,0,0,0,1,2440000
nn_kernel_gpu,202,1,1,19063,128,0,0,0,0,1,2440000
nn_kernel_gpu_mem,11704,1,1,19063,128,19520000,9760000,9760000,19520000,1,2440000
nn_kernel_cpu,25002,0,1,1,64,0,0,0,0,1,24410000
nn_kernel_gpu,1458,1,1,190704,128,0,0,0,0,1,24410000
nn_kernel_gpu_mem,37219,1,1,190704,128,195280000,97640000,97640000,195280000,1,24410000
nn_kernel_cpu,15684,0,1,1,64,0,0,0,0,1,24420000
nn_kernel_gpu,1466,1,1,190782,128,0,0,0,0,1,24420000
nn_kernel_gpu_mem,35115,1,1,190782,128,195360000,97680000,97680000,195360000,1,24420000
nn_kernel_cpu,25463,0,1,1,64,0,0,0,0,1,24430000
nn_kernel_gpu,1495,1,1,190860,128,0,0,0,0,1,24430000
nn_kernel_gpu_mem,44736,1,1,190860,128,195440000,97720000,97720000,195440000,1,24430000
nn_kernel_cpu,11331,0,1,1,64,0,0,0,0,1,24440000
nn_kernel_gpu,1460,1,1,190938,128,0,0,0,0,1,24440000
nn_kernel_gpu_mem,41861,1,1,190938,128,195520000,97760000,97760000,195520000,1,24440000
nn_kernel_cpu,11397,0,1,1,64,0,0,0,0,1,24450000
nn_kernel_gpu,1456,1,1,191016,128,0,0,0,0,1,24450000
nn_kernel_gpu_mem,43300,1,1,191016,128,195600000,97800000,97800000,195600000,1,24450000
nn_kernel_cpu,18534,0,1,1,64,0,0,0,0,1,24460000
nn_kernel_gpu,1457,1,1,191094,128,0,0,0,0,1,24460000
nn_kernel_gpu_mem,29076,1,1,191094,128,195680000,97840000,97840000,195680000,1,24460000
nn_kernel_cpu,22225,0,1,1,64,0,0,0,0,1,24470000
nn_kernel_gpu,1455,1,1,191172,128,0,0,0,0,1,24470000
nn_kernel_gpu_mem,39099,1,1,191172,128,195760000,97880000,97880000,195760000,1,24470000
nn_kernel_cpu,14784,0,1,1,64,0,0,0,0,1,24480000
nn_kernel_gpu,1452,1,1,191250,128,0,0,0,0,1,24480000
nn_kernel_gpu_mem,39210,1,1,191250,128,195840000,97920000,97920000,195840000,1,24480000
nn_kernel_cpu,30737,0,1,1,64,0,0,0,0,1,24490000
nn_kernel_gpu,1469,1,1,191329,128,0,0,0,0,1,24490000
nn_kernel_gpu_mem,38403,1,1,191329,128,195920000,97960000,97960000,195920000,1,24490000
nn_kernel_cpu,18541,0,1,1,64,0,0,0,0,1,24500000
nn_kernel_gpu,1458,1,1,191407,128,0,0,0,0,1,24500000
nn_kernel_gpu_mem,42559,1,1,191407,128,196000000,98000000,98000000,196000000,1,24500000
nn_kernel_cpu,6640,0,1,1,64,0,0,0,0,1,2450000
nn_kernel_gpu,205,1,1,19141,128,0,0,0,0,1,2450000
nn_kernel_gpu_mem,3951,1,1,19141,128,19600000,9800000,9800000,19600000,1,2450000
nn_kernel_cpu,29982,0,1,1,64,0,0,0,0,1,24510000
nn_kernel_gpu,1454,1,1,191485,128,0,0,0,0,1,24510000
nn_kernel_gpu_mem,29103,1,1,191485,128,196080000,98040000,98040000,196080000,1,24510000
nn_kernel_cpu,9505,0,1,1,64,0,0,0,0,1,24520000
nn_kernel_gpu,1487,1,1,191563,128,0,0,0,0,1,24520000
nn_kernel_gpu_mem,39003,1,1,191563,128,196160000,98080000,98080000,196160000,1,24520000
nn_kernel_cpu,43465,0,1,1,64,0,0,0,0,1,24530000
nn_kernel_gpu,1468,1,1,191641,128,0,0,0,0,1,24530000
nn_kernel_gpu_mem,33292,1,1,191641,128,196240000,98120000,98120000,196240000,1,24530000
nn_kernel_cpu,19772,0,1,1,64,0,0,0,0,1,24540000
nn_kernel_gpu,1494,1,1,191719,128,0,0,0,0,1,24540000
nn_kernel_gpu_mem,39360,1,1,191719,128,196320000,98160000,98160000,196320000,1,24540000
nn_kernel_cpu,12880,0,1,1,64,0,0,0,0,1,24550000
nn_kernel_gpu,1481,1,1,191797,128,0,0,0,0,1,24550000
nn_kernel_gpu_mem,40100,1,1,191797,128,196400000,98200000,98200000,196400000,1,24550000
nn_kernel_cpu,25424,0,1,1,64,0,0,0,0,1,24560000
nn_kernel_gpu,1470,1,1,191875,128,0,0,0,0,1,24560000
nn_kernel_gpu_mem,35522,1,1,191875,128,196480000,98240000,98240000,196480000,1,24560000
nn_kernel_cpu,14364,0,1,1,64,0,0,0,0,1,24570000
nn_kernel_gpu,1463,1,1,191954,128,0,0,0,0,1,24570000
nn_kernel_gpu_mem,39699,1,1,191954,128,196560000,98280000,98280000,196560000,1,24570000
nn_kernel_cpu,17089,0,1,1,64,0,0,0,0,1,24580000
nn_kernel_gpu,1465,1,1,192032,128,0,0,0,0,1,24580000
nn_kernel_gpu_mem,41127,1,1,192032,128,196640000,98320000,98320000,196640000,1,24580000
nn_kernel_cpu,21959,0,1,1,64,0,0,0,0,1,24590000
nn_kernel_gpu,1480,1,1,192110,128,0,0,0,0,1,24590000
nn_kernel_gpu_mem,39535,1,1,192110,128,196720000,98360000,98360000,196720000,1,24590000
nn_kernel_cpu,22467,0,1,1,64,0,0,0,0,1,24600000
nn_kernel_gpu,1468,1,1,192188,128,0,0,0,0,1,24600000
nn_kernel_gpu_mem,41041,1,1,192188,128,196800000,98400000,98400000,196800000,1,24600000
nn_kernel_cpu,19016,0,1,1,64,0,0,0,0,1,2460000
nn_kernel_gpu,195,1,1,19219,128,0,0,0,0,1,2460000
nn_kernel_gpu_mem,6157,1,1,19219,128,19680000,9840000,9840000,19680000,1,2460000
nn_kernel_cpu,20758,0,1,1,64,0,0,0,0,1,24610000
nn_kernel_gpu,1477,1,1,192266,128,0,0,0,0,1,24610000
nn_kernel_gpu_mem,39804,1,1,192266,128,196880000,98440000,98440000,196880000,1,24610000
nn_kernel_cpu,18801,0,1,1,64,0,0,0,0,1,24620000
nn_kernel_gpu,1457,1,1,192344,128,0,0,0,0,1,24620000
nn_kernel_gpu_mem,36200,1,1,192344,128,196960000,98480000,98480000,196960000,1,24620000
nn_kernel_cpu,20415,0,1,1,64,0,0,0,0,1,24630000
nn_kernel_gpu,1474,1,1,192422,128,0,0,0,0,1,24630000
nn_kernel_gpu_mem,33403,1,1,192422,128,197040000,98520000,98520000,197040000,1,24630000
nn_kernel_cpu,13848,0,1,1,64,0,0,0,0,1,24640000
nn_kernel_gpu,1474,1,1,192500,128,0,0,0,0,1,24640000
nn_kernel_gpu_mem,38380,1,1,192500,128,197120000,98560000,98560000,197120000,1,24640000
nn_kernel_cpu,9198,0,1,1,64,0,0,0,0,1,24650000
nn_kernel_gpu,1477,1,1,192579,128,0,0,0,0,1,24650000
nn_kernel_gpu_mem,38473,1,1,192579,128,197200000,98600000,98600000,197200000,1,24650000
nn_kernel_cpu,18172,0,1,1,64,0,0,0,0,1,24660000
nn_kernel_gpu,1493,1,1,192657,128,0,0,0,0,1,24660000
nn_kernel_gpu_mem,34808,1,1,192657,128,197280000,98640000,98640000,197280000,1,24660000
nn_kernel_cpu,8565,0,1,1,64,0,0,0,0,1,24670000
nn_kernel_gpu,1464,1,1,192735,128,0,0,0,0,1,24670000
nn_kernel_gpu_mem,36378,1,1,192735,128,197360000,98680000,98680000,197360000,1,24670000
nn_kernel_cpu,16462,0,1,1,64,0,0,0,0,1,24680000
nn_kernel_gpu,1491,1,1,192813,128,0,0,0,0,1,24680000
nn_kernel_gpu_mem,38038,1,1,192813,128,197440000,98720000,98720000,197440000,1,24680000
nn_kernel_cpu,28284,0,1,1,64,0,0,0,0,1,24690000
nn_kernel_gpu,1483,1,1,192891,128,0,0,0,0,1,24690000
nn_kernel_gpu_mem,39153,1,1,192891,128,197520000,98760000,98760000,197520000,1,24690000
nn_kernel_cpu,23040,0,1,1,64,0,0,0,0,1,24700000
nn_kernel_gpu,1489,1,1,192969,128,0,0,0,0,1,24700000
nn_kernel_gpu_mem,38898,1,1,192969,128,197600000,98800000,98800000,197600000,1,24700000
nn_kernel_cpu,25356,0,1,1,64,0,0,0,0,1,2470000
nn_kernel_gpu,195,1,1,19297,128,0,0,0,0,1,2470000
nn_kernel_gpu_mem,3719,1,1,19297,128,19760000,9880000,9880000,19760000,1,2470000
nn_kernel_cpu,29024,0,1,1,64,0,0,0,0,1,24710000
nn_kernel_gpu,1478,1,1,193047,128,0,0,0,0,1,24710000
nn_kernel_gpu_mem,33981,1,1,193047,128,197680000,98840000,98840000,197680000,1,24710000
nn_kernel_cpu,18715,0,1,1,64,0,0,0,0,1,24720000
nn_kernel_gpu,1479,1,1,193125,128,0,0,0,0,1,24720000
nn_kernel_gpu_mem,35189,1,1,193125,128,197760000,98880000,98880000,197760000,1,24720000
nn_kernel_cpu,16161,0,1,1,64,0,0,0,0,1,24730000
nn_kernel_gpu,1476,1,1,193204,128,0,0,0,0,1,24730000
nn_kernel_gpu_mem,41724,1,1,193204,128,197840000,98920000,98920000,197840000,1,24730000
nn_kernel_cpu,17336,0,1,1,64,0,0,0,0,1,24740000
nn_kernel_gpu,1474,1,1,193282,128,0,0,0,0,1,24740000
nn_kernel_gpu_mem,39249,1,1,193282,128,197920000,98960000,98960000,197920000,1,24740000
nn_kernel_cpu,15363,0,1,1,64,0,0,0,0,1,24750000
nn_kernel_gpu,1482,1,1,193360,128,0,0,0,0,1,24750000
nn_kernel_gpu_mem,41054,1,1,193360,128,198000000,99000000,99000000,198000000,1,24750000
nn_kernel_cpu,13309,0,1,1,64,0,0,0,0,1,24760000
nn_kernel_gpu,1508,1,1,193438,128,0,0,0,0,1,24760000
nn_kernel_gpu_mem,42511,1,1,193438,128,198080000,99040000,99040000,198080000,1,24760000
nn_kernel_cpu,24296,0,1,1,64,0,0,0,0,1,24770000
nn_kernel_gpu,1474,1,1,193516,128,0,0,0,0,1,24770000
nn_kernel_gpu_mem,33128,1,1,193516,128,198160000,99080000,99080000,198160000,1,24770000
nn_kernel_cpu,25215,0,1,1,64,0,0,0,0,1,24780000
nn_kernel_gpu,1483,1,1,193594,128,0,0,0,0,1,24780000
nn_kernel_gpu_mem,35430,1,1,193594,128,198240000,99120000,99120000,198240000,1,24780000
nn_kernel_cpu,19626,0,1,1,64,0,0,0,0,1,24790000
nn_kernel_gpu,1477,1,1,193672,128,0,0,0,0,1,24790000
nn_kernel_gpu_mem,40892,1,1,193672,128,198320000,99160000,99160000,198320000,1,24790000
nn_kernel_cpu,24777,0,1,1,64,0,0,0,0,1,24800000
nn_kernel_gpu,1500,1,1,193750,128,0,0,0,0,1,24800000
nn_kernel_gpu_mem,33095,1,1,193750,128,198400000,99200000,99200000,198400000,1,24800000
nn_kernel_cpu,4758,0,1,1,64,0,0,0,0,1,2480000
nn_kernel_gpu,188,1,1,19375,128,0,0,0,0,1,2480000
nn_kernel_gpu_mem,4226,1,1,19375,128,19840000,9920000,9920000,19840000,1,2480000
nn_kernel_cpu,8690,0,1,1,64,0,0,0,0,1,24810000
nn_kernel_gpu,1504,1,1,193829,128,0,0,0,0,1,24810000
nn_kernel_gpu_mem,41480,1,1,193829,128,198480000,99240000,99240000,198480000,1,24810000
nn_kernel_cpu,11928,0,1,1,64,0,0,0,0,1,24820000
nn_kernel_gpu,1500,1,1,193907,128,0,0,0,0,1,24820000
nn_kernel_gpu_mem,39395,1,1,193907,128,198560000,99280000,99280000,198560000,1,24820000
nn_kernel_cpu,26756,0,1,1,64,0,0,0,0,1,24830000
nn_kernel_gpu,1506,1,1,193985,128,0,0,0,0,1,24830000
nn_kernel_gpu_mem,41509,1,1,193985,128,198640000,99320000,99320000,198640000,1,24830000
nn_kernel_cpu,8373,0,1,1,64,0,0,0,0,1,24840000
nn_kernel_gpu,1482,1,1,194063,128,0,0,0,0,1,24840000
nn_kernel_gpu_mem,37834,1,1,194063,128,198720000,99360000,99360000,198720000,1,24840000
nn_kernel_cpu,18692,0,1,1,64,0,0,0,0,1,24850000
nn_kernel_gpu,1488,1,1,194141,128,0,0,0,0,1,24850000
nn_kernel_gpu_mem,39203,1,1,194141,128,198800000,99400000,99400000,198800000,1,24850000
nn_kernel_cpu,27206,0,1,1,64,0,0,0,0,1,24860000
nn_kernel_gpu,1533,1,1,194219,128,0,0,0,0,1,24860000
nn_kernel_gpu_mem,41628,1,1,194219,128,198880000,99440000,99440000,198880000,1,24860000
nn_kernel_cpu,12739,0,1,1,64,0,0,0,0,1,24870000
nn_kernel_gpu,1498,1,1,194297,128,0,0,0,0,1,24870000
nn_kernel_gpu_mem,35502,1,1,194297,128,198960000,99480000,99480000,198960000,1,24870000
nn_kernel_cpu,36422,0,1,1,64,0,0,0,0,1,24880000
nn_kernel_gpu,1482,1,1,194375,128,0,0,0,0,1,24880000
nn_kernel_gpu_mem,32765,1,1,194375,128,199040000,99520000,99520000,199040000,1,24880000
nn_kernel_cpu,21131,0,1,1,64,0,0,0,0,1,24890000
nn_kernel_gpu,1476,1,1,194454,128,0,0,0,0,1,24890000
nn_kernel_gpu_mem,38199,1,1,194454,128,199120000,99560000,99560000,199120000,1,24890000
nn_kernel_cpu,29607,0,1,1,64,0,0,0,0,1,24900000
nn_kernel_gpu,1488,1,1,194532,128,0,0,0,0,1,24900000
nn_kernel_gpu_mem,33376,1,1,194532,128,199200000,99600000,99600000,199200000,1,24900000
nn_kernel_cpu,27819,0,1,1,64,0,0,0,0,1,2490000
nn_kernel_gpu,199,1,1,19454,128,0,0,0,0,1,2490000
nn_kernel_gpu_mem,3909,1,1,19454,128,19920000,9960000,9960000,19920000,1,2490000
nn_kernel_cpu,11379,0,1,1,64,0,0,0,0,1,24910000
nn_kernel_gpu,1544,1,1,194610,128,0,0,0,0,1,24910000
nn_kernel_gpu_mem,38053,1,1,194610,128,199280000,99640000,99640000,199280000,1,24910000
nn_kernel_cpu,17301,0,1,1,64,0,0,0,0,1,24920000
nn_kernel_gpu,1478,1,1,194688,128,0,0,0,0,1,24920000
nn_kernel_gpu_mem,32863,1,1,194688,128,199360000,99680000,99680000,199360000,1,24920000
nn_kernel_cpu,10146,0,1,1,64,0,0,0,0,1,24930000
nn_kernel_gpu,1511,1,1,194766,128,0,0,0,0,1,24930000
nn_kernel_gpu_mem,35197,1,1,194766,128,199440000,99720000,99720000,199440000,1,24930000
nn_kernel_cpu,13228,0,1,1,64,0,0,0,0,1,24940000
nn_kernel_gpu,1482,1,1,194844,128,0,0,0,0,1,24940000
nn_kernel_gpu_mem,40459,1,1,194844,128,199520000,99760000,99760000,199520000,1,24940000
nn_kernel_cpu,15178,0,1,1,64,0,0,0,0,1,24950000
nn_kernel_gpu,1492,1,1,194922,128,0,0,0,0,1,24950000
nn_kernel_gpu_mem,39449,1,1,194922,128,199600000,99800000,99800000,199600000,1,24950000
nn_kernel_cpu,13688,0,1,1,64,0,0,0,0,1,24960000
nn_kernel_gpu,1490,1,1,195000,128,0,0,0,0,1,24960000
nn_kernel_gpu_mem,33486,1,1,195000,128,199680000,99840000,99840000,199680000,1,24960000
nn_kernel_cpu,31191,0,1,1,64,0,0,0,0,1,24970000
nn_kernel_gpu,1488,1,1,195079,128,0,0,0,0,1,24970000
nn_kernel_gpu_mem,33992,1,1,195079,128,199760000,99880000,99880000,199760000,1,24970000
nn_kernel_cpu,19006,0,1,1,64,0,0,0,0,1,24980000
nn_kernel_gpu,1488,1,1,195157,128,0,0,0,0,1,24980000
nn_kernel_gpu_mem,40454,1,1,195157,128,199840000,99920000,99920000,199840000,1,24980000
nn_kernel_cpu,24871,0,1,1,64,0,0,0,0,1,24990000
nn_kernel_gpu,1492,1,1,195235,128,0,0,0,0,1,24990000
nn_kernel_gpu_mem,39468,1,1,195235,128,199920000,99960000,99960000,199920000,1,24990000
nn_kernel_cpu,14922,0,1,1,64,0,0,0,0,1,25000000
nn_kernel_gpu,1495,1,1,195313,128,0,0,0,0,1,25000000
nn_kernel_gpu_mem,40176,1,1,195313,128,200000000,100000000,100000000,200000000,1,25000000
nn_kernel_cpu,19111,0,1,1,64,0,0,0,0,1,2500000
nn_kernel_gpu,202,1,1,19532,128,0,0,0,0,1,2500000
nn_kernel_gpu_mem,9273,1,1,19532,128,20000000,10000000,10000000,20000000,1,2500000
nn_kernel_cpu,31331,0,1,1,64,0,0,0,0,1,250000
nn_kernel_gpu,73,1,1,1954,128,0,0,0,0,1,250000
nn_kernel_gpu_mem,876,1,1,1954,128,2000000,1000000,1000000,2000000,1,250000
nn_kernel_cpu,22589,0,1,1,64,0,0,0,0,1,25010000
nn_kernel_gpu,1493,1,1,195391,128,0,0,0,0,1,25010000
nn_kernel_gpu_mem,39859,1,1,195391,128,200080000,100040000,100040000,200080000,1,25010000
nn_kernel_cpu,24382,0,1,1,64,0,0,0,0,1,25020000
nn_kernel_gpu,1495,1,1,195469,128,0,0,0,0,1,25020000
nn_kernel_gpu_mem,35483,1,1,195469,128,200160000,100080000,100080000,200160000,1,25020000
nn_kernel_cpu,17317,0,1,1,64,0,0,0,0,1,25030000
nn_kernel_gpu,1498,1,1,195547,128,0,0,0,0,1,25030000
nn_kernel_gpu_mem,37027,1,1,195547,128,200240000,100120000,100120000,200240000,1,25030000
nn_kernel_cpu,17204,0,1,1,64,0,0,0,0,1,25040000
nn_kernel_gpu,1504,1,1,195625,128,0,0,0,0,1,25040000
nn_kernel_gpu_mem,41692,1,1,195625,128,200320000,100160000,100160000,200320000,1,25040000
nn_kernel_cpu,18295,0,1,1,64,0,0,0,0,1,25050000
nn_kernel_gpu,1501,1,1,195704,128,0,0,0,0,1,25050000
nn_kernel_gpu_mem,45020,1,1,195704,128,200400000,100200000,100200000,200400000,1,25050000
nn_kernel_cpu,15051,0,1,1,64,0,0,0,0,1,25060000
nn_kernel_gpu,1487,1,1,195782,128,0,0,0,0,1,25060000
nn_kernel_gpu_mem,34293,1,1,195782,128,200480000,100240000,100240000,200480000,1,25060000
nn_kernel_cpu,17501,0,1,1,64,0,0,0,0,1,25070000
nn_kernel_gpu,1487,1,1,195860,128,0,0,0,0,1,25070000
nn_kernel_gpu_mem,33754,1,1,195860,128,200560000,100280000,100280000,200560000,1,25070000
nn_kernel_cpu,16720,0,1,1,64,0,0,0,0,1,25080000
nn_kernel_gpu,1492,1,1,195938,128,0,0,0,0,1,25080000
nn_kernel_gpu_mem,38204,1,1,195938,128,200640000,100320000,100320000,200640000,1,25080000
nn_kernel_cpu,8343,0,1,1,64,0,0,0,0,1,25090000
nn_kernel_gpu,1496,1,1,196016,128,0,0,0,0,1,25090000
nn_kernel_gpu_mem,39717,1,1,196016,128,200720000,100360000,100360000,200720000,1,25090000
nn_kernel_cpu,6666,0,1,1,64,0,0,0,0,1,25100000
nn_kernel_gpu,1498,1,1,196094,128,0,0,0,0,1,25100000
nn_kernel_gpu_mem,39140,1,1,196094,128,200800000,100400000,100400000,200800000,1,25100000
nn_kernel_cpu,12428,0,1,1,64,0,0,0,0,1,2510000
nn_kernel_gpu,199,1,1,19610,128,0,0,0,0,1,2510000
nn_kernel_gpu_mem,4168,1,1,19610,128,20080000,10040000,10040000,20080000,1,2510000
nn_kernel_cpu,16650,0,1,1,64,0,0,0,0,1,25110000
nn_kernel_gpu,1490,1,1,196172,128,0,0,0,0,1,25110000
nn_kernel_gpu_mem,38148,1,1,196172,128,200880000,100440000,100440000,200880000,1,25110000
nn_kernel_cpu,22488,0,1,1,64,0,0,0,0,1,25120000
nn_kernel_gpu,1500,1,1,196250,128,0,0,0,0,1,25120000
nn_kernel_gpu_mem,42436,1,1,196250,128,200960000,100480000,100480000,200960000,1,25120000
nn_kernel_cpu,15221,0,1,1,64,0,0,0,0,1,25130000
nn_kernel_gpu,1507,1,1,196329,128,0,0,0,0,1,25130000
nn_kernel_gpu_mem,39730,1,1,196329,128,201040000,100520000,100520000,201040000,1,25130000
nn_kernel_cpu,12130,0,1,1,64,0,0,0,0,1,25140000
nn_kernel_gpu,1500,1,1,196407,128,0,0,0,0,1,25140000
nn_kernel_gpu_mem,40336,1,1,196407,128,201120000,100560000,100560000,201120000,1,25140000
nn_kernel_cpu,15793,0,1,1,64,0,0,0,0,1,25150000
nn_kernel_gpu,1493,1,1,196485,128,0,0,0,0,1,25150000
nn_kernel_gpu_mem,32863,1,1,196485,128,201200000,100600000,100600000,201200000,1,25150000
nn_kernel_cpu,9085,0,1,1,64,0,0,0,0,1,25160000
nn_kernel_gpu,1494,1,1,196563,128,0,0,0,0,1,25160000
nn_kernel_gpu_mem,36334,1,1,196563,128,201280000,100640000,100640000,201280000,1,25160000
nn_kernel_cpu,24530,0,1,1,64,0,0,0,0,1,25170000
nn_kernel_gpu,1520,1,1,196641,128,0,0,0,0,1,25170000
nn_kernel_gpu_mem,54079,1,1,196641,128,201360000,100680000,100680000,201360000,1,25170000
nn_kernel_cpu,52669,0,1,1,64,0,0,0,0,1,25180000
nn_kernel_gpu,1512,1,1,196719,128,0,0,0,0,1,25180000
nn_kernel_gpu_mem,39917,1,1,196719,128,201440000,100720000,100720000,201440000,1,25180000
nn_kernel_cpu,16594,0,1,1,64,0,0,0,0,1,25190000
nn_kernel_gpu,1504,1,1,196797,128,0,0,0,0,1,25190000
nn_kernel_gpu_mem,40738,1,1,196797,128,201520000,100760000,100760000,201520000,1,25190000
nn_kernel_cpu,24928,0,1,1,64,0,0,0,0,1,25200000
nn_kernel_gpu,1511,1,1,196875,128,0,0,0,0,1,25200000
nn_kernel_gpu_mem,39807,1,1,196875,128,201600000,100800000,100800000,201600000,1,25200000
nn_kernel_cpu,5517,0,1,1,64,0,0,0,0,1,2520000
nn_kernel_gpu,194,1,1,19688,128,0,0,0,0,1,2520000
nn_kernel_gpu_mem,4141,1,1,19688,128,20160000,10080000,10080000,20160000,1,2520000
nn_kernel_cpu,14035,0,1,1,64,0,0,0,0,1,25210000
nn_kernel_gpu,1506,1,1,196954,128,0,0,0,0,1,25210000
nn_kernel_gpu_mem,39624,1,1,196954,128,201680000,100840000,100840000,201680000,1,25210000
nn_kernel_cpu,18284,0,1,1,64,0,0,0,0,1,25220000
nn_kernel_gpu,1513,1,1,197032,128,0,0,0,0,1,25220000
nn_kernel_gpu_mem,39638,1,1,197032,128,201760000,100880000,100880000,201760000,1,25220000
nn_kernel_cpu,17973,0,1,1,64,0,0,0,0,1,25230000
nn_kernel_gpu,1524,1,1,197110,128,0,0,0,0,1,25230000
nn_kernel_gpu_mem,39230,1,1,197110,128,201840000,100920000,100920000,201840000,1,25230000
nn_kernel_cpu,23395,0,1,1,64,0,0,0,0,1,25240000
nn_kernel_gpu,1514,1,1,197188,128,0,0,0,0,1,25240000
nn_kernel_gpu_mem,47819,1,1,197188,128,201920000,100960000,100960000,201920000,1,25240000
nn_kernel_cpu,12624,0,1,1,64,0,0,0,0,1,25250000
nn_kernel_gpu,1515,1,1,197266,128,0,0,0,0,1,25250000
nn_kernel_gpu_mem,44321,1,1,197266,128,202000000,101000000,101000000,202000000,1,25250000
nn_kernel_cpu,7444,0,1,1,64,0,0,0,0,1,25260000
nn_kernel_gpu,1516,1,1,197344,128,0,0,0,0,1,25260000
nn_kernel_gpu_mem,39440,1,1,197344,128,202080000,101040000,101040000,202080000,1,25260000
nn_kernel_cpu,10322,0,1,1,64,0,0,0,0,1,25270000
nn_kernel_gpu,1512,1,1,197422,128,0,0,0,0,1,25270000
nn_kernel_gpu_mem,41432,1,1,197422,128,202160000,101080000,101080000,202160000,1,25270000
nn_kernel_cpu,20930,0,1,1,64,0,0,0,0,1,25280000
nn_kernel_gpu,1514,1,1,197500,128,0,0,0,0,1,25280000
nn_kernel_gpu_mem,43937,1,1,197500,128,202240000,101120000,101120000,202240000,1,25280000
nn_kernel_cpu,22131,0,1,1,64,0,0,0,0,1,25290000
nn_kernel_gpu,1524,1,1,197579,128,0,0,0,0,1,25290000
nn_kernel_gpu_mem,44437,1,1,197579,128,202320000,101160000,101160000,202320000,1,25290000
nn_kernel_cpu,24926,0,1,1,64,0,0,0,0,1,25300000
nn_kernel_gpu,1521,1,1,197657,128,0,0,0,0,1,25300000
nn_kernel_gpu_mem,42538,1,1,197657,128,202400000,101200000,101200000,202400000,1,25300000
nn_kernel_cpu,7747,0,1,1,64,0,0,0,0,1,2530000
nn_kernel_gpu,210,1,1,19766,128,0,0,0,0,1,2530000
nn_kernel_gpu_mem,4024,1,1,19766,128,20240000,10120000,10120000,20240000,1,2530000
nn_kernel_cpu,25975,0,1,1,64,0,0,0,0,1,25310000
nn_kernel_gpu,1537,1,1,197735,128,0,0,0,0,1,25310000
nn_kernel_gpu_mem,45050,1,1,197735,128,202480000,101240000,101240000,202480000,1,25310000
nn_kernel_cpu,17553,0,1,1,64,0,0,0,0,1,25320000
nn_kernel_gpu,1534,1,1,197813,128,0,0,0,0,1,25320000
nn_kernel_gpu_mem,43249,1,1,197813,128,202560000,101280000,101280000,202560000,1,25320000
nn_kernel_cpu,16180,0,1,1,64,0,0,0,0,1,25330000
nn_kernel_gpu,1521,1,1,197891,128,0,0,0,0,1,25330000
nn_kernel_gpu_mem,40089,1,1,197891,128,202640000,101320000,101320000,202640000,1,25330000
nn_kernel_cpu,26032,0,1,1,64,0,0,0,0,1,25340000
nn_kernel_gpu,1524,1,1,197969,128,0,0,0,0,1,25340000
nn_kernel_gpu_mem,31970,1,1,197969,128,202720000,101360000,101360000,202720000,1,25340000
nn_kernel_cpu,32883,0,1,1,64,0,0,0,0,1,25350000
nn_kernel_gpu,1517,1,1,198047,128,0,0,0,0,1,25350000
nn_kernel_gpu_mem,39923,1,1,198047,128,202800000,101400000,101400000,202800000,1,25350000
nn_kernel_cpu,19358,0,1,1,64,0,0,0,0,1,25360000
nn_kernel_gpu,1515,1,1,198125,128,0,0,0,0,1,25360000
nn_kernel_gpu_mem,35767,1,1,198125,128,202880000,101440000,101440000,202880000,1,25360000
nn_kernel_cpu,13923,0,1,1,64,0,0,0,0,1,25370000
nn_kernel_gpu,1508,1,1,198204,128,0,0,0,0,1,25370000
nn_kernel_gpu_mem,37791,1,1,198204,128,202960000,101480000,101480000,202960000,1,25370000
nn_kernel_cpu,15614,0,1,1,64,0,0,0,0,1,25380000
nn_kernel_gpu,1519,1,1,198282,128,0,0,0,0,1,25380000
nn_kernel_gpu_mem,36533,1,1,198282,128,203040000,101520000,101520000,203040000,1,25380000
nn_kernel_cpu,23416,0,1,1,64,0,0,0,0,1,25390000
nn_kernel_gpu,1515,1,1,198360,128,0,0,0,0,1,25390000
nn_kernel_gpu_mem,41066,1,1,198360,128,203120000,101560000,101560000,203120000,1,25390000
nn_kernel_cpu,13587,0,1,1,64,0,0,0,0,1,25400000
nn_kernel_gpu,1532,1,1,198438,128,0,0,0,0,1,25400000
nn_kernel_gpu_mem,39359,1,1,198438,128,203200000,101600000,101600000,203200000,1,25400000
nn_kernel_cpu,8211,0,1,1,64,0,0,0,0,1,2540000
nn_kernel_gpu,234,1,1,19844,128,0,0,0,0,1,2540000
nn_kernel_gpu_mem,4270,1,1,19844,128,20320000,10160000,10160000,20320000,1,2540000
nn_kernel_cpu,28799,0,1,1,64,0,0,0,0,1,25410000
nn_kernel_gpu,1528,1,1,198516,128,0,0,0,0,1,25410000
nn_kernel_gpu_mem,40311,1,1,198516,128,203280000,101640000,101640000,203280000,1,25410000
nn_kernel_cpu,18198,0,1,1,64,0,0,0,0,1,25420000
nn_kernel_gpu,1524,1,1,198594,128,0,0,0,0,1,25420000
nn_kernel_gpu_mem,40176,1,1,198594,128,203360000,101680000,101680000,203360000,1,25420000
nn_kernel_cpu,14015,0,1,1,64,0,0,0,0,1,25430000
nn_kernel_gpu,1522,1,1,198672,128,0,0,0,0,1,25430000
nn_kernel_gpu_mem,32664,1,1,198672,128,203440000,101720000,101720000,203440000,1,25430000
nn_kernel_cpu,26476,0,1,1,64,0,0,0,0,1,25440000
nn_kernel_gpu,1517,1,1,198750,128,0,0,0,0,1,25440000
nn_kernel_gpu_mem,40494,1,1,198750,128,203520000,101760000,101760000,203520000,1,25440000
nn_kernel_cpu,12712,0,1,1,64,0,0,0,0,1,25450000
nn_kernel_gpu,1514,1,1,198829,128,0,0,0,0,1,25450000
nn_kernel_gpu_mem,34179,1,1,198829,128,203600000,101800000,101800000,203600000,1,25450000
nn_kernel_cpu,18350,0,1,1,64,0,0,0,0,1,25460000
nn_kernel_gpu,1523,1,1,198907,128,0,0,0,0,1,25460000
nn_kernel_gpu_mem,39966,1,1,198907,128,203680000,101840000,101840000,203680000,1,25460000
nn_kernel_cpu,14658,0,1,1,64,0,0,0,0,1,25470000
nn_kernel_gpu,1536,1,1,198985,128,0,0,0,0,1,25470000
nn_kernel_gpu_mem,47937,1,1,198985,128,203760000,101880000,101880000,203760000,1,25470000
nn_kernel_cpu,9907,0,1,1,64,0,0,0,0,1,25480000
nn_kernel_gpu,1527,1,1,199063,128,0,0,0,0,1,25480000
nn_kernel_gpu_mem,37425,1,1,199063,128,203840000,101920000,101920000,203840000,1,25480000
nn_kernel_cpu,10057,0,1,1,64,0,0,0,0,1,25490000
nn_kernel_gpu,1528,1,1,199141,128,0,0,0,0,1,25490000
nn_kernel_gpu_mem,40984,1,1,199141,128,203920000,101960000,101960000,203920000,1,25490000
nn_kernel_cpu,26362,0,1,1,64,0,0,0,0,1,25500000
nn_kernel_gpu,1529,1,1,199219,128,0,0,0,0,1,25500000
nn_kernel_gpu_mem,40356,1,1,199219,128,204000000,102000000,102000000,204000000,1,25500000
nn_kernel_cpu,22956,0,1,1,64,0,0,0,0,1,2550000
nn_kernel_gpu,186,1,1,19922,128,0,0,0,0,1,2550000
nn_kernel_gpu_mem,4378,1,1,19922,128,20400000,10200000,10200000,20400000,1,2550000
nn_kernel_cpu,37070,0,1,1,64,0,0,0,0,1,25510000
nn_kernel_gpu,1528,1,1,199297,128,0,0,0,0,1,25510000
nn_kernel_gpu_mem,41798,1,1,199297,128,204080000,102040000,102040000,204080000,1,25510000
nn_kernel_cpu,28406,0,1,1,64,0,0,0,0,1,25520000
nn_kernel_gpu,1544,1,1,199375,128,0,0,0,0,1,25520000
nn_kernel_gpu_mem,42875,1,1,199375,128,204160000,102080000,102080000,204160000,1,25520000
nn_kernel_cpu,23237,0,1,1,64,0,0,0,0,1,25530000
nn_kernel_gpu,1532,1,1,199454,128,0,0,0,0,1,25530000
nn_kernel_gpu_mem,35842,1,1,199454,128,204240000,102120000,102120000,204240000,1,25530000
nn_kernel_cpu,24820,0,1,1,64,0,0,0,0,1,25540000
nn_kernel_gpu,1532,1,1,199532,128,0,0,0,0,1,25540000
nn_kernel_gpu_mem,35691,1,1,199532,128,204320000,102160000,102160000,204320000,1,25540000
nn_kernel_cpu,22575,0,1,1,64,0,0,0,0,1,25550000
nn_kernel_gpu,1531,1,1,199610,128,0,0,0,0,1,25550000
nn_kernel_gpu_mem,40306,1,1,199610,128,204400000,102200000,102200000,204400000,1,25550000
nn_kernel_cpu,9660,0,1,1,64,0,0,0,0,1,25560000
nn_kernel_gpu,1540,1,1,199688,128,0,0,0,0,1,25560000
nn_kernel_gpu_mem,40799,1,1,199688,128,204480000,102240000,102240000,204480000,1,25560000
nn_kernel_cpu,35739,0,1,1,64,0,0,0,0,1,25570000
nn_kernel_gpu,1540,1,1,199766,128,0,0,0,0,1,25570000
nn_kernel_gpu_mem,46379,1,1,199766,128,204560000,102280000,102280000,204560000,1,25570000
nn_kernel_cpu,23504,0,1,1,64,0,0,0,0,1,25580000
nn_kernel_gpu,1540,1,1,199844,128,0,0,0,0,1,25580000
nn_kernel_gpu_mem,43604,1,1,199844,128,204640000,102320000,102320000,204640000,1,25580000
nn_kernel_cpu,9841,0,1,1,64,0,0,0,0,1,25590000
nn_kernel_gpu,1570,1,1,199922,128,0,0,0,0,1,25590000
nn_kernel_gpu_mem,39988,1,1,199922,128,204720000,102360000,102360000,204720000,1,25590000
nn_kernel_cpu,13943,0,1,1,64,0,0,0,0,1,25600000
nn_kernel_gpu,1533,1,1,200000,128,0,0,0,0,1,25600000
nn_kernel_gpu_mem,38577,1,1,200000,128,204800000,102400000,102400000,204800000,1,25600000
nn_kernel_cpu,6003,0,1,1,64,0,0,0,0,1,2560000
nn_kernel_gpu,205,1,1,20000,128,0,0,0,0,1,2560000
nn_kernel_gpu_mem,4029,1,1,20000,128,20480000,10240000,10240000,20480000,1,2560000
nn_kernel_cpu,17085,0,1,1,64,0,0,0,0,1,25610000
nn_kernel_gpu,1536,1,1,200079,128,0,0,0,0,1,25610000
nn_kernel_gpu_mem,39973,1,1,200079,128,204880000,102440000,102440000,204880000,1,25610000
nn_kernel_cpu,24198,0,1,1,64,0,0,0,0,1,25620000
nn_kernel_gpu,1539,1,1,200157,128,0,0,0,0,1,25620000
nn_kernel_gpu_mem,34088,1,1,200157,128,204960000,102480000,102480000,204960000,1,25620000
nn_kernel_cpu,19880,0,1,1,64,0,0,0,0,1,25630000
nn_kernel_gpu,1530,1,1,200235,128,0,0,0,0,1,25630000
nn_kernel_gpu_mem,37543,1,1,200235,128,205040000,102520000,102520000,205040000,1,25630000
nn_kernel_cpu,28855,0,1,1,64,0,0,0,0,1,25640000
nn_kernel_gpu,1541,1,1,200313,128,0,0,0,0,1,25640000
nn_kernel_gpu_mem,42357,1,1,200313,128,205120000,102560000,102560000,205120000,1,25640000
nn_kernel_cpu,22933,0,1,1,64,0,0,0,0,1,25650000
nn_kernel_gpu,1531,1,1,200391,128,0,0,0,0,1,25650000
nn_kernel_gpu_mem,40843,1,1,200391,128,205200000,102600000,102600000,205200000,1,25650000
nn_kernel_cpu,14684,0,1,1,64,0,0,0,0,1,25660000
nn_kernel_gpu,1535,1,1,200469,128,0,0,0,0,1,25660000
nn_kernel_gpu_mem,39569,1,1,200469,128,205280000,102640000,102640000,205280000,1,25660000
nn_kernel_cpu,7533,0,1,1,64,0,0,0,0,1,25670000
nn_kernel_gpu,1550,1,1,200547,128,0,0,0,0,1,25670000
nn_kernel_gpu_mem,40980,1,1,200547,128,205360000,102680000,102680000,205360000,1,25670000
nn_kernel_cpu,29792,0,1,1,64,0,0,0,0,1,25680000
nn_kernel_gpu,1536,1,1,200625,128,0,0,0,0,1,25680000
nn_kernel_gpu_mem,35281,1,1,200625,128,205440000,102720000,102720000,205440000,1,25680000
nn_kernel_cpu,14573,0,1,1,64,0,0,0,0,1,25690000
nn_kernel_gpu,1538,1,1,200704,128,0,0,0,0,1,25690000
nn_kernel_gpu_mem,40271,1,1,200704,128,205520000,102760000,102760000,205520000,1,25690000
nn_kernel_cpu,15170,0,1,1,64,0,0,0,0,1,25700000
nn_kernel_gpu,1551,1,1,200782,128,0,0,0,0,1,25700000
nn_kernel_gpu_mem,35512,1,1,200782,128,205600000,102800000,102800000,205600000,1,25700000
nn_kernel_cpu,7030,0,1,1,64,0,0,0,0,1,2570000
nn_kernel_gpu,201,1,1,20079,128,0,0,0,0,1,2570000
nn_kernel_gpu_mem,4307,1,1,20079,128,20560000,10280000,10280000,20560000,1,2570000
nn_kernel_cpu,31393,0,1,1,64,0,0,0,0,1,25710000
nn_kernel_gpu,1568,1,1,200860,128,0,0,0,0,1,25710000
nn_kernel_gpu_mem,40397,1,1,200860,128,205680000,102840000,102840000,205680000,1,25710000
nn_kernel_cpu,18434,0,1,1,64,0,0,0,0,1,25720000
nn_kernel_gpu,1555,1,1,200938,128,0,0,0,0,1,25720000
nn_kernel_gpu_mem,44868,1,1,200938,128,205760000,102880000,102880000,205760000,1,25720000
nn_kernel_cpu,7621,0,1,1,64,0,0,0,0,1,25730000
nn_kernel_gpu,1561,1,1,201016,128,0,0,0,0,1,25730000
nn_kernel_gpu_mem,36120,1,1,201016,128,205840000,102920000,102920000,205840000,1,25730000
nn_kernel_cpu,23570,0,1,1,64,0,0,0,0,1,25740000
nn_kernel_gpu,1559,1,1,201094,128,0,0,0,0,1,25740000
nn_kernel_gpu_mem,41278,1,1,201094,128,205920000,102960000,102960000,205920000,1,25740000
nn_kernel_cpu,21772,0,1,1,64,0,0,0,0,1,25750000
nn_kernel_gpu,1559,1,1,201172,128,0,0,0,0,1,25750000
nn_kernel_gpu_mem,34781,1,1,201172,128,206000000,103000000,103000000,206000000,1,25750000
nn_kernel_cpu,26824,0,1,1,64,0,0,0,0,1,25760000
nn_kernel_gpu,1572,1,1,201250,128,0,0,0,0,1,25760000
nn_kernel_gpu_mem,40343,1,1,201250,128,206080000,103040000,103040000,206080000,1,25760000
nn_kernel_cpu,22251,0,1,1,64,0,0,0,0,1,25770000
nn_kernel_gpu,1558,1,1,201329,128,0,0,0,0,1,25770000
nn_kernel_gpu_mem,39932,1,1,201329,128,206160000,103080000,103080000,206160000,1,25770000
nn_kernel_cpu,12310,0,1,1,64,0,0,0,0,1,25780000
nn_kernel_gpu,1554,1,1,201407,128,0,0,0,0,1,25780000
nn_kernel_gpu_mem,45638,1,1,201407,128,206240000,103120000,103120000,206240000,1,25780000
nn_kernel_cpu,9998,0,1,1,64,0,0,0,0,1,25790000
nn_kernel_gpu,1569,1,1,201485,128,0,0,0,0,1,25790000
nn_kernel_gpu_mem,40788,1,1,201485,128,206320000,103160000,103160000,206320000,1,25790000
nn_kernel_cpu,15380,0,1,1,64,0,0,0,0,1,25800000
nn_kernel_gpu,1554,1,1,201563,128,0,0,0,0,1,25800000
nn_kernel_gpu_mem,40335,1,1,201563,128,206400000,103200000,103200000,206400000,1,25800000
nn_kernel_cpu,49514,0,1,1,64,0,0,0,0,1,2580000
nn_kernel_gpu,218,1,1,20157,128,0,0,0,0,1,2580000
nn_kernel_gpu_mem,4191,1,1,20157,128,20640000,10320000,10320000,20640000,1,2580000
nn_kernel_cpu,27417,0,1,1,64,0,0,0,0,1,25810000
nn_kernel_gpu,1594,1,1,201641,128,0,0,0,0,1,25810000
nn_kernel_gpu_mem,45316,1,1,201641,128,206480000,103240000,103240000,206480000,1,25810000
nn_kernel_cpu,15936,0,1,1,64,0,0,0,0,1,25820000
nn_kernel_gpu,1549,1,1,201719,128,0,0,0,0,1,25820000
nn_kernel_gpu_mem,51836,1,1,201719,128,206560000,103280000,103280000,206560000,1,25820000
nn_kernel_cpu,9384,0,1,1,64,0,0,0,0,1,25830000
nn_kernel_gpu,1552,1,1,201797,128,0,0,0,0,1,25830000
nn_kernel_gpu_mem,41896,1,1,201797,128,206640000,103320000,103320000,206640000,1,25830000
nn_kernel_cpu,24877,0,1,1,64,0,0,0,0,1,25840000
nn_kernel_gpu,1570,1,1,201875,128,0,0,0,0,1,25840000
nn_kernel_gpu_mem,40311,1,1,201875,128,206720000,103360000,103360000,206720000,1,25840000
nn_kernel_cpu,24165,0,1,1,64,0,0,0,0,1,25850000
nn_kernel_gpu,1568,1,1,201954,128,0,0,0,0,1,25850000
nn_kernel_gpu_mem,41508,1,1,201954,128,206800000,103400000,103400000,206800000,1,25850000
nn_kernel_cpu,12957,0,1,1,64,0,0,0,0,1,25860000
nn_kernel_gpu,1559,1,1,202032,128,0,0,0,0,1,25860000
nn_kernel_gpu_mem,36258,1,1,202032,128,206880000,103440000,103440000,206880000,1,25860000
nn_kernel_cpu,18198,0,1,1,64,0,0,0,0,1,25870000
nn_kernel_gpu,1585,1,1,202110,128,0,0,0,0,1,25870000
nn_kernel_gpu_mem,41712,1,1,202110,128,206960000,103480000,103480000,206960000,1,25870000
nn_kernel_cpu,36053,0,1,1,64,0,0,0,0,1,25880000
nn_kernel_gpu,1552,1,1,202188,128,0,0,0,0,1,25880000
nn_kernel_gpu_mem,42370,1,1,202188,128,207040000,103520000,103520000,207040000,1,25880000
nn_kernel_cpu,15355,0,1,1,64,0,0,0,0,1,25890000
nn_kernel_gpu,1570,1,1,202266,128,0,0,0,0,1,25890000
nn_kernel_gpu_mem,39715,1,1,202266,128,207120000,103560000,103560000,207120000,1,25890000
nn_kernel_cpu,25105,0,1,1,64,0,0,0,0,1,25900000
nn_kernel_gpu,1559,1,1,202344,128,0,0,0,0,1,25900000
nn_kernel_gpu_mem,44543,1,1,202344,128,207200000,103600000,103600000,207200000,1,25900000
nn_kernel_cpu,6916,0,1,1,64,0,0,0,0,1,2590000
nn_kernel_gpu,214,1,1,20235,128,0,0,0,0,1,2590000
nn_kernel_gpu_mem,4158,1,1,20235,128,20720000,10360000,10360000,20720000,1,2590000
nn_kernel_cpu,24424,0,1,1,64,0,0,0,0,1,25910000
nn_kernel_gpu,1584,1,1,202422,128,0,0,0,0,1,25910000
nn_kernel_gpu_mem,41191,1,1,202422,128,207280000,103640000,103640000,207280000,1,25910000
nn_kernel_cpu,20316,0,1,1,64,0,0,0,0,1,25920000
nn_kernel_gpu,1563,1,1,202500,128,0,0,0,0,1,25920000
nn_kernel_gpu_mem,40621,1,1,202500,128,207360000,103680000,103680000,207360000,1,25920000
nn_kernel_cpu,28972,0,1,1,64,0,0,0,0,1,25930000
nn_kernel_gpu,1581,1,1,202579,128,0,0,0,0,1,25930000
nn_kernel_gpu_mem,38060,1,1,202579,128,207440000,103720000,103720000,207440000,1,25930000
nn_kernel_cpu,25462,0,1,1,64,0,0,0,0,1,25940000
nn_kernel_gpu,1566,1,1,202657,128,0,0,0,0,1,25940000
nn_kernel_gpu_mem,37437,1,1,202657,128,207520000,103760000,103760000,207520000,1,25940000
nn_kernel_cpu,24700,0,1,1,64,0,0,0,0,1,25950000
nn_kernel_gpu,1577,1,1,202735,128,0,0,0,0,1,25950000
nn_kernel_gpu_mem,40957,1,1,202735,128,207600000,103800000,103800000,207600000,1,25950000
nn_kernel_cpu,23250,0,1,1,64,0,0,0,0,1,25960000
nn_kernel_gpu,1554,1,1,202813,128,0,0,0,0,1,25960000
nn_kernel_gpu_mem,44892,1,1,202813,128,207680000,103840000,103840000,207680000,1,25960000
nn_kernel_cpu,21607,0,1,1,64,0,0,0,0,1,25970000
nn_kernel_gpu,1564,1,1,202891,128,0,0,0,0,1,25970000
nn_kernel_gpu_mem,40758,1,1,202891,128,207760000,103880000,103880000,207760000,1,25970000
nn_kernel_cpu,24477,0,1,1,64,0,0,0,0,1,25980000
nn_kernel_gpu,1573,1,1,202969,128,0,0,0,0,1,25980000
nn_kernel_gpu_mem,41783,1,1,202969,128,207840000,103920000,103920000,207840000,1,25980000
nn_kernel_cpu,18901,0,1,1,64,0,0,0,0,1,25990000
nn_kernel_gpu,1559,1,1,203047,128,0,0,0,0,1,25990000
nn_kernel_gpu_mem,42288,1,1,203047,128,207920000,103960000,103960000,207920000,1,25990000
nn_kernel_cpu,16778,0,1,1,64,0,0,0,0,1,26000000
nn_kernel_gpu,1558,1,1,203125,128,0,0,0,0,1,26000000
nn_kernel_gpu_mem,38220,1,1,203125,128,208000000,104000000,104000000,208000000,1,26000000
nn_kernel_cpu,30288,0,1,1,64,0,0,0,0,1,2600000
nn_kernel_gpu,198,1,1,20313,128,0,0,0,0,1,2600000
nn_kernel_gpu_mem,3612,1,1,20313,128,20800000,10400000,10400000,20800000,1,2600000
nn_kernel_cpu,24049,0,1,1,64,0,0,0,0,1,260000
nn_kernel_gpu,52,1,1,2032,128,0,0,0,0,1,260000
nn_kernel_gpu_mem,883,1,1,2032,128,2080000,1040000,1040000,2080000,1,260000
nn_kernel_cpu,21970,0,1,1,64,0,0,0,0,1,26010000
nn_kernel_gpu,1569,1,1,203204,128,0,0,0,0,1,26010000
nn_kernel_gpu_mem,41649,1,1,203204,128,208080000,104040000,104040000,208080000,1,26010000
nn_kernel_cpu,30632,0,1,1,64,0,0,0,0,1,26020000
nn_kernel_gpu,1581,1,1,203282,128,0,0,0,0,1,26020000
nn_kernel_gpu_mem,41838,1,1,203282,128,208160000,104080000,104080000,208160000,1,26020000
nn_kernel_cpu,20720,0,1,1,64,0,0,0,0,1,26030000
nn_kernel_gpu,1568,1,1,203360,128,0,0,0,0,1,26030000
nn_kernel_gpu_mem,37114,1,1,203360,128,208240000,104120000,104120000,208240000,1,26030000
nn_kernel_cpu,9575,0,1,1,64,0,0,0,0,1,26040000
nn_kernel_gpu,1552,1,1,203438,128,0,0,0,0,1,26040000
nn_kernel_gpu_mem,35994,1,1,203438,128,208320000,104160000,104160000,208320000,1,26040000
nn_kernel_cpu,24897,0,1,1,64,0,0,0,0,1,26050000
nn_kernel_gpu,1584,1,1,203516,128,0,0,0,0,1,26050000
nn_kernel_gpu_mem,41392,1,1,203516,128,208400000,104200000,104200000,208400000,1,26050000
nn_kernel_cpu,43460,0,1,1,64,0,0,0,0,1,26060000
nn_kernel_gpu,1572,1,1,203594,128,0,0,0,0,1,26060000
nn_kernel_gpu_mem,40993,1,1,203594,128,208480000,104240000,104240000,208480000,1,26060000
nn_kernel_cpu,26880,0,1,1,64,0,0,0,0,1,26070000
nn_kernel_gpu,1570,1,1,203672,128,0,0,0,0,1,26070000
nn_kernel_gpu_mem,42183,1,1,203672,128,208560000,104280000,104280000,208560000,1,26070000
nn_kernel_cpu,29823,0,1,1,64,0,0,0,0,1,26080000
nn_kernel_gpu,1584,1,1,203750,128,0,0,0,0,1,26080000
nn_kernel_gpu_mem,42585,1,1,203750,128,208640000,104320000,104320000,208640000,1,26080000
nn_kernel_cpu,30469,0,1,1,64,0,0,0,0,1,26090000
nn_kernel_gpu,1589,1,1,203829,128,0,0,0,0,1,26090000
nn_kernel_gpu_mem,42728,1,1,203829,128,208720000,104360000,104360000,208720000,1,26090000
nn_kernel_cpu,21936,0,1,1,64,0,0,0,0,1,26100000
nn_kernel_gpu,1567,1,1,203907,128,0,0,0,0,1,26100000
nn_kernel_gpu_mem,40417,1,1,203907,128,208800000,104400000,104400000,208800000,1,26100000
nn_kernel_cpu,13213,0,1,1,64,0,0,0,0,1,2610000
nn_kernel_gpu,204,1,1,20391,128,0,0,0,0,1,2610000
nn_kernel_gpu_mem,4055,1,1,20391,128,20880000,10440000,10440000,20880000,1,2610000
nn_kernel_cpu,34427,0,1,1,64,0,0,0,0,1,26110000
nn_kernel_gpu,1573,1,1,203985,128,0,0,0,0,1,26110000
nn_kernel_gpu_mem,43291,1,1,203985,128,208880000,104440000,104440000,208880000,1,26110000
nn_kernel_cpu,22546,0,1,1,64,0,0,0,0,1,26120000
nn_kernel_gpu,1569,1,1,204063,128,0,0,0,0,1,26120000
nn_kernel_gpu_mem,41372,1,1,204063,128,208960000,104480000,104480000,208960000,1,26120000
nn_kernel_cpu,32110,0,1,1,64,0,0,0,0,1,26130000
nn_kernel_gpu,1581,1,1,204141,128,0,0,0,0,1,26130000
nn_kernel_gpu_mem,35889,1,1,204141,128,209040000,104520000,104520000,209040000,1,26130000
nn_kernel_cpu,22140,0,1,1,64,0,0,0,0,1,26140000
nn_kernel_gpu,1616,1,1,204219,128,0,0,0,0,1,26140000
nn_kernel_gpu_mem,36513,1,1,204219,128,209120000,104560000,104560000,209120000,1,26140000
nn_kernel_cpu,17482,0,1,1,64,0,0,0,0,1,26150000
nn_kernel_gpu,1572,1,1,204297,128,0,0,0,0,1,26150000
nn_kernel_gpu_mem,44113,1,1,204297,128,209200000,104600000,104600000,209200000,1,26150000
nn_kernel_cpu,24441,0,1,1,64,0,0,0,0,1,26160000
nn_kernel_gpu,1576,1,1,204375,128,0,0,0,0,1,26160000
nn_kernel_gpu_mem,38549,1,1,204375,128,209280000,104640000,104640000,209280000,1,26160000
nn_kernel_cpu,34468,0,1,1,64,0,0,0,0,1,26170000
nn_kernel_gpu,1591,1,1,204454,128,0,0,0,0,1,26170000
nn_kernel_gpu_mem,45137,1,1,204454,128,209360000,104680000,104680000,209360000,1,26170000
nn_kernel_cpu,27961,0,1,1,64,0,0,0,0,1,26180000
nn_kernel_gpu,1597,1,1,204532,128,0,0,0,0,1,26180000
nn_kernel_gpu_mem,36209,1,1,204532,128,209440000,104720000,104720000,209440000,1,26180000
nn_kernel_cpu,29942,0,1,1,64,0,0,0,0,1,26190000
nn_kernel_gpu,1587,1,1,204610,128,0,0,0,0,1,26190000
nn_kernel_gpu_mem,43407,1,1,204610,128,209520000,104760000,104760000,209520000,1,26190000
nn_kernel_cpu,26700,0,1,1,64,0,0,0,0,1,26200000
nn_kernel_gpu,1583,1,1,204688,128,0,0,0,0,1,26200000
nn_kernel_gpu_mem,36317,1,1,204688,128,209600000,104800000,104800000,209600000,1,26200000
nn_kernel_cpu,26511,0,1,1,64,0,0,0,0,1,2620000
nn_kernel_gpu,212,1,1,20469,128,0,0,0,0,1,2620000
nn_kernel_gpu_mem,4729,1,1,20469,128,20960000,10480000,10480000,20960000,1,2620000
nn_kernel_cpu,28013,0,1,1,64,0,0,0,0,1,26210000
nn_kernel_gpu,1580,1,1,204766,128,0,0,0,0,1,26210000
nn_kernel_gpu_mem,41659,1,1,204766,128,209680000,104840000,104840000,209680000,1,26210000
nn_kernel_cpu,23463,0,1,1,64,0,0,0,0,1,26220000
nn_kernel_gpu,1569,1,1,204844,128,0,0,0,0,1,26220000
nn_kernel_gpu_mem,41478,1,1,204844,128,209760000,104880000,104880000,209760000,1,26220000
nn_kernel_cpu,14265,0,1,1,64,0,0,0,0,1,26230000
nn_kernel_gpu,1562,1,1,204922,128,0,0,0,0,1,26230000
nn_kernel_gpu_mem,37270,1,1,204922,128,209840000,104920000,104920000,209840000,1,26230000
nn_kernel_cpu,21708,0,1,1,64,0,0,0,0,1,26240000
nn_kernel_gpu,1564,1,1,205000,128,0,0,0,0,1,26240000
nn_kernel_gpu_mem,37394,1,1,205000,128,209920000,104960000,104960000,209920000,1,26240000
nn_kernel_cpu,26860,0,1,1,64,0,0,0,0,1,26250000
nn_kernel_gpu,1568,1,1,205079,128,0,0,0,0,1,26250000
nn_kernel_gpu_mem,41255,1,1,205079,128,210000000,105000000,105000000,210000000,1,26250000
nn_kernel_cpu,20645,0,1,1,64,0,0,0,0,1,26260000
nn_kernel_gpu,1582,1,1,205157,128,0,0,0,0,1,26260000
nn_kernel_gpu_mem,36487,1,1,205157,128,210080000,105040000,105040000,210080000,1,26260000
nn_kernel_cpu,30092,0,1,1,64,0,0,0,0,1,26270000
nn_kernel_gpu,1592,1,1,205235,128,0,0,0,0,1,26270000
nn_kernel_gpu_mem,45006,1,1,205235,128,210160000,105080000,105080000,210160000,1,26270000
nn_kernel_cpu,18151,0,1,1,64,0,0,0,0,1,26280000
nn_kernel_gpu,1570,1,1,205313,128,0,0,0,0,1,26280000
nn_kernel_gpu_mem,39462,1,1,205313,128,210240000,105120000,105120000,210240000,1,26280000
nn_kernel_cpu,27518,0,1,1,64,0,0,0,0,1,26290000
nn_kernel_gpu,1583,1,1,205391,128,0,0,0,0,1,26290000
nn_kernel_gpu_mem,37063,1,1,205391,128,210320000,105160000,105160000,210320000,1,26290000
nn_kernel_cpu,30347,0,1,1,64,0,0,0,0,1,26300000
nn_kernel_gpu,1591,1,1,205469,128,0,0,0,0,1,26300000
nn_kernel_gpu_mem,36338,1,1,205469,128,210400000,105200000,105200000,210400000,1,26300000
nn_kernel_cpu,30118,0,1,1,64,0,0,0,0,1,2630000
nn_kernel_gpu,207,1,1,20547,128,0,0,0,0,1,2630000
nn_kernel_gpu_mem,7116,1,1,20547,128,21040000,10520000,10520000,21040000,1,2630000
nn_kernel_cpu,26646,0,1,1,64,0,0,0,0,1,26310000
nn_kernel_gpu,1578,1,1,205547,128,0,0,0,0,1,26310000
nn_kernel_gpu_mem,36840,1,1,205547,128,210480000,105240000,105240000,210480000,1,26310000
nn_kernel_cpu,28100,0,1,1,64,0,0,0,0,1,26320000
nn_kernel_gpu,1577,1,1,205625,128,0,0,0,0,1,26320000
nn_kernel_gpu_mem,38556,1,1,205625,128,210560000,105280000,105280000,210560000,1,26320000
nn_kernel_cpu,21404,0,1,1,64,0,0,0,0,1,26330000
nn_kernel_gpu,1580,1,1,205704,128,0,0,0,0,1,26330000
nn_kernel_gpu_mem,41949,1,1,205704,128,210640000,105320000,105320000,210640000,1,26330000
nn_kernel_cpu,18682,0,1,1,64,0,0,0,0,1,26340000
nn_kernel_gpu,1570,1,1,205782,128,0,0,0,0,1,26340000
nn_kernel_gpu_mem,38174,1,1,205782,128,210720000,105360000,105360000,210720000,1,26340000
nn_kernel_cpu,24484,0,1,1,64,0,0,0,0,1,26350000
nn_kernel_gpu,1575,1,1,205860,128,0,0,0,0,1,26350000
nn_kernel_gpu_mem,41225,1,1,205860,128,210800000,105400000,105400000,210800000,1,26350000
nn_kernel_cpu,27636,0,1,1,64,0,0,0,0,1,26360000
nn_kernel_gpu,1565,1,1,205938,128,0,0,0,0,1,26360000
nn_kernel_gpu_mem,40030,1,1,205938,128,210880000,105440000,105440000,210880000,1,26360000
nn_kernel_cpu,25982,0,1,1,64,0,0,0,0,1,26370000
nn_kernel_gpu,1576,1,1,206016,128,0,0,0,0,1,26370000
nn_kernel_gpu_mem,42748,1,1,206016,128,210960000,105480000,105480000,210960000,1,26370000
nn_kernel_cpu,17241,0,1,1,64,0,0,0,0,1,26380000
nn_kernel_gpu,1579,1,1,206094,128,0,0,0,0,1,26380000
nn_kernel_gpu_mem,37944,1,1,206094,128,211040000,105520000,105520000,211040000,1,26380000
nn_kernel_cpu,25726,0,1,1,64,0,0,0,0,1,26390000
nn_kernel_gpu,1593,1,1,206172,128,0,0,0,0,1,26390000
nn_kernel_gpu_mem,44673,1,1,206172,128,211120000,105560000,105560000,211120000,1,26390000
nn_kernel_cpu,15488,0,1,1,64,0,0,0,0,1,26400000
nn_kernel_gpu,1578,1,1,206250,128,0,0,0,0,1,26400000
nn_kernel_gpu_mem,44414,1,1,206250,128,211200000,105600000,105600000,211200000,1,26400000
nn_kernel_cpu,33690,0,1,1,64,0,0,0,0,1,2640000
nn_kernel_gpu,210,1,1,20625,128,0,0,0,0,1,2640000
nn_kernel_gpu_mem,8996,1,1,20625,128,21120000,10560000,10560000,21120000,1,2640000
nn_kernel_cpu,36356,0,1,1,64,0,0,0,0,1,26410000
nn_kernel_gpu,1572,1,1,206329,128,0,0,0,0,1,26410000
nn_kernel_gpu_mem,38880,1,1,206329,128,211280000,105640000,105640000,211280000,1,26410000
nn_kernel_cpu,27701,0,1,1,64,0,0,0,0,1,26420000
nn_kernel_gpu,1580,1,1,206407,128,0,0,0,0,1,26420000
nn_kernel_gpu_mem,36533,1,1,206407,128,211360000,105680000,105680000,211360000,1,26420000
nn_kernel_cpu,24091,0,1,1,64,0,0,0,0,1,26430000
nn_kernel_gpu,1576,1,1,206485,128,0,0,0,0,1,26430000
nn_kernel_gpu_mem,39110,1,1,206485,128,211440000,105720000,105720000,211440000,1,26430000
nn_kernel_cpu,24782,0,1,1,64,0,0,0,0,1,26440000
nn_kernel_gpu,1575,1,1,206563,128,0,0,0,0,1,26440000
nn_kernel_gpu_mem,40674,1,1,206563,128,211520000,105760000,105760000,211520000,1,26440000
nn_kernel_cpu,18290,0,1,1,64,0,0,0,0,1,26450000
nn_kernel_gpu,1600,1,1,206641,128,0,0,0,0,1,26450000
nn_kernel_gpu_mem,46779,1,1,206641,128,211600000,105800000,105800000,211600000,1,26450000
nn_kernel_cpu,36685,0,1,1,64,0,0,0,0,1,26460000
nn_kernel_gpu,1576,1,1,206719,128,0,0,0,0,1,26460000
nn_kernel_gpu_mem,40537,1,1,206719,128,211680000,105840000,105840000,211680000,1,26460000
nn_kernel_cpu,32598,0,1,1,64,0,0,0,0,1,26470000
nn_kernel_gpu,1573,1,1,206797,128,0,0,0,0,1,26470000
nn_kernel_gpu_mem,42765,1,1,206797,128,211760000,105880000,105880000,211760000,1,26470000
nn_kernel_cpu,32719,0,1,1,64,0,0,0,0,1,26480000
nn_kernel_gpu,1626,1,1,206875,128,0,0,0,0,1,26480000
nn_kernel_gpu_mem,45868,1,1,206875,128,211840000,105920000,105920000,211840000,1,26480000
nn_kernel_cpu,26354,0,1,1,64,0,0,0,0,1,26490000
nn_kernel_gpu,1575,1,1,206954,128,0,0,0,0,1,26490000
nn_kernel_gpu_mem,40315,1,1,206954,128,211920000,105960000,105960000,211920000,1,26490000
nn_kernel_cpu,24953,0,1,1,64,0,0,0,0,1,26500000
nn_kernel_gpu,1599,1,1,207032,128,0,0,0,0,1,26500000
nn_kernel_gpu_mem,37684,1,1,207032,128,212000000,106000000,106000000,212000000,1,26500000
nn_kernel_cpu,20308,0,1,1,64,0,0,0,0,1,2650000
nn_kernel_gpu,202,1,1,20704,128,0,0,0,0,1,2650000
nn_kernel_gpu_mem,10522,1,1,20704,128,21200000,10600000,10600000,21200000,1,2650000
nn_kernel_cpu,15267,0,1,1,64,0,0,0,0,1,26510000
nn_kernel_gpu,1600,1,1,207110,128,0,0,0,0,1,26510000
nn_kernel_gpu_mem,48371,1,1,207110,128,212080000,106040000,106040000,212080000,1,26510000
nn_kernel_cpu,29783,0,1,1,64,0,0,0,0,1,26520000
nn_kernel_gpu,1576,1,1,207188,128,0,0,0,0,1,26520000
nn_kernel_gpu_mem,41286,1,1,207188,128,212160000,106080000,106080000,212160000,1,26520000
nn_kernel_cpu,25530,0,1,1,64,0,0,0,0,1,26530000
nn_kernel_gpu,1589,1,1,207266,128,0,0,0,0,1,26530000
nn_kernel_gpu_mem,35713,1,1,207266,128,212240000,106120000,106120000,212240000,1,26530000
nn_kernel_cpu,32195,0,1,1,64,0,0,0,0,1,26540000
nn_kernel_gpu,1597,1,1,207344,128,0,0,0,0,1,26540000
nn_kernel_gpu_mem,37849,1,1,207344,128,212320000,106160000,106160000,212320000,1,26540000
nn_kernel_cpu,30587,0,1,1,64,0,0,0,0,1,26550000
nn_kernel_gpu,1590,1,1,207422,128,0,0,0,0,1,26550000
nn_kernel_gpu_mem,46312,1,1,207422,128,212400000,106200000,106200000,212400000,1,26550000
nn_kernel_cpu,25194,0,1,1,64,0,0,0,0,1,26560000
nn_kernel_gpu,1585,1,1,207500,128,0,0,0,0,1,26560000
nn_kernel_gpu_mem,38870,1,1,207500,128,212480000,106240000,106240000,212480000,1,26560000
nn_kernel_cpu,32851,0,1,1,64,0,0,0,0,1,26570000
nn_kernel_gpu,1595,1,1,207579,128,0,0,0,0,1,26570000
nn_kernel_gpu_mem,37324,1,1,207579,128,212560000,106280000,106280000,212560000,1,26570000
nn_kernel_cpu,16846,0,1,1,64,0,0,0,0,1,26580000
nn_kernel_gpu,1626,1,1,207657,128,0,0,0,0,1,26580000
nn_kernel_gpu_mem,36274,1,1,207657,128,212640000,106320000,106320000,212640000,1,26580000
nn_kernel_cpu,26947,0,1,1,64,0,0,0,0,1,26590000
nn_kernel_gpu,1590,1,1,207735,128,0,0,0,0,1,26590000
nn_kernel_gpu_mem,41016,1,1,207735,128,212720000,106360000,106360000,212720000,1,26590000
nn_kernel_cpu,22227,0,1,1,64,0,0,0,0,1,26600000
nn_kernel_gpu,1609,1,1,207813,128,0,0,0,0,1,26600000
nn_kernel_gpu_mem,37661,1,1,207813,128,212800000,106400000,106400000,212800000,1,26600000
nn_kernel_cpu,23841,0,1,1,64,0,0,0,0,1,2660000
nn_kernel_gpu,215,1,1,20782,128,0,0,0,0,1,2660000
nn_kernel_gpu_mem,9339,1,1,20782,128,21280000,10640000,10640000,21280000,1,2660000
nn_kernel_cpu,28633,0,1,1,64,0,0,0,0,1,26610000
nn_kernel_gpu,1597,1,1,207891,128,0,0,0,0,1,26610000
nn_kernel_gpu_mem,43856,1,1,207891,128,212880000,106440000,106440000,212880000,1,26610000
nn_kernel_cpu,23819,0,1,1,64,0,0,0,0,1,26620000
nn_kernel_gpu,1598,1,1,207969,128,0,0,0,0,1,26620000
nn_kernel_gpu_mem,44783,1,1,207969,128,212960000,106480000,106480000,212960000,1,26620000
nn_kernel_cpu,25818,0,1,1,64,0,0,0,0,1,26630000
nn_kernel_gpu,1604,1,1,208047,128,0,0,0,0,1,26630000
nn_kernel_gpu_mem,41904,1,1,208047,128,213040000,106520000,106520000,213040000,1,26630000
nn_kernel_cpu,29556,0,1,1,64,0,0,0,0,1,26640000
nn_kernel_gpu,1591,1,1,208125,128,0,0,0,0,1,26640000
nn_kernel_gpu_mem,45906,1,1,208125,128,213120000,106560000,106560000,213120000,1,26640000
nn_kernel_cpu,35737,0,1,1,64,0,0,0,0,1,26650000
nn_kernel_gpu,1618,1,1,208204,128,0,0,0,0,1,26650000
nn_kernel_gpu_mem,37386,1,1,208204,128,213200000,106600000,106600000,213200000,1,26650000
nn_kernel_cpu,23980,0,1,1,64,0,0,0,0,1,26660000
nn_kernel_gpu,1595,1,1,208282,128,0,0,0,0,1,26660000
nn_kernel_gpu_mem,45143,1,1,208282,128,213280000,106640000,106640000,213280000,1,26660000
nn_kernel_cpu,25094,0,1,1,64,0,0,0,0,1,26670000
nn_kernel_gpu,1601,1,1,208360,128,0,0,0,0,1,26670000
nn_kernel_gpu_mem,36821,1,1,208360,128,213360000,106680000,106680000,213360000,1,26670000
nn_kernel_cpu,29229,0,1,1,64,0,0,0,0,1,26680000
nn_kernel_gpu,1599,1,1,208438,128,0,0,0,0,1,26680000
nn_kernel_gpu_mem,36798,1,1,208438,128,213440000,106720000,106720000,213440000,1,26680000
nn_kernel_cpu,25858,0,1,1,64,0,0,0,0,1,26690000
nn_kernel_gpu,1592,1,1,208516,128,0,0,0,0,1,26690000
nn_kernel_gpu_mem,39765,1,1,208516,128,213520000,106760000,106760000,213520000,1,26690000
nn_kernel_cpu,27882,0,1,1,64,0,0,0,0,1,26700000
nn_kernel_gpu,1593,1,1,208594,128,0,0,0,0,1,26700000
nn_kernel_gpu_mem,35273,1,1,208594,128,213600000,106800000,106800000,213600000,1,26700000
nn_kernel_cpu,36213,0,1,1,64,0,0,0,0,1,2670000
nn_kernel_gpu,230,1,1,20860,128,0,0,0,0,1,2670000
nn_kernel_gpu_mem,9118,1,1,20860,128,21360000,10680000,10680000,21360000,1,2670000
nn_kernel_cpu,31923,0,1,1,64,0,0,0,0,1,26710000
nn_kernel_gpu,1599,1,1,208672,128,0,0,0,0,1,26710000
nn_kernel_gpu_mem,43337,1,1,208672,128,213680000,106840000,106840000,213680000,1,26710000
nn_kernel_cpu,21678,0,1,1,64,0,0,0,0,1,26720000
nn_kernel_gpu,1600,1,1,208750,128,0,0,0,0,1,26720000
nn_kernel_gpu_mem,42578,1,1,208750,128,213760000,106880000,106880000,213760000,1,26720000
nn_kernel_cpu,27509,0,1,1,64,0,0,0,0,1,26730000
nn_kernel_gpu,1603,1,1,208829,128,0,0,0,0,1,26730000
nn_kernel_gpu_mem,37992,1,1,208829,128,213840000,106920000,106920000,213840000,1,26730000
nn_kernel_cpu,49418,0,1,1,64,0,0,0,0,1,26740000
nn_kernel_gpu,1616,1,1,208907,128,0,0,0,0,1,26740000
nn_kernel_gpu_mem,42317,1,1,208907,128,213920000,106960000,106960000,213920000,1,26740000
nn_kernel_cpu,26812,0,1,1,64,0,0,0,0,1,26750000
nn_kernel_gpu,1606,1,1,208985,128,0,0,0,0,1,26750000
nn_kernel_gpu_mem,37543,1,1,208985,128,214000000,107000000,107000000,214000000,1,26750000
nn_kernel_cpu,29312,0,1,1,64,0,0,0,0,1,26760000
nn_kernel_gpu,1598,1,1,209063,128,0,0,0,0,1,26760000
nn_kernel_gpu_mem,38221,1,1,209063,128,214080000,107040000,107040000,214080000,1,26760000
nn_kernel_cpu,22771,0,1,1,64,0,0,0,0,1,26770000
nn_kernel_gpu,1618,1,1,209141,128,0,0,0,0,1,26770000
nn_kernel_gpu_mem,35287,1,1,209141,128,214160000,107080000,107080000,214160000,1,26770000
nn_kernel_cpu,20741,0,1,1,64,0,0,0,0,1,26780000
nn_kernel_gpu,1596,1,1,209219,128,0,0,0,0,1,26780000
nn_kernel_gpu_mem,38136,1,1,209219,128,214240000,107120000,107120000,214240000,1,26780000
nn_kernel_cpu,36776,0,1,1,64,0,0,0,0,1,26790000
nn_kernel_gpu,1592,1,1,209297,128,0,0,0,0,1,26790000
nn_kernel_gpu_mem,38761,1,1,209297,128,214320000,107160000,107160000,214320000,1,26790000
nn_kernel_cpu,15719,0,1,1,64,0,0,0,0,1,26800000
nn_kernel_gpu,1614,1,1,209375,128,0,0,0,0,1,26800000
nn_kernel_gpu_mem,42093,1,1,209375,128,214400000,107200000,107200000,214400000,1,26800000
nn_kernel_cpu,18000,0,1,1,64,0,0,0,0,1,2680000
nn_kernel_gpu,214,1,1,20938,128,0,0,0,0,1,2680000
nn_kernel_gpu_mem,3684,1,1,20938,128,21440000,10720000,10720000,21440000,1,2680000
nn_kernel_cpu,35801,0,1,1,64,0,0,0,0,1,26810000
nn_kernel_gpu,1618,1,1,209454,128,0,0,0,0,1,26810000
nn_kernel_gpu_mem,41475,1,1,209454,128,214480000,107240000,107240000,214480000,1,26810000
nn_kernel_cpu,10819,0,1,1,64,0,0,0,0,1,26820000
nn_kernel_gpu,1589,1,1,209532,128,0,0,0,0,1,26820000
nn_kernel_gpu_mem,34973,1,1,209532,128,214560000,107280000,107280000,214560000,1,26820000
nn_kernel_cpu,17856,0,1,1,64,0,0,0,0,1,26830000
nn_kernel_gpu,1596,1,1,209610,128,0,0,0,0,1,26830000
nn_kernel_gpu_mem,41269,1,1,209610,128,214640000,107320000,107320000,214640000,1,26830000
nn_kernel_cpu,25701,0,1,1,64,0,0,0,0,1,26840000
nn_kernel_gpu,1632,1,1,209688,128,0,0,0,0,1,26840000
nn_kernel_gpu_mem,42398,1,1,209688,128,214720000,107360000,107360000,214720000,1,26840000
nn_kernel_cpu,22650,0,1,1,64,0,0,0,0,1,26850000
nn_kernel_gpu,1609,1,1,209766,128,0,0,0,0,1,26850000
nn_kernel_gpu_mem,44094,1,1,209766,128,214800000,107400000,107400000,214800000,1,26850000
nn_kernel_cpu,34718,0,1,1,64,0,0,0,0,1,26860000
nn_kernel_gpu,1606,1,1,209844,128,0,0,0,0,1,26860000
nn_kernel_gpu_mem,40761,1,1,209844,128,214880000,107440000,107440000,214880000,1,26860000
nn_kernel_cpu,35847,0,1,1,64,0,0,0,0,1,26870000
nn_kernel_gpu,1631,1,1,209922,128,0,0,0,0,1,26870000
nn_kernel_gpu_mem,42950,1,1,209922,128,214960000,107480000,107480000,214960000,1,26870000
nn_kernel_cpu,5583,0,1,1,64,0,0,0,0,1,26880000
nn_kernel_gpu,1604,1,1,210000,128,0,0,0,0,1,26880000
nn_kernel_gpu_mem,43502,1,1,210000,128,215040000,107520000,107520000,215040000,1,26880000
nn_kernel_cpu,11545,0,1,1,64,0,0,0,0,1,26890000
nn_kernel_gpu,1609,1,1,210079,128,0,0,0,0,1,26890000
nn_kernel_gpu_mem,38077,1,1,210079,128,215120000,107560000,107560000,215120000,1,26890000
nn_kernel_cpu,11614,0,1,1,64,0,0,0,0,1,26900000
nn_kernel_gpu,1604,1,1,210157,128,0,0,0,0,1,26900000
nn_kernel_gpu_mem,36508,1,1,210157,128,215200000,107600000,107600000,215200000,1,26900000
nn_kernel_cpu,10651,0,1,1,64,0,0,0,0,1,2690000
nn_kernel_gpu,207,1,1,21016,128,0,0,0,0,1,2690000
nn_kernel_gpu_mem,4866,1,1,21016,128,21520000,10760000,10760000,21520000,1,2690000
nn_kernel_cpu,26843,0,1,1,64,0,0,0,0,1,26910000
nn_kernel_gpu,1624,1,1,210235,128,0,0,0,0,1,26910000
nn_kernel_gpu_mem,37661,1,1,210235,128,215280000,107640000,107640000,215280000,1,26910000
nn_kernel_cpu,26846,0,1,1,64,0,0,0,0,1,26920000
nn_kernel_gpu,1612,1,1,210313,128,0,0,0,0,1,26920000
nn_kernel_gpu_mem,44033,1,1,210313,128,215360000,107680000,107680000,215360000,1,26920000
nn_kernel_cpu,30259,0,1,1,64,0,0,0,0,1,26930000
nn_kernel_gpu,1602,1,1,210391,128,0,0,0,0,1,26930000
nn_kernel_gpu_mem,39571,1,1,210391,128,215440000,107720000,107720000,215440000,1,26930000
nn_kernel_cpu,24735,0,1,1,64,0,0,0,0,1,26940000
nn_kernel_gpu,1615,1,1,210469,128,0,0,0,0,1,26940000
nn_kernel_gpu_mem,41417,1,1,210469,128,215520000,107760000,107760000,215520000,1,26940000
nn_kernel_cpu,24901,0,1,1,64,0,0,0,0,1,26950000
nn_kernel_gpu,1606,1,1,210547,128,0,0,0,0,1,26950000
nn_kernel_gpu_mem,44078,1,1,210547,128,215600000,107800000,107800000,215600000,1,26950000
nn_kernel_cpu,8745,0,1,1,64,0,0,0,0,1,26960000
nn_kernel_gpu,1614,1,1,210625,128,0,0,0,0,1,26960000
nn_kernel_gpu_mem,41428,1,1,210625,128,215680000,107840000,107840000,215680000,1,26960000
nn_kernel_cpu,35774,0,1,1,64,0,0,0,0,1,26970000
nn_kernel_gpu,1597,1,1,210704,128,0,0,0,0,1,26970000
nn_kernel_gpu_mem,45169,1,1,210704,128,215760000,107880000,107880000,215760000,1,26970000
nn_kernel_cpu,23201,0,1,1,64,0,0,0,0,1,26980000
nn_kernel_gpu,1607,1,1,210782,128,0,0,0,0,1,26980000
nn_kernel_gpu_mem,43924,1,1,210782,128,215840000,107920000,107920000,215840000,1,26980000
nn_kernel_cpu,27783,0,1,1,64,0,0,0,0,1,26990000
nn_kernel_gpu,1613,1,1,210860,128,0,0,0,0,1,26990000
nn_kernel_gpu_mem,42419,1,1,210860,128,215920000,107960000,107960000,215920000,1,26990000
nn_kernel_cpu,14744,0,1,1,64,0,0,0,0,1,27000000
nn_kernel_gpu,1640,1,1,210938,128,0,0,0,0,1,27000000
nn_kernel_gpu_mem,39082,1,1,210938,128,216000000,108000000,108000000,216000000,1,27000000
nn_kernel_cpu,23826,0,1,1,64,0,0,0,0,1,2700000
nn_kernel_gpu,216,1,1,21094,128,0,0,0,0,1,2700000
nn_kernel_gpu_mem,4524,1,1,21094,128,21600000,10800000,10800000,21600000,1,2700000
nn_kernel_cpu,30432,0,1,1,64,0,0,0,0,1,270000
nn_kernel_gpu,65,1,1,2110,128,0,0,0,0,1,270000
nn_kernel_gpu_mem,1051,1,1,2110,128,2160000,1080000,1080000,2160000,1,270000
nn_kernel_cpu,25169,0,1,1,64,0,0,0,0,1,27010000
nn_kernel_gpu,1616,1,1,211016,128,0,0,0,0,1,27010000
nn_kernel_gpu_mem,38599,1,1,211016,128,216080000,108040000,108040000,216080000,1,27010000
nn_kernel_cpu,19567,0,1,1,64,0,0,0,0,1,27020000
nn_kernel_gpu,1625,1,1,211094,128,0,0,0,0,1,27020000
nn_kernel_gpu_mem,42339,1,1,211094,128,216160000,108080000,108080000,216160000,1,27020000
nn_kernel_cpu,27984,0,1,1,64,0,0,0,0,1,27030000
nn_kernel_gpu,1631,1,1,211172,128,0,0,0,0,1,27030000
nn_kernel_gpu_mem,42297,1,1,211172,128,216240000,108120000,108120000,216240000,1,27030000
nn_kernel_cpu,21266,0,1,1,64,0,0,0,0,1,27040000
nn_kernel_gpu,1630,1,1,211250,128,0,0,0,0,1,27040000
nn_kernel_gpu_mem,47058,1,1,211250,128,216320000,108160000,108160000,216320000,1,27040000
nn_kernel_cpu,21147,0,1,1,64,0,0,0,0,1,27050000
nn_kernel_gpu,1644,1,1,211329,128,0,0,0,0,1,27050000
nn_kernel_gpu_mem,42183,1,1,211329,128,216400000,108200000,108200000,216400000,1,27050000
nn_kernel_cpu,14025,0,1,1,64,0,0,0,0,1,27060000
nn_kernel_gpu,1617,1,1,211407,128,0,0,0,0,1,27060000
nn_kernel_gpu_mem,41136,1,1,211407,128,216480000,108240000,108240000,216480000,1,27060000
nn_kernel_cpu,8063,0,1,1,64,0,0,0,0,1,27070000
nn_kernel_gpu,1609,1,1,211485,128,0,0,0,0,1,27070000
nn_kernel_gpu_mem,39010,1,1,211485,128,216560000,108280000,108280000,216560000,1,27070000
nn_kernel_cpu,16235,0,1,1,64,0,0,0,0,1,27080000
nn_kernel_gpu,1616,1,1,211563,128,0,0,0,0,1,27080000
nn_kernel_gpu_mem,40885,1,1,211563,128,216640000,108320000,108320000,216640000,1,27080000
nn_kernel_cpu,9148,0,1,1,64,0,0,0,0,1,27090000
nn_kernel_gpu,1613,1,1,211641,128,0,0,0,0,1,27090000
nn_kernel_gpu_mem,35597,1,1,211641,128,216720000,108360000,108360000,216720000,1,27090000
nn_kernel_cpu,14834,0,1,1,64,0,0,0,0,1,27100000
nn_kernel_gpu,1607,1,1,211719,128,0,0,0,0,1,27100000
nn_kernel_gpu_mem,37327,1,1,211719,128,216800000,108400000,108400000,216800000,1,27100000
nn_kernel_cpu,6518,0,1,1,64,0,0,0,0,1,2710000
nn_kernel_gpu,209,1,1,21172,128,0,0,0,0,1,2710000
nn_kernel_gpu_mem,12357,1,1,21172,128,21680000,10840000,10840000,21680000,1,2710000
nn_kernel_cpu,24854,0,1,1,64,0,0,0,0,1,27110000
nn_kernel_gpu,1635,1,1,211797,128,0,0,0,0,1,27110000
nn_kernel_gpu_mem,43037,1,1,211797,128,216880000,108440000,108440000,216880000,1,27110000
nn_kernel_cpu,16278,0,1,1,64,0,0,0,0,1,27120000
nn_kernel_gpu,1618,1,1,211875,128,0,0,0,0,1,27120000
nn_kernel_gpu_mem,34953,1,1,211875,128,216960000,108480000,108480000,216960000,1,27120000
nn_kernel_cpu,26128,0,1,1,64,0,0,0,0,1,27130000
nn_kernel_gpu,1623,1,1,211954,128,0,0,0,0,1,27130000
nn_kernel_gpu_mem,43653,1,1,211954,128,217040000,108520000,108520000,217040000,1,27130000
nn_kernel_cpu,33162,0,1,1,64,0,0,0,0,1,27140000
nn_kernel_gpu,1618,1,1,212032,128,0,0,0,0,1,27140000
nn_kernel_gpu_mem,42082,1,1,212032,128,217120000,108560000,108560000,217120000,1,27140000
nn_kernel_cpu,18448,0,1,1,64,0,0,0,0,1,27150000
nn_kernel_gpu,1626,1,1,212110,128,0,0,0,0,1,27150000
nn_kernel_gpu_mem,42050,1,1,212110,128,217200000,108600000,108600000,217200000,1,27150000
nn_kernel_cpu,39297,0,1,1,64,0,0,0,0,1,27160000
nn_kernel_gpu,1680,1,1,212188,128,0,0,0,0,1,27160000
nn_kernel_gpu_mem,38797,1,1,212188,128,217280000,108640000,108640000,217280000,1,27160000
nn_kernel_cpu,20138,0,1,1,64,0,0,0,0,1,27170000
nn_kernel_gpu,1629,1,1,212266,128,0,0,0,0,1,27170000
nn_kernel_gpu_mem,43384,1,1,212266,128,217360000,108680000,108680000,217360000,1,27170000
nn_kernel_cpu,14339,0,1,1,64,0,0,0,0,1,27180000
nn_kernel_gpu,1620,1,1,212344,128,0,0,0,0,1,27180000
nn_kernel_gpu_mem,43197,1,1,212344,128,217440000,108720000,108720000,217440000,1,27180000
nn_kernel_cpu,32997,0,1,1,64,0,0,0,0,1,27190000
nn_kernel_gpu,1632,1,1,212422,128,0,0,0,0,1,27190000
nn_kernel_gpu_mem,41776,1,1,212422,128,217520000,108760000,108760000,217520000,1,27190000
nn_kernel_cpu,15131,0,1,1,64,0,0,0,0,1,27200000
nn_kernel_gpu,1613,1,1,212500,128,0,0,0,0,1,27200000
nn_kernel_gpu_mem,39370,1,1,212500,128,217600000,108800000,108800000,217600000,1,27200000
nn_kernel_cpu,37182,0,1,1,64,0,0,0,0,1,2720000
nn_kernel_gpu,241,1,1,21250,128,0,0,0,0,1,2720000
nn_kernel_gpu_mem,4529,1,1,21250,128,21760000,10880000,10880000,21760000,1,2720000
nn_kernel_cpu,8338,0,1,1,64,0,0,0,0,1,27210000
nn_kernel_gpu,1639,1,1,212579,128,0,0,0,0,1,27210000
nn_kernel_gpu_mem,43196,1,1,212579,128,217680000,108840000,108840000,217680000,1,27210000
nn_kernel_cpu,20253,0,1,1,64,0,0,0,0,1,27220000
nn_kernel_gpu,1616,1,1,212657,128,0,0,0,0,1,27220000
nn_kernel_gpu_mem,40375,1,1,212657,128,217760000,108880000,108880000,217760000,1,27220000
nn_kernel_cpu,19487,0,1,1,64,0,0,0,0,1,27230000
nn_kernel_gpu,1639,1,1,212735,128,0,0,0,0,1,27230000
nn_kernel_gpu_mem,42752,1,1,212735,128,217840000,108920000,108920000,217840000,1,27230000
nn_kernel_cpu,35760,0,1,1,64,0,0,0,0,1,27240000
nn_kernel_gpu,1647,1,1,212813,128,0,0,0,0,1,27240000
nn_kernel_gpu_mem,37216,1,1,212813,128,217920000,108960000,108960000,217920000,1,27240000
nn_kernel_cpu,14830,0,1,1,64,0,0,0,0,1,27250000
nn_kernel_gpu,1625,1,1,212891,128,0,0,0,0,1,27250000
nn_kernel_gpu_mem,43846,1,1,212891,128,218000000,109000000,109000000,218000000,1,27250000
nn_kernel_cpu,25670,0,1,1,64,0,0,0,0,1,27260000
nn_kernel_gpu,1625,1,1,212969,128,0,0,0,0,1,27260000
nn_kernel_gpu_mem,43564,1,1,212969,128,218080000,109040000,109040000,218080000,1,27260000
nn_kernel_cpu,22939,0,1,1,64,0,0,0,0,1,27270000
nn_kernel_gpu,1641,1,1,213047,128,0,0,0,0,1,27270000
nn_kernel_gpu_mem,44856,1,1,213047,128,218160000,109080000,109080000,218160000,1,27270000
nn_kernel_cpu,26780,0,1,1,64,0,0,0,0,1,27280000
nn_kernel_gpu,1631,1,1,213125,128,0,0,0,0,1,27280000
nn_kernel_gpu_mem,43309,1,1,213125,128,218240000,109120000,109120000,218240000,1,27280000
nn_kernel_cpu,27969,0,1,1,64,0,0,0,0,1,27290000
nn_kernel_gpu,1643,1,1,213204,128,0,0,0,0,1,27290000
nn_kernel_gpu_mem,37881,1,1,213204,128,218320000,109160000,109160000,218320000,1,27290000
nn_kernel_cpu,24863,0,1,1,64,0,0,0,0,1,27300000
nn_kernel_gpu,1634,1,1,213282,128,0,0,0,0,1,27300000
nn_kernel_gpu_mem,44546,1,1,213282,128,218400000,109200000,109200000,218400000,1,27300000
nn_kernel_cpu,36838,0,1,1,64,0,0,0,0,1,2730000
nn_kernel_gpu,213,1,1,21329,128,0,0,0,0,1,2730000
nn_kernel_gpu_mem,5100,1,1,21329,128,21840000,10920000,10920000,21840000,1,2730000
nn_kernel_cpu,26660,0,1,1,64,0,0,0,0,1,27310000
nn_kernel_gpu,1624,1,1,213360,128,0,0,0,0,1,27310000
nn_kernel_gpu_mem,43305,1,1,213360,128,218480000,109240000,109240000,218480000,1,27310000
nn_kernel_cpu,16942,0,1,1,64,0,0,0,0,1,27320000
nn_kernel_gpu,1644,1,1,213438,128,0,0,0,0,1,27320000
nn_kernel_gpu_mem,38140,1,1,213438,128,218560000,109280000,109280000,218560000,1,27320000
nn_kernel_cpu,24318,0,1,1,64,0,0,0,0,1,27330000
nn_kernel_gpu,1639,1,1,213516,128,0,0,0,0,1,27330000
nn_kernel_gpu_mem,46489,1,1,213516,128,218640000,109320000,109320000,218640000,1,27330000
nn_kernel_cpu,16487,0,1,1,64,0,0,0,0,1,27340000
nn_kernel_gpu,1640,1,1,213594,128,0,0,0,0,1,27340000
nn_kernel_gpu_mem,42790,1,1,213594,128,218720000,109360000,109360000,218720000,1,27340000
nn_kernel_cpu,36854,0,1,1,64,0,0,0,0,1,27350000
nn_kernel_gpu,1625,1,1,213672,128,0,0,0,0,1,27350000
nn_kernel_gpu_mem,36005,1,1,213672,128,218800000,109400000,109400000,218800000,1,27350000
nn_kernel_cpu,25080,0,1,1,64,0,0,0,0,1,27360000
nn_kernel_gpu,1626,1,1,213750,128,0,0,0,0,1,27360000
nn_kernel_gpu_mem,36608,1,1,213750,128,218880000,109440000,109440000,218880000,1,27360000
nn_kernel_cpu,18196,0,1,1,64,0,0,0,0,1,27370000
nn_kernel_gpu,1659,1,1,213829,128,0,0,0,0,1,27370000
nn_kernel_gpu_mem,38464,1,1,213829,128,218960000,109480000,109480000,218960000,1,27370000
nn_kernel_cpu,24444,0,1,1,64,0,0,0,0,1,27380000
nn_kernel_gpu,1634,1,1,213907,128,0,0,0,0,1,27380000
nn_kernel_gpu_mem,38712,1,1,213907,128,219040000,109520000,109520000,219040000,1,27380000
nn_kernel_cpu,11248,0,1,1,64,0,0,0,0,1,27390000
nn_kernel_gpu,1634,1,1,213985,128,0,0,0,0,1,27390000
nn_kernel_gpu_mem,45447,1,1,213985,128,219120000,109560000,109560000,219120000,1,27390000
nn_kernel_cpu,8622,0,1,1,64,0,0,0,0,1,27400000
nn_kernel_gpu,1632,1,1,214063,128,0,0,0,0,1,27400000
nn_kernel_gpu_mem,37127,1,1,214063,128,219200000,109600000,109600000,219200000,1,27400000
nn_kernel_cpu,7417,0,1,1,64,0,0,0,0,1,2740000
nn_kernel_gpu,203,1,1,21407,128,0,0,0,0,1,2740000
nn_kernel_gpu_mem,4110,1,1,21407,128,21920000,10960000,10960000,21920000,1,2740000
nn_kernel_cpu,16907,0,1,1,64,0,0,0,0,1,27410000
nn_kernel_gpu,1638,1,1,214141,128,0,0,0,0,1,27410000
nn_kernel_gpu_mem,47421,1,1,214141,128,219280000,109640000,109640000,219280000,1,27410000
nn_kernel_cpu,19764,0,1,1,64,0,0,0,0,1,27420000
nn_kernel_gpu,1646,1,1,214219,128,0,0,0,0,1,27420000
nn_kernel_gpu_mem,43125,1,1,214219,128,219360000,109680000,109680000,219360000,1,27420000
nn_kernel_cpu,10859,0,1,1,64,0,0,0,0,1,27430000
nn_kernel_gpu,1631,1,1,214297,128,0,0,0,0,1,27430000
nn_kernel_gpu_mem,36929,1,1,214297,128,219440000,109720000,109720000,219440000,1,27430000
nn_kernel_cpu,14206,0,1,1,64,0,0,0,0,1,27440000
nn_kernel_gpu,1658,1,1,214375,128,0,0,0,0,1,27440000
nn_kernel_gpu_mem,48892,1,1,214375,128,219520000,109760000,109760000,219520000,1,27440000
nn_kernel_cpu,16135,0,1,1,64,0,0,0,0,1,27450000
nn_kernel_gpu,1637,1,1,214454,128,0,0,0,0,1,27450000
nn_kernel_gpu_mem,42598,1,1,214454,128,219600000,109800000,109800000,219600000,1,27450000
nn_kernel_cpu,23648,0,1,1,64,0,0,0,0,1,27460000
nn_kernel_gpu,1623,1,1,214532,128,0,0,0,0,1,27460000
nn_kernel_gpu_mem,42584,1,1,214532,128,219680000,109840000,109840000,219680000,1,27460000
nn_kernel_cpu,35677,0,1,1,64,0,0,0,0,1,27470000
nn_kernel_gpu,1650,1,1,214610,128,0,0,0,0,1,27470000
nn_kernel_gpu_mem,42099,1,1,214610,128,219760000,109880000,109880000,219760000,1,27470000
nn_kernel_cpu,10563,0,1,1,64,0,0,0,0,1,27480000
nn_kernel_gpu,1642,1,1,214688,128,0,0,0,0,1,27480000
nn_kernel_gpu_mem,36764,1,1,214688,128,219840000,109920000,109920000,219840000,1,27480000
nn_kernel_cpu,32674,0,1,1,64,0,0,0,0,1,27490000
nn_kernel_gpu,1674,1,1,214766,128,0,0,0,0,1,27490000
nn_kernel_gpu_mem,45532,1,1,214766,128,219920000,109960000,109960000,219920000,1,27490000
nn_kernel_cpu,23221,0,1,1,64,0,0,0,0,1,27500000
nn_kernel_gpu,1653,1,1,214844,128,0,0,0,0,1,27500000
nn_kernel_gpu_mem,43045,1,1,214844,128,220000000,110000000,110000000,220000000,1,27500000
nn_kernel_cpu,13754,0,1,1,64,0,0,0,0,1,2750000
nn_kernel_gpu,213,1,1,21485,128,0,0,0,0,1,2750000
nn_kernel_gpu_mem,5136,1,1,21485,128,22000000,11000000,11000000,22000000,1,2750000
nn_kernel_cpu,12717,0,1,1,64,0,0,0,0,1,27510000
nn_kernel_gpu,1657,1,1,214922,128,0,0,0,0,1,27510000
nn_kernel_gpu_mem,37422,1,1,214922,128,220080000,110040000,110040000,220080000,1,27510000
nn_kernel_cpu,13923,0,1,1,64,0,0,0,0,1,27520000
nn_kernel_gpu,1642,1,1,215000,128,0,0,0,0,1,27520000
nn_kernel_gpu_mem,43021,1,1,215000,128,220160000,110080000,110080000,220160000,1,27520000
nn_kernel_cpu,24157,0,1,1,64,0,0,0,0,1,27530000
nn_kernel_gpu,1649,1,1,215079,128,0,0,0,0,1,27530000
nn_kernel_gpu_mem,37285,1,1,215079,128,220240000,110120000,110120000,220240000,1,27530000
nn_kernel_cpu,32110,0,1,1,64,0,0,0,0,1,27540000
nn_kernel_gpu,1641,1,1,215157,128,0,0,0,0,1,27540000
nn_kernel_gpu_mem,35408,1,1,215157,128,220320000,110160000,110160000,220320000,1,27540000
nn_kernel_cpu,17952,0,1,1,64,0,0,0,0,1,27550000
nn_kernel_gpu,1632,1,1,215235,128,0,0,0,0,1,27550000
nn_kernel_gpu_mem,36892,1,1,215235,128,220400000,110200000,110200000,220400000,1,27550000
nn_kernel_cpu,10963,0,1,1,64,0,0,0,0,1,27560000
nn_kernel_gpu,1651,1,1,215313,128,0,0,0,0,1,27560000
nn_kernel_gpu_mem,42231,1,1,215313,128,220480000,110240000,110240000,220480000,1,27560000
nn_kernel_cpu,22096,0,1,1,64,0,0,0,0,1,27570000
nn_kernel_gpu,1641,1,1,215391,128,0,0,0,0,1,27570000
nn_kernel_gpu_mem,44994,1,1,215391,128,220560000,110280000,110280000,220560000,1,27570000
nn_kernel_cpu,25928,0,1,1,64,0,0,0,0,1,27580000
nn_kernel_gpu,1651,1,1,215469,128,0,0,0,0,1,27580000
nn_kernel_gpu_mem,46661,1,1,215469,128,220640000,110320000,110320000,220640000,1,27580000
nn_kernel_cpu,8583,0,1,1,64,0,0,0,0,1,27590000
nn_kernel_gpu,1640,1,1,215547,128,0,0,0,0,1,27590000
nn_kernel_gpu_mem,45129,1,1,215547,128,220720000,110360000,110360000,220720000,1,27590000
nn_kernel_cpu,18652,0,1,1,64,0,0,0,0,1,27600000
nn_kernel_gpu,1668,1,1,215625,128,0,0,0,0,1,27600000
nn_kernel_gpu_mem,40605,1,1,215625,128,220800000,110400000,110400000,220800000,1,27600000
nn_kernel_cpu,23627,0,1,1,64,0,0,0,0,1,2760000
nn_kernel_gpu,215,1,1,21563,128,0,0,0,0,1,2760000
nn_kernel_gpu_mem,4545,1,1,21563,128,22080000,11040000,11040000,22080000,1,2760000
nn_kernel_cpu,15946,0,1,1,64,0,0,0,0,1,27610000
nn_kernel_gpu,1661,1,1,215704,128,0,0,0,0,1,27610000
nn_kernel_gpu_mem,43788,1,1,215704,128,220880000,110440000,110440000,220880000,1,27610000
nn_kernel_cpu,11639,0,1,1,64,0,0,0,0,1,27620000
nn_kernel_gpu,1649,1,1,215782,128,0,0,0,0,1,27620000
nn_kernel_gpu_mem,39836,1,1,215782,128,220960000,110480000,110480000,220960000,1,27620000
nn_kernel_cpu,22107,0,1,1,64,0,0,0,0,1,27630000
nn_kernel_gpu,1643,1,1,215860,128,0,0,0,0,1,27630000
nn_kernel_gpu_mem,38583,1,1,215860,128,221040000,110520000,110520000,221040000,1,27630000
nn_kernel_cpu,14766,0,1,1,64,0,0,0,0,1,27640000
nn_kernel_gpu,1670,1,1,215938,128,0,0,0,0,1,27640000
nn_kernel_gpu_mem,36628,1,1,215938,128,221120000,110560000,110560000,221120000,1,27640000
nn_kernel_cpu,10890,0,1,1,64,0,0,0,0,1,27650000
nn_kernel_gpu,1633,1,1,216016,128,0,0,0,0,1,27650000
nn_kernel_gpu_mem,47349,1,1,216016,128,221200000,110600000,110600000,221200000,1,27650000
nn_kernel_cpu,11515,0,1,1,64,0,0,0,0,1,27660000
nn_kernel_gpu,1654,1,1,216094,128,0,0,0,0,1,27660000
nn_kernel_gpu_mem,47814,1,1,216094,128,221280000,110640000,110640000,221280000,1,27660000
nn_kernel_cpu,7629,0,1,1,64,0,0,0,0,1,27670000
nn_kernel_gpu,1642,1,1,216172,128,0,0,0,0,1,27670000
nn_kernel_gpu_mem,36410,1,1,216172,128,221360000,110680000,110680000,221360000,1,27670000
nn_kernel_cpu,22045,0,1,1,64,0,0,0,0,1,27680000
nn_kernel_gpu,1665,1,1,216250,128,0,0,0,0,1,27680000
nn_kernel_gpu_mem,37893,1,1,216250,128,221440000,110720000,110720000,221440000,1,27680000
nn_kernel_cpu,29817,0,1,1,64,0,0,0,0,1,27690000
nn_kernel_gpu,1679,1,1,216329,128,0,0,0,0,1,27690000
nn_kernel_gpu_mem,36420,1,1,216329,128,221520000,110760000,110760000,221520000,1,27690000
nn_kernel_cpu,27798,0,1,1,64,0,0,0,0,1,27700000
nn_kernel_gpu,1667,1,1,216407,128,0,0,0,0,1,27700000
nn_kernel_gpu_mem,43485,1,1,216407,128,221600000,110800000,110800000,221600000,1,27700000
nn_kernel_cpu,11786,0,1,1,64,0,0,0,0,1,2770000
nn_kernel_gpu,223,1,1,21641,128,0,0,0,0,1,2770000
nn_kernel_gpu_mem,4488,1,1,21641,128,22160000,11080000,11080000,22160000,1,2770000
nn_kernel_cpu,11952,0,1,1,64,0,0,0,0,1,27710000
nn_kernel_gpu,1676,1,1,216485,128,0,0,0,0,1,27710000
nn_kernel_gpu_mem,37307,1,1,216485,128,221680000,110840000,110840000,221680000,1,27710000
nn_kernel_cpu,22138,0,1,1,64,0,0,0,0,1,27720000
nn_kernel_gpu,1645,1,1,216563,128,0,0,0,0,1,27720000
nn_kernel_gpu_mem,35791,1,1,216563,128,221760000,110880000,110880000,221760000,1,27720000
nn_kernel_cpu,13907,0,1,1,64,0,0,0,0,1,27730000
nn_kernel_gpu,1662,1,1,216641,128,0,0,0,0,1,27730000
nn_kernel_gpu_mem,44139,1,1,216641,128,221840000,110920000,110920000,221840000,1,27730000
nn_kernel_cpu,12195,0,1,1,64,0,0,0,0,1,27740000
nn_kernel_gpu,1674,1,1,216719,128,0,0,0,0,1,27740000
nn_kernel_gpu_mem,42869,1,1,216719,128,221920000,110960000,110960000,221920000,1,27740000
nn_kernel_cpu,16196,0,1,1,64,0,0,0,0,1,27750000
nn_kernel_gpu,1659,1,1,216797,128,0,0,0,0,1,27750000
nn_kernel_gpu_mem,40455,1,1,216797,128,222000000,111000000,111000000,222000000,1,27750000
nn_kernel_cpu,23206,0,1,1,64,0,0,0,0,1,27760000
nn_kernel_gpu,1660,1,1,216875,128,0,0,0,0,1,27760000
nn_kernel_gpu_mem,43840,1,1,216875,128,222080000,111040000,111040000,222080000,1,27760000
nn_kernel_cpu,23056,0,1,1,64,0,0,0,0,1,27770000
nn_kernel_gpu,1683,1,1,216954,128,0,0,0,0,1,27770000
nn_kernel_gpu_mem,42626,1,1,216954,128,222160000,111080000,111080000,222160000,1,27770000
nn_kernel_cpu,27498,0,1,1,64,0,0,0,0,1,27780000
nn_kernel_gpu,1659,1,1,217032,128,0,0,0,0,1,27780000
nn_kernel_gpu_mem,39406,1,1,217032,128,222240000,111120000,111120000,222240000,1,27780000
nn_kernel_cpu,6194,0,1,1,64,0,0,0,0,1,27790000
nn_kernel_gpu,1669,1,1,217110,128,0,0,0,0,1,27790000
nn_kernel_gpu_mem,42371,1,1,217110,128,222320000,111160000,111160000,222320000,1,27790000
nn_kernel_cpu,10837,0,1,1,64,0,0,0,0,1,27800000
nn_kernel_gpu,1669,1,1,217188,128,0,0,0,0,1,27800000
nn_kernel_gpu_mem,45703,1,1,217188,128,222400000,111200000,111200000,222400000,1,27800000
nn_kernel_cpu,10116,0,1,1,64,0,0,0,0,1,2780000
nn_kernel_gpu,388,1,1,21719,128,0,0,0,0,1,2780000
nn_kernel_gpu_mem,4683,1,1,21719,128,22240000,11120000,11120000,22240000,1,2780000
nn_kernel_cpu,9470,0,1,1,64,0,0,0,0,1,27810000
nn_kernel_gpu,1653,1,1,217266,128,0,0,0,0,1,27810000
nn_kernel_gpu_mem,44169,1,1,217266,128,222480000,111240000,111240000,222480000,1,27810000
nn_kernel_cpu,24814,0,1,1,64,0,0,0,0,1,27820000
nn_kernel_gpu,1681,1,1,217344,128,0,0,0,0,1,27820000
nn_kernel_gpu_mem,44317,1,1,217344,128,222560000,111280000,111280000,222560000,1,27820000
nn_kernel_cpu,12146,0,1,1,64,0,0,0,0,1,27830000
nn_kernel_gpu,1667,1,1,217422,128,0,0,0,0,1,27830000
nn_kernel_gpu_mem,39740,1,1,217422,128,222640000,111320000,111320000,222640000,1,27830000
nn_kernel_cpu,24609,0,1,1,64,0,0,0,0,1,27840000
nn_kernel_gpu,1658,1,1,217500,128,0,0,0,0,1,27840000
nn_kernel_gpu_mem,35682,1,1,217500,128,222720000,111360000,111360000,222720000,1,27840000
nn_kernel_cpu,39084,0,1,1,64,0,0,0,0,1,27850000
nn_kernel_gpu,1657,1,1,217579,128,0,0,0,0,1,27850000
nn_kernel_gpu_mem,43533,1,1,217579,128,222800000,111400000,111400000,222800000,1,27850000
nn_kernel_cpu,10634,0,1,1,64,0,0,0,0,1,27860000
nn_kernel_gpu,1686,1,1,217657,128,0,0,0,0,1,27860000
nn_kernel_gpu_mem,43241,1,1,217657,128,222880000,111440000,111440000,222880000,1,27860000
nn_kernel_cpu,14496,0,1,1,64,0,0,0,0,1,27870000
nn_kernel_gpu,1678,1,1,217735,128,0,0,0,0,1,27870000
nn_kernel_gpu_mem,39022,1,1,217735,128,222960000,111480000,111480000,222960000,1,27870000
nn_kernel_cpu,22884,0,1,1,64,0,0,0,0,1,27880000
nn_kernel_gpu,1680,1,1,217813,128,0,0,0,0,1,27880000
nn_kernel_gpu_mem,37687,1,1,217813,128,223040000,111520000,111520000,223040000,1,27880000
nn_kernel_cpu,21457,0,1,1,64,0,0,0,0,1,27890000
nn_kernel_gpu,1679,1,1,217891,128,0,0,0,0,1,27890000
nn_kernel_gpu_mem,45254,1,1,217891,128,223120000,111560000,111560000,223120000,1,27890000
nn_kernel_cpu,13078,0,1,1,64,0,0,0,0,1,27900000
nn_kernel_gpu,1695,1,1,217969,128,0,0,0,0,1,27900000
nn_kernel_gpu_mem,43441,1,1,217969,128,223200000,111600000,111600000,223200000,1,27900000
nn_kernel_cpu,8171,0,1,1,64,0,0,0,0,1,2790000
nn_kernel_gpu,210,1,1,21797,128,0,0,0,0,1,2790000
nn_kernel_gpu_mem,4376,1,1,21797,128,22320000,11160000,11160000,22320000,1,2790000
nn_kernel_cpu,13903,0,1,1,64,0,0,0,0,1,27910000
nn_kernel_gpu,1679,1,1,218047,128,0,0,0,0,1,27910000
nn_kernel_gpu_mem,42826,1,1,218047,128,223280000,111640000,111640000,223280000,1,27910000
nn_kernel_cpu,16861,0,1,1,64,0,0,0,0,1,27920000
nn_kernel_gpu,1663,1,1,218125,128,0,0,0,0,1,27920000
nn_kernel_gpu_mem,38524,1,1,218125,128,223360000,111680000,111680000,223360000,1,27920000
nn_kernel_cpu,35774,0,1,1,64,0,0,0,0,1,27930000
nn_kernel_gpu,1667,1,1,218204,128,0,0,0,0,1,27930000
nn_kernel_gpu_mem,45273,1,1,218204,128,223440000,111720000,111720000,223440000,1,27930000
nn_kernel_cpu,14803,0,1,1,64,0,0,0,0,1,27940000
nn_kernel_gpu,1679,1,1,218282,128,0,0,0,0,1,27940000
nn_kernel_gpu_mem,37258,1,1,218282,128,223520000,111760000,111760000,223520000,1,27940000
nn_kernel_cpu,20381,0,1,1,64,0,0,0,0,1,27950000
nn_kernel_gpu,1688,1,1,218360,128,0,0,0,0,1,27950000
nn_kernel_gpu_mem,44506,1,1,218360,128,223600000,111800000,111800000,223600000,1,27950000
nn_kernel_cpu,19278,0,1,1,64,0,0,0,0,1,27960000
nn_kernel_gpu,1663,1,1,218438,128,0,0,0,0,1,27960000
nn_kernel_gpu_mem,37123,1,1,218438,128,223680000,111840000,111840000,223680000,1,27960000
nn_kernel_cpu,36113,0,1,1,64,0,0,0,0,1,27970000
nn_kernel_gpu,1677,1,1,218516,128,0,0,0,0,1,27970000
nn_kernel_gpu_mem,44988,1,1,218516,128,223760000,111880000,111880000,223760000,1,27970000
nn_kernel_cpu,39000,0,1,1,64,0,0,0,0,1,27980000
nn_kernel_gpu,1682,1,1,218594,128,0,0,0,0,1,27980000
nn_kernel_gpu_mem,39619,1,1,218594,128,223840000,111920000,111920000,223840000,1,27980000
nn_kernel_cpu,20134,0,1,1,64,0,0,0,0,1,27990000
nn_kernel_gpu,1661,1,1,218672,128,0,0,0,0,1,27990000
nn_kernel_gpu_mem,45483,1,1,218672,128,223920000,111960000,111960000,223920000,1,27990000
nn_kernel_cpu,19214,0,1,1,64,0,0,0,0,1,28000000
nn_kernel_gpu,1674,1,1,218750,128,0,0,0,0,1,28000000
nn_kernel_gpu_mem,41750,1,1,218750,128,224000000,112000000,112000000,224000000,1,28000000
nn_kernel_cpu,19539,0,1,1,64,0,0,0,0,1,2800000
nn_kernel_gpu,220,1,1,21875,128,0,0,0,0,1,2800000
nn_kernel_gpu_mem,4593,1,1,21875,128,22400000,11200000,11200000,22400000,1,2800000
nn_kernel_cpu,23402,0,1,1,64,0,0,0,0,1,280000
nn_kernel_gpu,54,1,1,2188,128,0,0,0,0,1,280000
nn_kernel_gpu_mem,712,1,1,2188,128,2240000,1120000,1120000,2240000,1,280000
nn_kernel_cpu,38069,0,1,1,64,0,0,0,0,1,28010000
nn_kernel_gpu,1682,1,1,218829,128,0,0,0,0,1,28010000
nn_kernel_gpu_mem,36484,1,1,218829,128,224080000,112040000,112040000,224080000,1,28010000
nn_kernel_cpu,30148,0,1,1,64,0,0,0,0,1,28020000
nn_kernel_gpu,1664,1,1,218907,128,0,0,0,0,1,28020000
nn_kernel_gpu_mem,42172,1,1,218907,128,224160000,112080000,112080000,224160000,1,28020000
nn_kernel_cpu,13149,0,1,1,64,0,0,0,0,1,28030000
nn_kernel_gpu,1669,1,1,218985,128,0,0,0,0,1,28030000
nn_kernel_gpu_mem,40948,1,1,218985,128,224240000,112120000,112120000,224240000,1,28030000
nn_kernel_cpu,18460,0,1,1,64,0,0,0,0,1,28040000
nn_kernel_gpu,1679,1,1,219063,128,0,0,0,0,1,28040000
nn_kernel_gpu_mem,44588,1,1,219063,128,224320000,112160000,112160000,224320000,1,28040000
nn_kernel_cpu,38526,0,1,1,64,0,0,0,0,1,28050000
nn_kernel_gpu,1675,1,1,219141,128,0,0,0,0,1,28050000
nn_kernel_gpu_mem,45390,1,1,219141,128,224400000,112200000,112200000,224400000,1,28050000
nn_kernel_cpu,11342,0,1,1,64,0,0,0,0,1,28060000
nn_kernel_gpu,1677,1,1,219219,128,0,0,0,0,1,28060000
nn_kernel_gpu_mem,45922,1,1,219219,128,224480000,112240000,112240000,224480000,1,28060000
nn_kernel_cpu,15573,0,1,1,64,0,0,0,0,1,28070000
nn_kernel_gpu,1667,1,1,219297,128,0,0,0,0,1,28070000
nn_kernel_gpu_mem,38817,1,1,219297,128,224560000,112280000,112280000,224560000,1,28070000
nn_kernel_cpu,14363,0,1,1,64,0,0,0,0,1,28080000
nn_kernel_gpu,1683,1,1,219375,128,0,0,0,0,1,28080000
nn_kernel_gpu_mem,44599,1,1,219375,128,224640000,112320000,112320000,224640000,1,28080000
nn_kernel_cpu,11439,0,1,1,64,0,0,0,0,1,28090000
nn_kernel_gpu,1686,1,1,219454,128,0,0,0,0,1,28090000
nn_kernel_gpu_mem,43959,1,1,219454,128,224720000,112360000,112360000,224720000,1,28090000
nn_kernel_cpu,8190,0,1,1,64,0,0,0,0,1,28100000
nn_kernel_gpu,1721,1,1,219532,128,0,0,0,0,1,28100000
nn_kernel_gpu_mem,43284,1,1,219532,128,224800000,112400000,112400000,224800000,1,28100000
nn_kernel_cpu,6888,0,1,1,64,0,0,0,0,1,2810000
nn_kernel_gpu,223,1,1,21954,128,0,0,0,0,1,2810000
nn_kernel_gpu_mem,4284,1,1,21954,128,22480000,11240000,11240000,22480000,1,2810000
nn_kernel_cpu,12685,0,1,1,64,0,0,0,0,1,28110000
nn_kernel_gpu,1707,1,1,219610,128,0,0,0,0,1,28110000
nn_kernel_gpu_mem,43316,1,1,219610,128,224880000,112440000,112440000,224880000,1,28110000
nn_kernel_cpu,13000,0,1,1,64,0,0,0,0,1,28120000
nn_kernel_gpu,1700,1,1,219688,128,0,0,0,0,1,28120000
nn_kernel_gpu_mem,43137,1,1,219688,128,224960000,112480000,112480000,224960000,1,28120000
nn_kernel_cpu,22670,0,1,1,64,0,0,0,0,1,28130000
nn_kernel_gpu,1673,1,1,219766,128,0,0,0,0,1,28130000
nn_kernel_gpu_mem,40507,1,1,219766,128,225040000,112520000,112520000,225040000,1,28130000
nn_kernel_cpu,16718,0,1,1,64,0,0,0,0,1,28140000
nn_kernel_gpu,1688,1,1,219844,128,0,0,0,0,1,28140000
nn_kernel_gpu_mem,39554,1,1,219844,128,225120000,112560000,112560000,225120000,1,28140000
nn_kernel_cpu,17921,0,1,1,64,0,0,0,0,1,28150000
nn_kernel_gpu,1677,1,1,219922,128,0,0,0,0,1,28150000
nn_kernel_gpu_mem,40306,1,1,219922,128,225200000,112600000,112600000,225200000,1,28150000
nn_kernel_cpu,26819,0,1,1,64,0,0,0,0,1,28160000
nn_kernel_gpu,1683,1,1,220000,128,0,0,0,0,1,28160000
nn_kernel_gpu_mem,42951,1,1,220000,128,225280000,112640000,112640000,225280000,1,28160000
nn_kernel_cpu,29065,0,1,1,64,0,0,0,0,1,28170000
nn_kernel_gpu,1675,1,1,220079,128,0,0,0,0,1,28170000
nn_kernel_gpu_mem,40411,1,1,220079,128,225360000,112680000,112680000,225360000,1,28170000
nn_kernel_cpu,18535,0,1,1,64,0,0,0,0,1,28180000
nn_kernel_gpu,1730,1,1,220157,128,0,0,0,0,1,28180000
nn_kernel_gpu_mem,37058,1,1,220157,128,225440000,112720000,112720000,225440000,1,28180000
nn_kernel_cpu,49183,0,1,1,64,0,0,0,0,1,28190000
nn_kernel_gpu,1708,1,1,220235,128,0,0,0,0,1,28190000
nn_kernel_gpu_mem,38447,1,1,220235,128,225520000,112760000,112760000,225520000,1,28190000
nn_kernel_cpu,11938,0,1,1,64,0,0,0,0,1,28200000
nn_kernel_gpu,1710,1,1,220313,128,0,0,0,0,1,28200000
nn_kernel_gpu_mem,43914,1,1,220313,128,225600000,112800000,112800000,225600000,1,28200000
nn_kernel_cpu,9131,0,1,1,64,0,0,0,0,1,2820000
nn_kernel_gpu,208,1,1,22032,128,0,0,0,0,1,2820000
nn_kernel_gpu_mem,4679,1,1,22032,128,22560000,11280000,11280000,22560000,1,2820000
nn_kernel_cpu,23944,0,1,1,64,0,0,0,0,1,28210000
nn_kernel_gpu,1705,1,1,220391,128,0,0,0,0,1,28210000
nn_kernel_gpu_mem,47112,1,1,220391,128,225680000,112840000,112840000,225680000,1,28210000
nn_kernel_cpu,33958,0,1,1,64,0,0,0,0,1,28220000
nn_kernel_gpu,1698,1,1,220469,128,0,0,0,0,1,28220000
nn_kernel_gpu_mem,38943,1,1,220469,128,225760000,112880000,112880000,225760000,1,28220000
nn_kernel_cpu,17467,0,1,1,64,0,0,0,0,1,28230000
nn_kernel_gpu,1686,1,1,220547,128,0,0,0,0,1,28230000
nn_kernel_gpu_mem,43450,1,1,220547,128,225840000,112920000,112920000,225840000,1,28230000
nn_kernel_cpu,14754,0,1,1,64,0,0,0,0,1,28240000
nn_kernel_gpu,1695,1,1,220625,128,0,0,0,0,1,28240000
nn_kernel_gpu_mem,42834,1,1,220625,128,225920000,112960000,112960000,225920000,1,28240000
nn_kernel_cpu,23059,0,1,1,64,0,0,0,0,1,28250000
nn_kernel_gpu,1681,1,1,220704,128,0,0,0,0,1,28250000
nn_kernel_gpu_mem,45371,1,1,220704,128,226000000,113000000,113000000,226000000,1,28250000
nn_kernel_cpu,12537,0,1,1,64,0,0,0,0,1,28260000
nn_kernel_gpu,1708,1,1,220782,128,0,0,0,0,1,28260000
nn_kernel_gpu_mem,43441,1,1,220782,128,226080000,113040000,113040000,226080000,1,28260000
nn_kernel_cpu,17819,0,1,1,64,0,0,0,0,1,28270000
nn_kernel_gpu,1713,1,1,220860,128,0,0,0,0,1,28270000
nn_kernel_gpu_mem,43488,1,1,220860,128,226160000,113080000,113080000,226160000,1,28270000
nn_kernel_cpu,26009,0,1,1,64,0,0,0,0,1,28280000
nn_kernel_gpu,1712,1,1,220938,128,0,0,0,0,1,28280000
nn_kernel_gpu_mem,39396,1,1,220938,128,226240000,113120000,113120000,226240000,1,28280000
nn_kernel_cpu,26391,0,1,1,64,0,0,0,0,1,28290000
nn_kernel_gpu,1716,1,1,221016,128,0,0,0,0,1,28290000
nn_kernel_gpu_mem,45684,1,1,221016,128,226320000,113160000,113160000,226320000,1,28290000
nn_kernel_cpu,21314,0,1,1,64,0,0,0,0,1,28300000
nn_kernel_gpu,1698,1,1,221094,128,0,0,0,0,1,28300000
nn_kernel_gpu_mem,42699,1,1,221094,128,226400000,113200000,113200000,226400000,1,28300000
nn_kernel_cpu,13144,0,1,1,64,0,0,0,0,1,2830000
nn_kernel_gpu,217,1,1,22110,128,0,0,0,0,1,2830000
nn_kernel_gpu_mem,4372,1,1,22110,128,22640000,11320000,11320000,22640000,1,2830000
nn_kernel_cpu,16483,0,1,1,64,0,0,0,0,1,28310000
nn_kernel_gpu,1694,1,1,221172,128,0,0,0,0,1,28310000
nn_kernel_gpu_mem,38598,1,1,221172,128,226480000,113240000,113240000,226480000,1,28310000
nn_kernel_cpu,13153,0,1,1,64,0,0,0,0,1,28320000
nn_kernel_gpu,1710,1,1,221250,128,0,0,0,0,1,28320000
nn_kernel_gpu_mem,51350,1,1,221250,128,226560000,113280000,113280000,226560000,1,28320000
nn_kernel_cpu,16296,0,1,1,64,0,0,0,0,1,28330000
nn_kernel_gpu,1696,1,1,221329,128,0,0,0,0,1,28330000
nn_kernel_gpu_mem,44479,1,1,221329,128,226640000,113320000,113320000,226640000,1,28330000
nn_kernel_cpu,29669,0,1,1,64,0,0,0,0,1,28340000
nn_kernel_gpu,1682,1,1,221407,128,0,0,0,0,1,28340000
nn_kernel_gpu_mem,41993,1,1,221407,128,226720000,113360000,113360000,226720000,1,28340000
nn_kernel_cpu,31474,0,1,1,64,0,0,0,0,1,28350000
nn_kernel_gpu,1679,1,1,221485,128,0,0,0,0,1,28350000
nn_kernel_gpu_mem,45409,1,1,221485,128,226800000,113400000,113400000,226800000,1,28350000
nn_kernel_cpu,24819,0,1,1,64,0,0,0,0,1,28360000
nn_kernel_gpu,1698,1,1,221563,128,0,0,0,0,1,28360000
nn_kernel_gpu_mem,45473,1,1,221563,128,226880000,113440000,113440000,226880000,1,28360000
nn_kernel_cpu,24502,0,1,1,64,0,0,0,0,1,28370000
nn_kernel_gpu,1716,1,1,221641,128,0,0,0,0,1,28370000
nn_kernel_gpu_mem,44342,1,1,221641,128,226960000,113480000,113480000,226960000,1,28370000
nn_kernel_cpu,33889,0,1,1,64,0,0,0,0,1,28380000
nn_kernel_gpu,1695,1,1,221719,128,0,0,0,0,1,28380000
nn_kernel_gpu_mem,41253,1,1,221719,128,227040000,113520000,113520000,227040000,1,28380000
nn_kernel_cpu,30362,0,1,1,64,0,0,0,0,1,28390000
nn_kernel_gpu,1717,1,1,221797,128,0,0,0,0,1,28390000
nn_kernel_gpu_mem,47880,1,1,221797,128,227120000,113560000,113560000,227120000,1,28390000
nn_kernel_cpu,18420,0,1,1,64,0,0,0,0,1,28400000
nn_kernel_gpu,1689,1,1,221875,128,0,0,0,0,1,28400000
nn_kernel_gpu_mem,45033,1,1,221875,128,227200000,113600000,113600000,227200000,1,28400000
nn_kernel_cpu,22057,0,1,1,64,0,0,0,0,1,2840000
nn_kernel_gpu,210,1,1,22188,128,0,0,0,0,1,2840000
nn_kernel_gpu_mem,4414,1,1,22188,128,22720000,11360000,11360000,22720000,1,2840000
nn_kernel_cpu,28022,0,1,1,64,0,0,0,0,1,28410000
nn_kernel_gpu,1703,1,1,221954,128,0,0,0,0,1,28410000
nn_kernel_gpu_mem,46026,1,1,221954,128,227280000,113640000,113640000,227280000,1,28410000
nn_kernel_cpu,36698,0,1,1,64,0,0,0,0,1,28420000
nn_kernel_gpu,1721,1,1,222032,128,0,0,0,0,1,28420000
nn_kernel_gpu_mem,55737,1,1,222032,128,227360000,113680000,113680000,227360000,1,28420000
nn_kernel_cpu,9219,0,1,1,64,0,0,0,0,1,28430000
nn_kernel_gpu,1711,1,1,222110,128,0,0,0,0,1,28430000
nn_kernel_gpu_mem,44593,1,1,222110,128,227440000,113720000,113720000,227440000,1,28430000
nn_kernel_cpu,51435,0,1,1,64,0,0,0,0,1,28440000
nn_kernel_gpu,1700,1,1,222188,128,0,0,0,0,1,28440000
nn_kernel_gpu_mem,43366,1,1,222188,128,227520000,113760000,113760000,227520000,1,28440000
nn_kernel_cpu,31335,0,1,1,64,0,0,0,0,1,28450000
nn_kernel_gpu,1697,1,1,222266,128,0,0,0,0,1,28450000
nn_kernel_gpu_mem,42026,1,1,222266,128,227600000,113800000,113800000,227600000,1,28450000
nn_kernel_cpu,13340,0,1,1,64,0,0,0,0,1,28460000
nn_kernel_gpu,1708,1,1,222344,128,0,0,0,0,1,28460000
nn_kernel_gpu_mem,44500,1,1,222344,128,227680000,113840000,113840000,227680000,1,28460000
nn_kernel_cpu,11969,0,1,1,64,0,0,0,0,1,28470000
nn_kernel_gpu,1694,1,1,222422,128,0,0,0,0,1,28470000
nn_kernel_gpu_mem,43459,1,1,222422,128,227760000,113880000,113880000,227760000,1,28470000
nn_kernel_cpu,24260,0,1,1,64,0,0,0,0,1,28480000
nn_kernel_gpu,1708,1,1,222500,128,0,0,0,0,1,28480000
nn_kernel_gpu_mem,55598,1,1,222500,128,227840000,113920000,113920000,227840000,1,28480000
nn_kernel_cpu,26033,0,1,1,64,0,0,0,0,1,28490000
nn_kernel_gpu,1715,1,1,222579,128,0,0,0,0,1,28490000
nn_kernel_gpu_mem,44577,1,1,222579,128,227920000,113960000,113960000,227920000,1,28490000
nn_kernel_cpu,22631,0,1,1,64,0,0,0,0,1,28500000
nn_kernel_gpu,1687,1,1,222657,128,0,0,0,0,1,28500000
nn_kernel_gpu_mem,37930,1,1,222657,128,228000000,114000000,114000000,228000000,1,28500000
nn_kernel_cpu,6414,0,1,1,64,0,0,0,0,1,2850000
nn_kernel_gpu,226,1,1,22266,128,0,0,0,0,1,2850000
nn_kernel_gpu_mem,4573,1,1,22266,128,22800000,11400000,11400000,22800000,1,2850000
nn_kernel_cpu,27709,0,1,1,64,0,0,0,0,1,28510000
nn_kernel_gpu,1711,1,1,222735,128,0,0,0,0,1,28510000
nn_kernel_gpu_mem,43038,1,1,222735,128,228080000,114040000,114040000,228080000,1,28510000
nn_kernel_cpu,25149,0,1,1,64,0,0,0,0,1,28520000
nn_kernel_gpu,1726,1,1,222813,128,0,0,0,0,1,28520000
nn_kernel_gpu_mem,36686,1,1,222813,128,228160000,114080000,114080000,228160000,1,28520000
nn_kernel_cpu,33260,0,1,1,64,0,0,0,0,1,28530000
nn_kernel_gpu,1703,1,1,222891,128,0,0,0,0,1,28530000
nn_kernel_gpu_mem,40904,1,1,222891,128,228240000,114120000,114120000,228240000,1,28530000
nn_kernel_cpu,23731,0,1,1,64,0,0,0,0,1,28540000
nn_kernel_gpu,1713,1,1,222969,128,0,0,0,0,1,28540000
nn_kernel_gpu_mem,40624,1,1,222969,128,228320000,114160000,114160000,228320000,1,28540000
nn_kernel_cpu,50376,0,1,1,64,0,0,0,0,1,28550000
nn_kernel_gpu,1707,1,1,223047,128,0,0,0,0,1,28550000
nn_kernel_gpu_mem,38928,1,1,223047,128,228400000,114200000,114200000,228400000,1,28550000
nn_kernel_cpu,22111,0,1,1,64,0,0,0,0,1,28560000
nn_kernel_gpu,1694,1,1,223125,128,0,0,0,0,1,28560000
nn_kernel_gpu_mem,41181,1,1,223125,128,228480000,114240000,114240000,228480000,1,28560000
nn_kernel_cpu,50469,0,1,1,64,0,0,0,0,1,28570000
nn_kernel_gpu,1704,1,1,223204,128,0,0,0,0,1,28570000
nn_kernel_gpu_mem,47533,1,1,223204,128,228560000,114280000,114280000,228560000,1,28570000
nn_kernel_cpu,22900,0,1,1,64,0,0,0,0,1,28580000
nn_kernel_gpu,1699,1,1,223282,128,0,0,0,0,1,28580000
nn_kernel_gpu_mem,40167,1,1,223282,128,228640000,114320000,114320000,228640000,1,28580000
nn_kernel_cpu,10800,0,1,1,64,0,0,0,0,1,28590000
nn_kernel_gpu,1720,1,1,223360,128,0,0,0,0,1,28590000
nn_kernel_gpu_mem,38562,1,1,223360,128,228720000,114360000,114360000,228720000,1,28590000
nn_kernel_cpu,28070,0,1,1,64,0,0,0,0,1,28600000
nn_kernel_gpu,1708,1,1,223438,128,0,0,0,0,1,28600000
nn_kernel_gpu_mem,43753,1,1,223438,128,228800000,114400000,114400000,228800000,1,28600000
nn_kernel_cpu,9448,0,1,1,64,0,0,0,0,1,2860000
nn_kernel_gpu,224,1,1,22344,128,0,0,0,0,1,2860000
nn_kernel_gpu_mem,4631,1,1,22344,128,22880000,11440000,11440000,22880000,1,2860000
nn_kernel_cpu,14428,0,1,1,64,0,0,0,0,1,28610000
nn_kernel_gpu,1697,1,1,223516,128,0,0,0,0,1,28610000
nn_kernel_gpu_mem,40039,1,1,223516,128,228880000,114440000,114440000,228880000,1,28610000
nn_kernel_cpu,19604,0,1,1,64,0,0,0,0,1,28620000
nn_kernel_gpu,1699,1,1,223594,128,0,0,0,0,1,28620000
nn_kernel_gpu_mem,37316,1,1,223594,128,228960000,114480000,114480000,228960000,1,28620000
nn_kernel_cpu,23566,0,1,1,64,0,0,0,0,1,28630000
nn_kernel_gpu,1713,1,1,223672,128,0,0,0,0,1,28630000
nn_kernel_gpu_mem,44227,1,1,223672,128,229040000,114520000,114520000,229040000,1,28630000
nn_kernel_cpu,38352,0,1,1,64,0,0,0,0,1,28640000
nn_kernel_gpu,1731,1,1,223750,128,0,0,0,0,1,28640000
nn_kernel_gpu_mem,36189,1,1,223750,128,229120000,114560000,114560000,229120000,1,28640000
nn_kernel_cpu,24526,0,1,1,64,0,0,0,0,1,28650000
nn_kernel_gpu,1724,1,1,223829,128,0,0,0,0,1,28650000
nn_kernel_gpu_mem,44922,1,1,223829,128,229200000,114600000,114600000,229200000,1,28650000
nn_kernel_cpu,21581,0,1,1,64,0,0,0,0,1,28660000
nn_kernel_gpu,1691,1,1,223907,128,0,0,0,0,1,28660000
nn_kernel_gpu_mem,39898,1,1,223907,128,229280000,114640000,114640000,229280000,1,28660000
nn_kernel_cpu,26307,0,1,1,64,0,0,0,0,1,28670000
nn_kernel_gpu,1694,1,1,223985,128,0,0,0,0,1,28670000
nn_kernel_gpu_mem,44951,1,1,223985,128,229360000,114680000,114680000,229360000,1,28670000
nn_kernel_cpu,13659,0,1,1,64,0,0,0,0,1,28680000
nn_kernel_gpu,1708,1,1,224063,128,0,0,0,0,1,28680000
nn_kernel_gpu_mem,37969,1,1,224063,128,229440000,114720000,114720000,229440000,1,28680000
nn_kernel_cpu,20591,0,1,1,64,0,0,0,0,1,28690000
nn_kernel_gpu,1709,1,1,224141,128,0,0,0,0,1,28690000
nn_kernel_gpu_mem,37929,1,1,224141,128,229520000,114760000,114760000,229520000,1,28690000
nn_kernel_cpu,18302,0,1,1,64,0,0,0,0,1,28700000
nn_kernel_gpu,1719,1,1,224219,128,0,0,0,0,1,28700000
nn_kernel_gpu_mem,43913,1,1,224219,128,229600000,114800000,114800000,229600000,1,28700000
nn_kernel_cpu,21220,0,1,1,64,0,0,0,0,1,2870000
nn_kernel_gpu,206,1,1,22422,128,0,0,0,0,1,2870000
nn_kernel_gpu_mem,4753,1,1,22422,128,22960000,11480000,11480000,22960000,1,2870000
nn_kernel_cpu,23281,0,1,1,64,0,0,0,0,1,28710000
nn_kernel_gpu,1701,1,1,224297,128,0,0,0,0,1,28710000
nn_kernel_gpu_mem,43200,1,1,224297,128,229680000,114840000,114840000,229680000,1,28710000
nn_kernel_cpu,16135,0,1,1,64,0,0,0,0,1,28720000
nn_kernel_gpu,1715,1,1,224375,128,0,0,0,0,1,28720000
nn_kernel_gpu_mem,36943,1,1,224375,128,229760000,114880000,114880000,229760000,1,28720000
nn_kernel_cpu,21341,0,1,1,64,0,0,0,0,1,28730000
nn_kernel_gpu,1733,1,1,224454,128,0,0,0,0,1,28730000
nn_kernel_gpu_mem,39077,1,1,224454,128,229840000,114920000,114920000,229840000,1,28730000
nn_kernel_cpu,8152,0,1,1,64,0,0,0,0,1,28740000
nn_kernel_gpu,1703,1,1,224532,128,0,0,0,0,1,28740000
nn_kernel_gpu_mem,39318,1,1,224532,128,229920000,114960000,114960000,229920000,1,28740000
nn_kernel_cpu,18705,0,1,1,64,0,0,0,0,1,28750000
nn_kernel_gpu,1703,1,1,224610,128,0,0,0,0,1,28750000
nn_kernel_gpu_mem,38375,1,1,224610,128,230000000,115000000,115000000,230000000,1,28750000
nn_kernel_cpu,23487,0,1,1,64,0,0,0,0,1,28760000
nn_kernel_gpu,1704,1,1,224688,128,0,0,0,0,1,28760000
nn_kernel_gpu_mem,38642,1,1,224688,128,230080000,115040000,115040000,230080000,1,28760000
nn_kernel_cpu,32724,0,1,1,64,0,0,0,0,1,28770000
nn_kernel_gpu,1709,1,1,224766,128,0,0,0,0,1,28770000
nn_kernel_gpu_mem,49414,1,1,224766,128,230160000,115080000,115080000,230160000,1,28770000
nn_kernel_cpu,9629,0,1,1,64,0,0,0,0,1,28780000
nn_kernel_gpu,1737,1,1,224844,128,0,0,0,0,1,28780000
nn_kernel_gpu_mem,38212,1,1,224844,128,230240000,115120000,115120000,230240000,1,28780000
nn_kernel_cpu,19300,0,1,1,64,0,0,0,0,1,28790000
nn_kernel_gpu,1708,1,1,224922,128,0,0,0,0,1,28790000
nn_kernel_gpu_mem,37349,1,1,224922,128,230320000,115160000,115160000,230320000,1,28790000
nn_kernel_cpu,24816,0,1,1,64,0,0,0,0,1,28800000
nn_kernel_gpu,1717,1,1,225000,128,0,0,0,0,1,28800000
nn_kernel_gpu_mem,41314,1,1,225000,128,230400000,115200000,115200000,230400000,1,28800000
nn_kernel_cpu,14341,0,1,1,64,0,0,0,0,1,2880000
nn_kernel_gpu,231,1,1,22500,128,0,0,0,0,1,2880000
nn_kernel_gpu_mem,4659,1,1,22500,128,23040000,11520000,11520000,23040000,1,2880000
nn_kernel_cpu,18044,0,1,1,64,0,0,0,0,1,28810000
nn_kernel_gpu,1727,1,1,225079,128,0,0,0,0,1,28810000
nn_kernel_gpu_mem,44610,1,1,225079,128,230480000,115240000,115240000,230480000,1,28810000
nn_kernel_cpu,15850,0,1,1,64,0,0,0,0,1,28820000
nn_kernel_gpu,1730,1,1,225157,128,0,0,0,0,1,28820000
nn_kernel_gpu_mem,40266,1,1,225157,128,230560000,115280000,115280000,230560000,1,28820000
nn_kernel_cpu,30686,0,1,1,64,0,0,0,0,1,28830000
nn_kernel_gpu,1728,1,1,225235,128,0,0,0,0,1,28830000
nn_kernel_gpu_mem,43868,1,1,225235,128,230640000,115320000,115320000,230640000,1,28830000
nn_kernel_cpu,19283,0,1,1,64,0,0,0,0,1,28840000
nn_kernel_gpu,1712,1,1,225313,128,0,0,0,0,1,28840000
nn_kernel_gpu_mem,37790,1,1,225313,128,230720000,115360000,115360000,230720000,1,28840000
nn_kernel_cpu,41458,0,1,1,64,0,0,0,0,1,28850000
nn_kernel_gpu,1709,1,1,225391,128,0,0,0,0,1,28850000
nn_kernel_gpu_mem,35959,1,1,225391,128,230800000,115400000,115400000,230800000,1,28850000
nn_kernel_cpu,21945,0,1,1,64,0,0,0,0,1,28860000
nn_kernel_gpu,1707,1,1,225469,128,0,0,0,0,1,28860000
nn_kernel_gpu_mem,36410,1,1,225469,128,230880000,115440000,115440000,230880000,1,28860000
nn_kernel_cpu,17009,0,1,1,64,0,0,0,0,1,28870000
nn_kernel_gpu,1743,1,1,225547,128,0,0,0,0,1,28870000
nn_kernel_gpu_mem,44779,1,1,225547,128,230960000,115480000,115480000,230960000,1,28870000
nn_kernel_cpu,28073,0,1,1,64,0,0,0,0,1,28880000
nn_kernel_gpu,1764,1,1,225625,128,0,0,0,0,1,28880000
nn_kernel_gpu_mem,37573,1,1,225625,128,231040000,115520000,115520000,231040000,1,28880000
nn_kernel_cpu,11312,0,1,1,64,0,0,0,0,1,28890000
nn_kernel_gpu,1722,1,1,225704,128,0,0,0,0,1,28890000
nn_kernel_gpu_mem,45688,1,1,225704,128,231120000,115560000,115560000,231120000,1,28890000
nn_kernel_cpu,9083,0,1,1,64,0,0,0,0,1,28900000
nn_kernel_gpu,1713,1,1,225782,128,0,0,0,0,1,28900000
nn_kernel_gpu_mem,41580,1,1,225782,128,231200000,115600000,115600000,231200000,1,28900000
nn_kernel_cpu,12434,0,1,1,64,0,0,0,0,1,2890000
nn_kernel_gpu,230,1,1,22579,128,0,0,0,0,1,2890000
nn_kernel_gpu_mem,4444,1,1,22579,128,23120000,11560000,11560000,23120000,1,2890000
nn_kernel_cpu,26722,0,1,1,64,0,0,0,0,1,28910000
nn_kernel_gpu,1715,1,1,225860,128,0,0,0,0,1,28910000
nn_kernel_gpu_mem,44039,1,1,225860,128,231280000,115640000,115640000,231280000,1,28910000
nn_kernel_cpu,36695,0,1,1,64,0,0,0,0,1,28920000
nn_kernel_gpu,1743,1,1,225938,128,0,0,0,0,1,28920000
nn_kernel_gpu_mem,38557,1,1,225938,128,231360000,115680000,115680000,231360000,1,28920000
nn_kernel_cpu,16609,0,1,1,64,0,0,0,0,1,28930000
nn_kernel_gpu,1743,1,1,226016,128,0,0,0,0,1,28930000
nn_kernel_gpu_mem,41100,1,1,226016,128,231440000,115720000,115720000,231440000,1,28930000
nn_kernel_cpu,14201,0,1,1,64,0,0,0,0,1,28940000
nn_kernel_gpu,1713,1,1,226094,128,0,0,0,0,1,28940000
nn_kernel_gpu_mem,38213,1,1,226094,128,231520000,115760000,115760000,231520000,1,28940000
nn_kernel_cpu,31019,0,1,1,64,0,0,0,0,1,28950000
nn_kernel_gpu,1711,1,1,226172,128,0,0,0,0,1,28950000
nn_kernel_gpu_mem,38702,1,1,226172,128,231600000,115800000,115800000,231600000,1,28950000
nn_kernel_cpu,20240,0,1,1,64,0,0,0,0,1,28960000
nn_kernel_gpu,1710,1,1,226250,128,0,0,0,0,1,28960000
nn_kernel_gpu_mem,47168,1,1,226250,128,231680000,115840000,115840000,231680000,1,28960000
nn_kernel_cpu,30066,0,1,1,64,0,0,0,0,1,28970000
nn_kernel_gpu,1717,1,1,226329,128,0,0,0,0,1,28970000
nn_kernel_gpu_mem,37908,1,1,226329,128,231760000,115880000,115880000,231760000,1,28970000
nn_kernel_cpu,9882,0,1,1,64,0,0,0,0,1,28980000
nn_kernel_gpu,1737,1,1,226407,128,0,0,0,0,1,28980000
nn_kernel_gpu_mem,46155,1,1,226407,128,231840000,115920000,115920000,231840000,1,28980000
nn_kernel_cpu,29101,0,1,1,64,0,0,0,0,1,28990000
nn_kernel_gpu,1721,1,1,226485,128,0,0,0,0,1,28990000
nn_kernel_gpu_mem,39101,1,1,226485,128,231920000,115960000,115960000,231920000,1,28990000
nn_kernel_cpu,14244,0,1,1,64,0,0,0,0,1,29000000
nn_kernel_gpu,1738,1,1,226563,128,0,0,0,0,1,29000000
nn_kernel_gpu_mem,44951,1,1,226563,128,232000000,116000000,116000000,232000000,1,29000000
nn_kernel_cpu,7255,0,1,1,64,0,0,0,0,1,2900000
nn_kernel_gpu,236,1,1,22657,128,0,0,0,0,1,2900000
nn_kernel_gpu_mem,4525,1,1,22657,128,23200000,11600000,11600000,23200000,1,2900000
nn_kernel_cpu,27034,0,1,1,64,0,0,0,0,1,290000
nn_kernel_gpu,78,1,1,2266,128,0,0,0,0,1,290000
nn_kernel_gpu_mem,1207,1,1,2266,128,2320000,1160000,1160000,2320000,1,290000
nn_kernel_cpu,17034,0,1,1,64,0,0,0,0,1,29010000
nn_kernel_gpu,1732,1,1,226641,128,0,0,0,0,1,29010000
nn_kernel_gpu_mem,44370,1,1,226641,128,232080000,116040000,116040000,232080000,1,29010000
nn_kernel_cpu,30509,0,1,1,64,0,0,0,0,1,29020000
nn_kernel_gpu,1751,1,1,226719,128,0,0,0,0,1,29020000
nn_kernel_gpu_mem,46184,1,1,226719,128,232160000,116080000,116080000,232160000,1,29020000
nn_kernel_cpu,24048,0,1,1,64,0,0,0,0,1,29030000
nn_kernel_gpu,1727,1,1,226797,128,0,0,0,0,1,29030000
nn_kernel_gpu_mem,39368,1,1,226797,128,232240000,116120000,116120000,232240000,1,29030000
nn_kernel_cpu,26958,0,1,1,64,0,0,0,0,1,29040000
nn_kernel_gpu,1731,1,1,226875,128,0,0,0,0,1,29040000
nn_kernel_gpu_mem,44764,1,1,226875,128,232320000,116160000,116160000,232320000,1,29040000
nn_kernel_cpu,26452,0,1,1,64,0,0,0,0,1,29050000
nn_kernel_gpu,1733,1,1,226954,128,0,0,0,0,1,29050000
nn_kernel_gpu_mem,46529,1,1,226954,128,232400000,116200000,116200000,232400000,1,29050000
nn_kernel_cpu,27131,0,1,1,64,0,0,0,0,1,29060000
nn_kernel_gpu,1736,1,1,227032,128,0,0,0,0,1,29060000
nn_kernel_gpu_mem,43235,1,1,227032,128,232480000,116240000,116240000,232480000,1,29060000
nn_kernel_cpu,24724,0,1,1,64,0,0,0,0,1,29070000
nn_kernel_gpu,1743,1,1,227110,128,0,0,0,0,1,29070000
nn_kernel_gpu_mem,42848,1,1,227110,128,232560000,116280000,116280000,232560000,1,29070000
nn_kernel_cpu,27735,0,1,1,64,0,0,0,0,1,29080000
nn_kernel_gpu,1737,1,1,227188,128,0,0,0,0,1,29080000
nn_kernel_gpu_mem,43841,1,1,227188,128,232640000,116320000,116320000,232640000,1,29080000
nn_kernel_cpu,35885,0,1,1,64,0,0,0,0,1,29090000
nn_kernel_gpu,1745,1,1,227266,128,0,0,0,0,1,29090000
nn_kernel_gpu_mem,46582,1,1,227266,128,232720000,116360000,116360000,232720000,1,29090000
nn_kernel_cpu,28553,0,1,1,64,0,0,0,0,1,29100000
nn_kernel_gpu,1754,1,1,227344,128,0,0,0,0,1,29100000
nn_kernel_gpu_mem,47574,1,1,227344,128,232800000,116400000,116400000,232800000,1,29100000
nn_kernel_cpu,16033,0,1,1,64,0,0,0,0,1,2910000
nn_kernel_gpu,219,1,1,22735,128,0,0,0,0,1,2910000
nn_kernel_gpu_mem,8802,1,1,22735,128,23280000,11640000,11640000,23280000,1,2910000
nn_kernel_cpu,22067,0,1,1,64,0,0,0,0,1,29110000
nn_kernel_gpu,1727,1,1,227422,128,0,0,0,0,1,29110000
nn_kernel_gpu_mem,43642,1,1,227422,128,232880000,116440000,116440000,232880000,1,29110000
nn_kernel_cpu,26874,0,1,1,64,0,0,0,0,1,29120000
nn_kernel_gpu,1752,1,1,227500,128,0,0,0,0,1,29120000
nn_kernel_gpu_mem,47116,1,1,227500,128,232960000,116480000,116480000,232960000,1,29120000
nn_kernel_cpu,21841,0,1,1,64,0,0,0,0,1,29130000
nn_kernel_gpu,1733,1,1,227579,128,0,0,0,0,1,29130000
nn_kernel_gpu_mem,45288,1,1,227579,128,233040000,116520000,116520000,233040000,1,29130000
nn_kernel_cpu,34344,0,1,1,64,0,0,0,0,1,29140000
nn_kernel_gpu,1741,1,1,227657,128,0,0,0,0,1,29140000
nn_kernel_gpu_mem,43839,1,1,227657,128,233120000,116560000,116560000,233120000,1,29140000
nn_kernel_cpu,33068,0,1,1,64,0,0,0,0,1,29150000
nn_kernel_gpu,1742,1,1,227735,128,0,0,0,0,1,29150000
nn_kernel_gpu_mem,38460,1,1,227735,128,233200000,116600000,116600000,233200000,1,29150000
nn_kernel_cpu,22236,0,1,1,64,0,0,0,0,1,29160000
nn_kernel_gpu,1731,1,1,227813,128,0,0,0,0,1,29160000
nn_kernel_gpu_mem,47982,1,1,227813,128,233280000,116640000,116640000,233280000,1,29160000
nn_kernel_cpu,24798,0,1,1,64,0,0,0,0,1,29170000
nn_kernel_gpu,1725,1,1,227891,128,0,0,0,0,1,29170000
nn_kernel_gpu_mem,47220,1,1,227891,128,233360000,116680000,116680000,233360000,1,29170000
nn_kernel_cpu,35400,0,1,1,64,0,0,0,0,1,29180000
nn_kernel_gpu,1753,1,1,227969,128,0,0,0,0,1,29180000
nn_kernel_gpu_mem,38777,1,1,227969,128,233440000,116720000,116720000,233440000,1,29180000
nn_kernel_cpu,22598,0,1,1,64,0,0,0,0,1,29190000
nn_kernel_gpu,1781,1,1,228047,128,0,0,0,0,1,29190000
nn_kernel_gpu_mem,39696,1,1,228047,128,233520000,116760000,116760000,233520000,1,29190000
nn_kernel_cpu,38123,0,1,1,64,0,0,0,0,1,29200000
nn_kernel_gpu,1726,1,1,228125,128,0,0,0,0,1,29200000
nn_kernel_gpu_mem,38113,1,1,228125,128,233600000,116800000,116800000,233600000,1,29200000
nn_kernel_cpu,24513,0,1,1,64,0,0,0,0,1,2920000
nn_kernel_gpu,226,1,1,22813,128,0,0,0,0,1,2920000
nn_kernel_gpu_mem,9067,1,1,22813,128,23360000,11680000,11680000,23360000,1,2920000
nn_kernel_cpu,32308,0,1,1,64,0,0,0,0,1,29210000
nn_kernel_gpu,1774,1,1,228204,128,0,0,0,0,1,29210000
nn_kernel_gpu_mem,46463,1,1,228204,128,233680000,116840000,116840000,233680000,1,29210000
nn_kernel_cpu,24533,0,1,1,64,0,0,0,0,1,29220000
nn_kernel_gpu,1760,1,1,228282,128,0,0,0,0,1,29220000
nn_kernel_gpu_mem,40465,1,1,228282,128,233760000,116880000,116880000,233760000,1,29220000
nn_kernel_cpu,25887,0,1,1,64,0,0,0,0,1,29230000
nn_kernel_gpu,1755,1,1,228360,128,0,0,0,0,1,29230000
nn_kernel_gpu_mem,43903,1,1,228360,128,233840000,116920000,116920000,233840000,1,29230000
nn_kernel_cpu,39393,0,1,1,64,0,0,0,0,1,29240000
nn_kernel_gpu,1730,1,1,228438,128,0,0,0,0,1,29240000
nn_kernel_gpu_mem,43818,1,1,228438,128,233920000,116960000,116960000,233920000,1,29240000
nn_kernel_cpu,29666,0,1,1,64,0,0,0,0,1,29250000
nn_kernel_gpu,1750,1,1,228516,128,0,0,0,0,1,29250000
nn_kernel_gpu_mem,38657,1,1,228516,128,234000000,117000000,117000000,234000000,1,29250000
nn_kernel_cpu,18544,0,1,1,64,0,0,0,0,1,29260000
nn_kernel_gpu,1764,1,1,228594,128,0,0,0,0,1,29260000
nn_kernel_gpu_mem,40231,1,1,228594,128,234080000,117040000,117040000,234080000,1,29260000
nn_kernel_cpu,25043,0,1,1,64,0,0,0,0,1,29270000
nn_kernel_gpu,1746,1,1,228672,128,0,0,0,0,1,29270000
nn_kernel_gpu_mem,39945,1,1,228672,128,234160000,117080000,117080000,234160000,1,29270000
nn_kernel_cpu,32829,0,1,1,64,0,0,0,0,1,29280000
nn_kernel_gpu,1767,1,1,228750,128,0,0,0,0,1,29280000
nn_kernel_gpu_mem,45702,1,1,228750,128,234240000,117120000,117120000,234240000,1,29280000
nn_kernel_cpu,23223,0,1,1,64,0,0,0,0,1,29290000
nn_kernel_gpu,1734,1,1,228829,128,0,0,0,0,1,29290000
nn_kernel_gpu_mem,45938,1,1,228829,128,234320000,117160000,117160000,234320000,1,29290000
nn_kernel_cpu,13654,0,1,1,64,0,0,0,0,1,29300000
nn_kernel_gpu,1760,1,1,228907,128,0,0,0,0,1,29300000
nn_kernel_gpu_mem,44862,1,1,228907,128,234400000,117200000,117200000,234400000,1,29300000
nn_kernel_cpu,18252,0,1,1,64,0,0,0,0,1,2930000
nn_kernel_gpu,217,1,1,22891,128,0,0,0,0,1,2930000
nn_kernel_gpu_mem,3968,1,1,22891,128,23440000,11720000,11720000,23440000,1,2930000
nn_kernel_cpu,20742,0,1,1,64,0,0,0,0,1,29310000
nn_kernel_gpu,1757,1,1,228985,128,0,0,0,0,1,29310000
nn_kernel_gpu_mem,47643,1,1,228985,128,234480000,117240000,117240000,234480000,1,29310000
nn_kernel_cpu,27206,0,1,1,64,0,0,0,0,1,29320000
nn_kernel_gpu,1752,1,1,229063,128,0,0,0,0,1,29320000
nn_kernel_gpu_mem,38389,1,1,229063,128,234560000,117280000,117280000,234560000,1,29320000
nn_kernel_cpu,27976,0,1,1,64,0,0,0,0,1,29330000
nn_kernel_gpu,1749,1,1,229141,128,0,0,0,0,1,29330000
nn_kernel_gpu_mem,45495,1,1,229141,128,234640000,117320000,117320000,234640000,1,29330000
nn_kernel_cpu,25478,0,1,1,64,0,0,0,0,1,29340000
nn_kernel_gpu,1749,1,1,229219,128,0,0,0,0,1,29340000
nn_kernel_gpu_mem,36812,1,1,229219,128,234720000,117360000,117360000,234720000,1,29340000
nn_kernel_cpu,24180,0,1,1,64,0,0,0,0,1,29350000
nn_kernel_gpu,1754,1,1,229297,128,0,0,0,0,1,29350000
nn_kernel_gpu_mem,39881,1,1,229297,128,234800000,117400000,117400000,234800000,1,29350000
nn_kernel_cpu,35397,0,1,1,64,0,0,0,0,1,29360000
nn_kernel_gpu,1748,1,1,229375,128,0,0,0,0,1,29360000
nn_kernel_gpu_mem,43882,1,1,229375,128,234880000,117440000,117440000,234880000,1,29360000
nn_kernel_cpu,23944,0,1,1,64,0,0,0,0,1,29370000
nn_kernel_gpu,1755,1,1,229454,128,0,0,0,0,1,29370000
nn_kernel_gpu_mem,44661,1,1,229454,128,234960000,117480000,117480000,234960000,1,29370000
nn_kernel_cpu,28608,0,1,1,64,0,0,0,0,1,29380000
nn_kernel_gpu,1751,1,1,229532,128,0,0,0,0,1,29380000
nn_kernel_gpu_mem,41892,1,1,229532,128,235040000,117520000,117520000,235040000,1,29380000
nn_kernel_cpu,49434,0,1,1,64,0,0,0,0,1,29390000
nn_kernel_gpu,1777,1,1,229610,128,0,0,0,0,1,29390000
nn_kernel_gpu_mem,46963,1,1,229610,128,235120000,117560000,117560000,235120000,1,29390000
nn_kernel_cpu,23616,0,1,1,64,0,0,0,0,1,29400000
nn_kernel_gpu,1770,1,1,229688,128,0,0,0,0,1,29400000
nn_kernel_gpu_mem,47199,1,1,229688,128,235200000,117600000,117600000,235200000,1,29400000
nn_kernel_cpu,29407,0,1,1,64,0,0,0,0,1,2940000
nn_kernel_gpu,229,1,1,22969,128,0,0,0,0,1,2940000
nn_kernel_gpu_mem,5560,1,1,22969,128,23520000,11760000,11760000,23520000,1,2940000
nn_kernel_cpu,25643,0,1,1,64,0,0,0,0,1,29410000
nn_kernel_gpu,1771,1,1,229766,128,0,0,0,0,1,29410000
nn_kernel_gpu_mem,38015,1,1,229766,128,235280000,117640000,117640000,235280000,1,29410000
nn_kernel_cpu,38981,0,1,1,64,0,0,0,0,1,29420000
nn_kernel_gpu,1753,1,1,229844,128,0,0,0,0,1,29420000
nn_kernel_gpu_mem,39852,1,1,229844,128,235360000,117680000,117680000,235360000,1,29420000
nn_kernel_cpu,25181,0,1,1,64,0,0,0,0,1,29430000
nn_kernel_gpu,1752,1,1,229922,128,0,0,0,0,1,29430000
nn_kernel_gpu_mem,38862,1,1,229922,128,235440000,117720000,117720000,235440000,1,29430000
nn_kernel_cpu,26275,0,1,1,64,0,0,0,0,1,29440000
nn_kernel_gpu,1772,1,1,230000,128,0,0,0,0,1,29440000
nn_kernel_gpu_mem,38415,1,1,230000,128,235520000,117760000,117760000,235520000,1,29440000
nn_kernel_cpu,33195,0,1,1,64,0,0,0,0,1,29450000
nn_kernel_gpu,1744,1,1,230079,128,0,0,0,0,1,29450000
nn_kernel_gpu_mem,48212,1,1,230079,128,235600000,117800000,117800000,235600000,1,29450000
nn_kernel_cpu,36138,0,1,1,64,0,0,0,0,1,29460000
nn_kernel_gpu,1781,1,1,230157,128,0,0,0,0,1,29460000
nn_kernel_gpu_mem,40712,1,1,230157,128,235680000,117840000,117840000,235680000,1,29460000
nn_kernel_cpu,38603,0,1,1,64,0,0,0,0,1,29470000
nn_kernel_gpu,1771,1,1,230235,128,0,0,0,0,1,29470000
nn_kernel_gpu_mem,47471,1,1,230235,128,235760000,117880000,117880000,235760000,1,29470000
nn_kernel_cpu,27250,0,1,1,64,0,0,0,0,1,29480000
nn_kernel_gpu,1757,1,1,230313,128,0,0,0,0,1,29480000
nn_kernel_gpu_mem,38224,1,1,230313,128,235840000,117920000,117920000,235840000,1,29480000
nn_kernel_cpu,28258,0,1,1,64,0,0,0,0,1,29490000
nn_kernel_gpu,1775,1,1,230391,128,0,0,0,0,1,29490000
nn_kernel_gpu_mem,38822,1,1,230391,128,235920000,117960000,117960000,235920000,1,29490000
nn_kernel_cpu,22359,0,1,1,64,0,0,0,0,1,29500000
nn_kernel_gpu,1752,1,1,230469,128,0,0,0,0,1,29500000
nn_kernel_gpu_mem,40383,1,1,230469,128,236000000,118000000,118000000,236000000,1,29500000
nn_kernel_cpu,13604,0,1,1,64,0,0,0,0,1,2950000
nn_kernel_gpu,224,1,1,23047,128,0,0,0,0,1,2950000
nn_kernel_gpu_mem,7875,1,1,23047,128,23600000,11800000,11800000,23600000,1,2950000
nn_kernel_cpu,25611,0,1,1,64,0,0,0,0,1,29510000
nn_kernel_gpu,1761,1,1,230547,128,0,0,0,0,1,29510000
nn_kernel_gpu_mem,40419,1,1,230547,128,236080000,118040000,118040000,236080000,1,29510000
nn_kernel_cpu,24928,0,1,1,64,0,0,0,0,1,29520000
nn_kernel_gpu,1761,1,1,230625,128,0,0,0,0,1,29520000
nn_kernel_gpu_mem,38213,1,1,230625,128,236160000,118080000,118080000,236160000,1,29520000
nn_kernel_cpu,26010,0,1,1,64,0,0,0,0,1,29530000
nn_kernel_gpu,1769,1,1,230704,128,0,0,0,0,1,29530000
nn_kernel_gpu_mem,41763,1,1,230704,128,236240000,118120000,118120000,236240000,1,29530000
nn_kernel_cpu,11541,0,1,1,64,0,0,0,0,1,29540000
nn_kernel_gpu,1771,1,1,230782,128,0,0,0,0,1,29540000
nn_kernel_gpu_mem,43736,1,1,230782,128,236320000,118160000,118160000,236320000,1,29540000
nn_kernel_cpu,35760,0,1,1,64,0,0,0,0,1,29550000
nn_kernel_gpu,1765,1,1,230860,128,0,0,0,0,1,29550000
nn_kernel_gpu_mem,38864,1,1,230860,128,236400000,118200000,118200000,236400000,1,29550000
nn_kernel_cpu,30093,0,1,1,64,0,0,0,0,1,29560000
nn_kernel_gpu,1779,1,1,230938,128,0,0,0,0,1,29560000
nn_kernel_gpu_mem,39951,1,1,230938,128,236480000,118240000,118240000,236480000,1,29560000
nn_kernel_cpu,24484,0,1,1,64,0,0,0,0,1,29570000
nn_kernel_gpu,1765,1,1,231016,128,0,0,0,0,1,29570000
nn_kernel_gpu_mem,44747,1,1,231016,128,236560000,118280000,118280000,236560000,1,29570000
nn_kernel_cpu,9557,0,1,1,64,0,0,0,0,1,29580000
nn_kernel_gpu,1767,1,1,231094,128,0,0,0,0,1,29580000
nn_kernel_gpu_mem,44300,1,1,231094,128,236640000,118320000,118320000,236640000,1,29580000
nn_kernel_cpu,22254,0,1,1,64,0,0,0,0,1,29590000
nn_kernel_gpu,1758,1,1,231172,128,0,0,0,0,1,29590000
nn_kernel_gpu_mem,39889,1,1,231172,128,236720000,118360000,118360000,236720000,1,29590000
nn_kernel_cpu,11640,0,1,1,64,0,0,0,0,1,29600000
nn_kernel_gpu,1769,1,1,231250,128,0,0,0,0,1,29600000
nn_kernel_gpu_mem,45507,1,1,231250,128,236800000,118400000,118400000,236800000,1,29600000
nn_kernel_cpu,5656,0,1,1,64,0,0,0,0,1,2960000
nn_kernel_gpu,264,1,1,23125,128,0,0,0,0,1,2960000
nn_kernel_gpu_mem,5098,1,1,23125,128,23680000,11840000,11840000,23680000,1,2960000
nn_kernel_cpu,22907,0,1,1,64,0,0,0,0,1,29610000
nn_kernel_gpu,1783,1,1,231329,128,0,0,0,0,1,29610000
nn_kernel_gpu_mem,52822,1,1,231329,128,236880000,118440000,118440000,236880000,1,29610000
nn_kernel_cpu,28330,0,1,1,64,0,0,0,0,1,29620000
nn_kernel_gpu,1790,1,1,231407,128,0,0,0,0,1,29620000
nn_kernel_gpu_mem,46162,1,1,231407,128,236960000,118480000,118480000,236960000,1,29620000
nn_kernel_cpu,23974,0,1,1,64,0,0,0,0,1,29630000
nn_kernel_gpu,1771,1,1,231485,128,0,0,0,0,1,29630000
nn_kernel_gpu_mem,44222,1,1,231485,128,237040000,118520000,118520000,237040000,1,29630000
nn_kernel_cpu,11199,0,1,1,64,0,0,0,0,1,29640000
nn_kernel_gpu,1778,1,1,231563,128,0,0,0,0,1,29640000
nn_kernel_gpu_mem,44758,1,1,231563,128,237120000,118560000,118560000,237120000,1,29640000
nn_kernel_cpu,28481,0,1,1,64,0,0,0,0,1,29650000
nn_kernel_gpu,1767,1,1,231641,128,0,0,0,0,1,29650000
nn_kernel_gpu_mem,44739,1,1,231641,128,237200000,118600000,118600000,237200000,1,29650000
nn_kernel_cpu,18202,0,1,1,64,0,0,0,0,1,29660000
nn_kernel_gpu,1759,1,1,231719,128,0,0,0,0,1,29660000
nn_kernel_gpu_mem,45950,1,1,231719,128,237280000,118640000,118640000,237280000,1,29660000
nn_kernel_cpu,11482,0,1,1,64,0,0,0,0,1,29670000
nn_kernel_gpu,1773,1,1,231797,128,0,0,0,0,1,29670000
nn_kernel_gpu_mem,44604,1,1,231797,128,237360000,118680000,118680000,237360000,1,29670000
nn_kernel_cpu,25628,0,1,1,64,0,0,0,0,1,29680000
nn_kernel_gpu,1798,1,1,231875,128,0,0,0,0,1,29680000
nn_kernel_gpu_mem,53762,1,1,231875,128,237440000,118720000,118720000,237440000,1,29680000
nn_kernel_cpu,19568,0,1,1,64,0,0,0,0,1,29690000
nn_kernel_gpu,1773,1,1,231954,128,0,0,0,0,1,29690000
nn_kernel_gpu_mem,44170,1,1,231954,128,237520000,118760000,118760000,237520000,1,29690000
nn_kernel_cpu,30758,0,1,1,64,0,0,0,0,1,29700000
nn_kernel_gpu,1765,1,1,232032,128,0,0,0,0,1,29700000
nn_kernel_gpu_mem,47410,1,1,232032,128,237600000,118800000,118800000,237600000,1,29700000
nn_kernel_cpu,24878,0,1,1,64,0,0,0,0,1,2970000
nn_kernel_gpu,221,1,1,23204,128,0,0,0,0,1,2970000
nn_kernel_gpu_mem,4879,1,1,23204,128,23760000,11880000,11880000,23760000,1,2970000
nn_kernel_cpu,26175,0,1,1,64,0,0,0,0,1,29710000
nn_kernel_gpu,1771,1,1,232110,128,0,0,0,0,1,29710000
nn_kernel_gpu_mem,40615,1,1,232110,128,237680000,118840000,118840000,237680000,1,29710000
nn_kernel_cpu,15155,0,1,1,64,0,0,0,0,1,29720000
nn_kernel_gpu,1785,1,1,232188,128,0,0,0,0,1,29720000
nn_kernel_gpu_mem,47155,1,1,232188,128,237760000,118880000,118880000,237760000,1,29720000
nn_kernel_cpu,26544,0,1,1,64,0,0,0,0,1,29730000
nn_kernel_gpu,1751,1,1,232266,128,0,0,0,0,1,29730000
nn_kernel_gpu_mem,40186,1,1,232266,128,237840000,118920000,118920000,237840000,1,29730000
nn_kernel_cpu,30044,0,1,1,64,0,0,0,0,1,29740000
nn_kernel_gpu,1790,1,1,232344,128,0,0,0,0,1,29740000
nn_kernel_gpu_mem,41309,1,1,232344,128,237920000,118960000,118960000,237920000,1,29740000
nn_kernel_cpu,11849,0,1,1,64,0,0,0,0,1,29750000
nn_kernel_gpu,1783,1,1,232422,128,0,0,0,0,1,29750000
nn_kernel_gpu_mem,43894,1,1,232422,128,238000000,119000000,119000000,238000000,1,29750000
nn_kernel_cpu,30474,0,1,1,64,0,0,0,0,1,29760000
nn_kernel_gpu,1769,1,1,232500,128,0,0,0,0,1,29760000
nn_kernel_gpu_mem,42884,1,1,232500,128,238080000,119040000,119040000,238080000,1,29760000
nn_kernel_cpu,13338,0,1,1,64,0,0,0,0,1,29770000
nn_kernel_gpu,1784,1,1,232579,128,0,0,0,0,1,29770000
nn_kernel_gpu_mem,38542,1,1,232579,128,238160000,119080000,119080000,238160000,1,29770000
nn_kernel_cpu,24860,0,1,1,64,0,0,0,0,1,29780000
nn_kernel_gpu,1776,1,1,232657,128,0,0,0,0,1,29780000
nn_kernel_gpu_mem,44931,1,1,232657,128,238240000,119120000,119120000,238240000,1,29780000
nn_kernel_cpu,8381,0,1,1,64,0,0,0,0,1,29790000
nn_kernel_gpu,1776,1,1,232735,128,0,0,0,0,1,29790000
nn_kernel_gpu_mem,39510,1,1,232735,128,238320000,119160000,119160000,238320000,1,29790000
nn_kernel_cpu,15960,0,1,1,64,0,0,0,0,1,29800000
nn_kernel_gpu,1793,1,1,232813,128,0,0,0,0,1,29800000
nn_kernel_gpu_mem,45911,1,1,232813,128,238400000,119200000,119200000,238400000,1,29800000
nn_kernel_cpu,16483,0,1,1,64,0,0,0,0,1,2980000
nn_kernel_gpu,235,1,1,23282,128,0,0,0,0,1,2980000
nn_kernel_gpu_mem,4812,1,1,23282,128,23840000,11920000,11920000,23840000,1,2980000
nn_kernel_cpu,19613,0,1,1,64,0,0,0,0,1,29810000
nn_kernel_gpu,1788,1,1,232891,128,0,0,0,0,1,29810000
nn_kernel_gpu_mem,44963,1,1,232891,128,238480000,119240000,119240000,238480000,1,29810000
nn_kernel_cpu,27262,0,1,1,64,0,0,0,0,1,29820000
nn_kernel_gpu,1774,1,1,232969,128,0,0,0,0,1,29820000
nn_kernel_gpu_mem,47619,1,1,232969,128,238560000,119280000,119280000,238560000,1,29820000
nn_kernel_cpu,23370,0,1,1,64,0,0,0,0,1,29830000
nn_kernel_gpu,1787,1,1,233047,128,0,0,0,0,1,29830000
nn_kernel_gpu_mem,41848,1,1,233047,128,238640000,119320000,119320000,238640000,1,29830000
nn_kernel_cpu,8297,0,1,1,64,0,0,0,0,1,29840000
nn_kernel_gpu,1770,1,1,233125,128,0,0,0,0,1,29840000
nn_kernel_gpu_mem,45251,1,1,233125,128,238720000,119360000,119360000,238720000,1,29840000
nn_kernel_cpu,25606,0,1,1,64,0,0,0,0,1,29850000
nn_kernel_gpu,1780,1,1,233204,128,0,0,0,0,1,29850000
nn_kernel_gpu_mem,42563,1,1,233204,128,238800000,119400000,119400000,238800000,1,29850000
nn_kernel_cpu,26237,0,1,1,64,0,0,0,0,1,29860000
nn_kernel_gpu,1771,1,1,233282,128,0,0,0,0,1,29860000
nn_kernel_gpu_mem,45655,1,1,233282,128,238880000,119440000,119440000,238880000,1,29860000
nn_kernel_cpu,13059,0,1,1,64,0,0,0,0,1,29870000
nn_kernel_gpu,1775,1,1,233360,128,0,0,0,0,1,29870000
nn_kernel_gpu_mem,45803,1,1,233360,128,238960000,119480000,119480000,238960000,1,29870000
nn_kernel_cpu,15656,0,1,1,64,0,0,0,0,1,29880000
nn_kernel_gpu,1807,1,1,233438,128,0,0,0,0,1,29880000
nn_kernel_gpu_mem,37134,1,1,233438,128,239040000,119520000,119520000,239040000,1,29880000
nn_kernel_cpu,15590,0,1,1,64,0,0,0,0,1,29890000
nn_kernel_gpu,1788,1,1,233516,128,0,0,0,0,1,29890000
nn_kernel_gpu_mem,42359,1,1,233516,128,239120000,119560000,119560000,239120000,1,29890000
nn_kernel_cpu,25309,0,1,1,64,0,0,0,0,1,29900000
nn_kernel_gpu,1784,1,1,233594,128,0,0,0,0,1,29900000
nn_kernel_gpu_mem,35398,1,1,233594,128,239200000,119600000,119600000,239200000,1,29900000
nn_kernel_cpu,13532,0,1,1,64,0,0,0,0,1,2990000
nn_kernel_gpu,231,1,1,23360,128,0,0,0,0,1,2990000
nn_kernel_gpu_mem,4520,1,1,23360,128,23920000,11960000,11960000,23920000,1,2990000
nn_kernel_cpu,30983,0,1,1,64,0,0,0,0,1,29910000
nn_kernel_gpu,1789,1,1,233672,128,0,0,0,0,1,29910000
nn_kernel_gpu_mem,40659,1,1,233672,128,239280000,119640000,119640000,239280000,1,29910000
nn_kernel_cpu,35193,0,1,1,64,0,0,0,0,1,29920000
nn_kernel_gpu,1766,1,1,233750,128,0,0,0,0,1,29920000
nn_kernel_gpu_mem,47769,1,1,233750,128,239360000,119680000,119680000,239360000,1,29920000
nn_kernel_cpu,12262,0,1,1,64,0,0,0,0,1,29930000
nn_kernel_gpu,1765,1,1,233829,128,0,0,0,0,1,29930000
nn_kernel_gpu_mem,50281,1,1,233829,128,239440000,119720000,119720000,239440000,1,29930000
nn_kernel_cpu,23035,0,1,1,64,0,0,0,0,1,29940000
nn_kernel_gpu,1773,1,1,233907,128,0,0,0,0,1,29940000
nn_kernel_gpu_mem,40560,1,1,233907,128,239520000,119760000,119760000,239520000,1,29940000
nn_kernel_cpu,25675,0,1,1,64,0,0,0,0,1,29950000
nn_kernel_gpu,1778,1,1,233985,128,0,0,0,0,1,29950000
nn_kernel_gpu_mem,38188,1,1,233985,128,239600000,119800000,119800000,239600000,1,29950000
nn_kernel_cpu,17294,0,1,1,64,0,0,0,0,1,29960000
nn_kernel_gpu,1770,1,1,234063,128,0,0,0,0,1,29960000
nn_kernel_gpu_mem,45255,1,1,234063,128,239680000,119840000,119840000,239680000,1,29960000
nn_kernel_cpu,11725,0,1,1,64,0,0,0,0,1,29970000
nn_kernel_gpu,1786,1,1,234141,128,0,0,0,0,1,29970000
nn_kernel_gpu_mem,45452,1,1,234141,128,239760000,119880000,119880000,239760000,1,29970000
nn_kernel_cpu,64107,0,1,1,64,0,0,0,0,1,29980000
nn_kernel_gpu,1772,1,1,234219,128,0,0,0,0,1,29980000
nn_kernel_gpu_mem,36771,1,1,234219,128,239840000,119920000,119920000,239840000,1,29980000
nn_kernel_cpu,28875,0,1,1,64,0,0,0,0,1,29990000
nn_kernel_gpu,1769,1,1,234297,128,0,0,0,0,1,29990000
nn_kernel_gpu_mem,41176,1,1,234297,128,239920000,119960000,119960000,239920000,1,29990000
nn_kernel_cpu,25228,0,1,1,64,0,0,0,0,1,30000000
nn_kernel_gpu,1792,1,1,234375,128,0,0,0,0,1,30000000
nn_kernel_gpu_mem,47414,1,1,234375,128,240000000,120000000,120000000,240000000,1,30000000
nn_kernel_cpu,23014,0,1,1,64,0,0,0,0,1,3000000
nn_kernel_gpu,231,1,1,23438,128,0,0,0,0,1,3000000
nn_kernel_gpu_mem,5464,1,1,23438,128,24000000,12000000,12000000,24000000,1,3000000
nn_kernel_cpu,24031,0,1,1,64,0,0,0,0,1,300000
nn_kernel_gpu,67,1,1,2344,128,0,0,0,0,1,300000
nn_kernel_gpu_mem,745,1,1,2344,128,2400000,1200000,1200000,2400000,1,300000
nn_kernel_cpu,514,0,1,1,64,0,0,0,0,1,30000
nn_kernel_gpu,36,1,1,235,128,0,0,0,0,1,30000
nn_kernel_gpu_mem,149,1,1,235,128,240000,120000,120000,240000,1,30000
nn_kernel_cpu,23850,0,1,1,64,0,0,0,0,1,30010000
nn_kernel_gpu,1808,1,1,234454,128,0,0,0,0,1,30010000
nn_kernel_gpu_mem,47350,1,1,234454,128,240080000,120040000,120040000,240080000,1,30010000
nn_kernel_cpu,8443,0,1,1,64,0,0,0,0,1,30020000
nn_kernel_gpu,1783,1,1,234532,128,0,0,0,0,1,30020000
nn_kernel_gpu_mem,41471,1,1,234532,128,240160000,120080000,120080000,240160000,1,30020000
nn_kernel_cpu,36607,0,1,1,64,0,0,0,0,1,30030000
nn_kernel_gpu,1777,1,1,234610,128,0,0,0,0,1,30030000
nn_kernel_gpu_mem,44805,1,1,234610,128,240240000,120120000,120120000,240240000,1,30030000
nn_kernel_cpu,25787,0,1,1,64,0,0,0,0,1,30040000
nn_kernel_gpu,1775,1,1,234688,128,0,0,0,0,1,30040000
nn_kernel_gpu_mem,44248,1,1,234688,128,240320000,120160000,120160000,240320000,1,30040000
nn_kernel_cpu,33247,0,1,1,64,0,0,0,0,1,30050000
nn_kernel_gpu,1803,1,1,234766,128,0,0,0,0,1,30050000
nn_kernel_gpu_mem,44698,1,1,234766,128,240400000,120200000,120200000,240400000,1,30050000
nn_kernel_cpu,31873,0,1,1,64,0,0,0,0,1,30060000
nn_kernel_gpu,1785,1,1,234844,128,0,0,0,0,1,30060000
nn_kernel_gpu_mem,45604,1,1,234844,128,240480000,120240000,120240000,240480000,1,30060000
nn_kernel_cpu,13086,0,1,1,64,0,0,0,0,1,30070000
nn_kernel_gpu,1811,1,1,234922,128,0,0,0,0,1,30070000
nn_kernel_gpu_mem,46952,1,1,234922,128,240560000,120280000,120280000,240560000,1,30070000
nn_kernel_cpu,19937,0,1,1,64,0,0,0,0,1,30080000
nn_kernel_gpu,1785,1,1,235000,128,0,0,0,0,1,30080000
nn_kernel_gpu_mem,41513,1,1,235000,128,240640000,120320000,120320000,240640000,1,30080000
nn_kernel_cpu,22438,0,1,1,64,0,0,0,0,1,30090000
nn_kernel_gpu,1779,1,1,235079,128,0,0,0,0,1,30090000
nn_kernel_gpu_mem,48806,1,1,235079,128,240720000,120360000,120360000,240720000,1,30090000
nn_kernel_cpu,12103,0,1,1,64,0,0,0,0,1,30100000
nn_kernel_gpu,1778,1,1,235157,128,0,0,0,0,1,30100000
nn_kernel_gpu_mem,46754,1,1,235157,128,240800000,120400000,120400000,240800000,1,30100000
nn_kernel_cpu,7886,0,1,1,64,0,0,0,0,1,3010000
nn_kernel_gpu,222,1,1,23516,128,0,0,0,0,1,3010000
nn_kernel_gpu_mem,4294,1,1,23516,128,24080000,12040000,12040000,24080000,1,3010000
nn_kernel_cpu,20631,0,1,1,64,0,0,0,0,1,30110000
nn_kernel_gpu,1784,1,1,235235,128,0,0,0,0,1,30110000
nn_kernel_gpu_mem,47883,1,1,235235,128,240880000,120440000,120440000,240880000,1,30110000
nn_kernel_cpu,12294,0,1,1,64,0,0,0,0,1,30120000
nn_kernel_gpu,1791,1,1,235313,128,0,0,0,0,1,30120000
nn_kernel_gpu_mem,48218,1,1,235313,128,240960000,120480000,120480000,240960000,1,30120000
nn_kernel_cpu,10052,0,1,1,64,0,0,0,0,1,30130000
nn_kernel_gpu,1781,1,1,235391,128,0,0,0,0,1,30130000
nn_kernel_gpu_mem,48639,1,1,235391,128,241040000,120520000,120520000,241040000,1,30130000
nn_kernel_cpu,37133,0,1,1,64,0,0,0,0,1,30140000
nn_kernel_gpu,1834,1,1,235469,128,0,0,0,0,1,30140000
nn_kernel_gpu_mem,50482,1,1,235469,128,241120000,120560000,120560000,241120000,1,30140000
nn_kernel_cpu,11162,0,1,1,64,0,0,0,0,1,30150000
nn_kernel_gpu,1791,1,1,235547,128,0,0,0,0,1,30150000
nn_kernel_gpu_mem,42211,1,1,235547,128,241200000,120600000,120600000,241200000,1,30150000
nn_kernel_cpu,17170,0,1,1,64,0,0,0,0,1,30160000
nn_kernel_gpu,1783,1,1,235625,128,0,0,0,0,1,30160000
nn_kernel_gpu_mem,38955,1,1,235625,128,241280000,120640000,120640000,241280000,1,30160000
nn_kernel_cpu,14700,0,1,1,64,0,0,0,0,1,30170000
nn_kernel_gpu,1789,1,1,235704,128,0,0,0,0,1,30170000
nn_kernel_gpu_mem,46142,1,1,235704,128,241360000,120680000,120680000,241360000,1,30170000
nn_kernel_cpu,11027,0,1,1,64,0,0,0,0,1,30180000
nn_kernel_gpu,1805,1,1,235782,128,0,0,0,0,1,30180000
nn_kernel_gpu_mem,43126,1,1,235782,128,241440000,120720000,120720000,241440000,1,30180000
nn_kernel_cpu,20615,0,1,1,64,0,0,0,0,1,30190000
nn_kernel_gpu,1812,1,1,235860,128,0,0,0,0,1,30190000
nn_kernel_gpu_mem,45757,1,1,235860,128,241520000,120760000,120760000,241520000,1,30190000
nn_kernel_cpu,15755,0,1,1,64,0,0,0,0,1,30200000
nn_kernel_gpu,1803,1,1,235938,128,0,0,0,0,1,30200000
nn_kernel_gpu_mem,46347,1,1,235938,128,241600000,120800000,120800000,241600000,1,30200000
nn_kernel_cpu,3557,0,1,1,64,0,0,0,0,1,3020000
nn_kernel_gpu,240,1,1,23594,128,0,0,0,0,1,3020000
nn_kernel_gpu_mem,4654,1,1,23594,128,24160000,12080000,12080000,24160000,1,3020000
nn_kernel_cpu,17869,0,1,1,64,0,0,0,0,1,30210000
nn_kernel_gpu,1793,1,1,236016,128,0,0,0,0,1,30210000
nn_kernel_gpu_mem,45774,1,1,236016,128,241680000,120840000,120840000,241680000,1,30210000
nn_kernel_cpu,24628,0,1,1,64,0,0,0,0,1,30220000
nn_kernel_gpu,1798,1,1,236094,128,0,0,0,0,1,30220000
nn_kernel_gpu_mem,40320,1,1,236094,128,241760000,120880000,120880000,241760000,1,30220000
nn_kernel_cpu,42349,0,1,1,64,0,0,0,0,1,30230000
nn_kernel_gpu,1801,1,1,236172,128,0,0,0,0,1,30230000
nn_kernel_gpu_mem,48737,1,1,236172,128,241840000,120920000,120920000,241840000,1,30230000
nn_kernel_cpu,32094,0,1,1,64,0,0,0,0,1,30240000
nn_kernel_gpu,1802,1,1,236250,128,0,0,0,0,1,30240000
nn_kernel_gpu_mem,40476,1,1,236250,128,241920000,120960000,120960000,241920000,1,30240000
nn_kernel_cpu,38685,0,1,1,64,0,0,0,0,1,30250000
nn_kernel_gpu,1798,1,1,236329,128,0,0,0,0,1,30250000
nn_kernel_gpu_mem,37602,1,1,236329,128,242000000,121000000,121000000,242000000,1,30250000
nn_kernel_cpu,29740,0,1,1,64,0,0,0,0,1,30260000
nn_kernel_gpu,1798,1,1,236407,128,0,0,0,0,1,30260000
nn_kernel_gpu_mem,39141,1,1,236407,128,242080000,121040000,121040000,242080000,1,30260000
nn_kernel_cpu,13177,0,1,1,64,0,0,0,0,1,30270000
nn_kernel_gpu,1796,1,1,236485,128,0,0,0,0,1,30270000
nn_kernel_gpu_mem,47006,1,1,236485,128,242160000,121080000,121080000,242160000,1,30270000
nn_kernel_cpu,20977,0,1,1,64,0,0,0,0,1,30280000
nn_kernel_gpu,1813,1,1,236563,128,0,0,0,0,1,30280000
nn_kernel_gpu_mem,45424,1,1,236563,128,242240000,121120000,121120000,242240000,1,30280000
nn_kernel_cpu,28033,0,1,1,64,0,0,0,0,1,30290000
nn_kernel_gpu,1800,1,1,236641,128,0,0,0,0,1,30290000
nn_kernel_gpu_mem,39281,1,1,236641,128,242320000,121160000,121160000,242320000,1,30290000
nn_kernel_cpu,28426,0,1,1,64,0,0,0,0,1,30300000
nn_kernel_gpu,1802,1,1,236719,128,0,0,0,0,1,30300000
nn_kernel_gpu_mem,45329,1,1,236719,128,242400000,121200000,121200000,242400000,1,30300000
nn_kernel_cpu,19276,0,1,1,64,0,0,0,0,1,3030000
nn_kernel_gpu,231,1,1,23672,128,0,0,0,0,1,3030000
nn_kernel_gpu_mem,4841,1,1,23672,128,24240000,12120000,12120000,24240000,1,3030000
nn_kernel_cpu,13148,0,1,1,64,0,0,0,0,1,30310000
nn_kernel_gpu,1814,1,1,236797,128,0,0,0,0,1,30310000
nn_kernel_gpu_mem,46780,1,1,236797,128,242480000,121240000,121240000,242480000,1,30310000
nn_kernel_cpu,24150,0,1,1,64,0,0,0,0,1,30320000
nn_kernel_gpu,1804,1,1,236875,128,0,0,0,0,1,30320000
nn_kernel_gpu_mem,42150,1,1,236875,128,242560000,121280000,121280000,242560000,1,30320000
nn_kernel_cpu,17046,0,1,1,64,0,0,0,0,1,30330000
nn_kernel_gpu,1799,1,1,236954,128,0,0,0,0,1,30330000
nn_kernel_gpu_mem,45056,1,1,236954,128,242640000,121320000,121320000,242640000,1,30330000
nn_kernel_cpu,25834,0,1,1,64,0,0,0,0,1,30340000
nn_kernel_gpu,1804,1,1,237032,128,0,0,0,0,1,30340000
nn_kernel_gpu_mem,39119,1,1,237032,128,242720000,121360000,121360000,242720000,1,30340000
nn_kernel_cpu,38534,0,1,1,64,0,0,0,0,1,30350000
nn_kernel_gpu,1815,1,1,237110,128,0,0,0,0,1,30350000
nn_kernel_gpu_mem,38690,1,1,237110,128,242800000,121400000,121400000,242800000,1,30350000
nn_kernel_cpu,26296,0,1,1,64,0,0,0,0,1,30360000
nn_kernel_gpu,1809,1,1,237188,128,0,0,0,0,1,30360000
nn_kernel_gpu_mem,48813,1,1,237188,128,242880000,121440000,121440000,242880000,1,30360000
nn_kernel_cpu,14475,0,1,1,64,0,0,0,0,1,30370000
nn_kernel_gpu,1818,1,1,237266,128,0,0,0,0,1,30370000
nn_kernel_gpu_mem,46636,1,1,237266,128,242960000,121480000,121480000,242960000,1,30370000
nn_kernel_cpu,21981,0,1,1,64,0,0,0,0,1,30380000
nn_kernel_gpu,1797,1,1,237344,128,0,0,0,0,1,30380000
nn_kernel_gpu_mem,42012,1,1,237344,128,243040000,121520000,121520000,243040000,1,30380000
nn_kernel_cpu,21124,0,1,1,64,0,0,0,0,1,30390000
nn_kernel_gpu,1830,1,1,237422,128,0,0,0,0,1,30390000
nn_kernel_gpu_mem,41350,1,1,237422,128,243120000,121560000,121560000,243120000,1,30390000
nn_kernel_cpu,13947,0,1,1,64,0,0,0,0,1,30400000
nn_kernel_gpu,1821,1,1,237500,128,0,0,0,0,1,30400000
nn_kernel_gpu_mem,46738,1,1,237500,128,243200000,121600000,121600000,243200000,1,30400000
nn_kernel_cpu,16757,0,1,1,64,0,0,0,0,1,3040000
nn_kernel_gpu,230,1,1,23750,128,0,0,0,0,1,3040000
nn_kernel_gpu_mem,3996,1,1,23750,128,24320000,12160000,12160000,24320000,1,3040000
nn_kernel_cpu,26187,0,1,1,64,0,0,0,0,1,30410000
nn_kernel_gpu,1801,1,1,237579,128,0,0,0,0,1,30410000
nn_kernel_gpu_mem,46519,1,1,237579,128,243280000,121640000,121640000,243280000,1,30410000
nn_kernel_cpu,21422,0,1,1,64,0,0,0,0,1,30420000
nn_kernel_gpu,1826,1,1,237657,128,0,0,0,0,1,30420000
nn_kernel_gpu_mem,47161,1,1,237657,128,243360000,121680000,121680000,243360000,1,30420000
nn_kernel_cpu,11946,0,1,1,64,0,0,0,0,1,30430000
nn_kernel_gpu,1825,1,1,237735,128,0,0,0,0,1,30430000
nn_kernel_gpu_mem,47340,1,1,237735,128,243440000,121720000,121720000,243440000,1,30430000
nn_kernel_cpu,27019,0,1,1,64,0,0,0,0,1,30440000
nn_kernel_gpu,1806,1,1,237813,128,0,0,0,0,1,30440000
nn_kernel_gpu_mem,48755,1,1,237813,128,243520000,121760000,121760000,243520000,1,30440000
nn_kernel_cpu,35000,0,1,1,64,0,0,0,0,1,30450000
nn_kernel_gpu,1837,1,1,237891,128,0,0,0,0,1,30450000
nn_kernel_gpu_mem,44090,1,1,237891,128,243600000,121800000,121800000,243600000,1,30450000
nn_kernel_cpu,14698,0,1,1,64,0,0,0,0,1,30460000
nn_kernel_gpu,1795,1,1,237969,128,0,0,0,0,1,30460000
nn_kernel_gpu_mem,41115,1,1,237969,128,243680000,121840000,121840000,243680000,1,30460000
nn_kernel_cpu,13351,0,1,1,64,0,0,0,0,1,30470000
nn_kernel_gpu,1802,1,1,238047,128,0,0,0,0,1,30470000
nn_kernel_gpu_mem,46657,1,1,238047,128,243760000,121880000,121880000,243760000,1,30470000
nn_kernel_cpu,18453,0,1,1,64,0,0,0,0,1,30480000
nn_kernel_gpu,1821,1,1,238125,128,0,0,0,0,1,30480000
nn_kernel_gpu_mem,35363,1,1,238125,128,243840000,121920000,121920000,243840000,1,30480000
nn_kernel_cpu,11396,0,1,1,64,0,0,0,0,1,30490000
nn_kernel_gpu,1824,1,1,238204,128,0,0,0,0,1,30490000
nn_kernel_gpu_mem,47140,1,1,238204,128,243920000,121960000,121960000,243920000,1,30490000
nn_kernel_cpu,22227,0,1,1,64,0,0,0,0,1,30500000
nn_kernel_gpu,1828,1,1,238282,128,0,0,0,0,1,30500000
nn_kernel_gpu_mem,39816,1,1,238282,128,244000000,122000000,122000000,244000000,1,30500000
nn_kernel_cpu,10254,0,1,1,64,0,0,0,0,1,3050000
nn_kernel_gpu,232,1,1,23829,128,0,0,0,0,1,3050000
nn_kernel_gpu_mem,4695,1,1,23829,128,24400000,12200000,12200000,24400000,1,3050000
nn_kernel_cpu,23294,0,1,1,64,0,0,0,0,1,30510000
nn_kernel_gpu,1805,1,1,238360,128,0,0,0,0,1,30510000
nn_kernel_gpu_mem,38642,1,1,238360,128,244080000,122040000,122040000,244080000,1,30510000
nn_kernel_cpu,15580,0,1,1,64,0,0,0,0,1,30520000
nn_kernel_gpu,1837,1,1,238438,128,0,0,0,0,1,30520000
nn_kernel_gpu_mem,42540,1,1,238438,128,244160000,122080000,122080000,244160000,1,30520000
nn_kernel_cpu,28900,0,1,1,64,0,0,0,0,1,30530000
nn_kernel_gpu,1830,1,1,238516,128,0,0,0,0,1,30530000
nn_kernel_gpu_mem,44323,1,1,238516,128,244240000,122120000,122120000,244240000,1,30530000
nn_kernel_cpu,14625,0,1,1,64,0,0,0,0,1,30540000
nn_kernel_gpu,1817,1,1,238594,128,0,0,0,0,1,30540000
nn_kernel_gpu_mem,49068,1,1,238594,128,244320000,122160000,122160000,244320000,1,30540000
nn_kernel_cpu,35840,0,1,1,64,0,0,0,0,1,30550000
nn_kernel_gpu,1831,1,1,238672,128,0,0,0,0,1,30550000
nn_kernel_gpu_mem,37847,1,1,238672,128,244400000,122200000,122200000,244400000,1,30550000
nn_kernel_cpu,24191,0,1,1,64,0,0,0,0,1,30560000
nn_kernel_gpu,1816,1,1,238750,128,0,0,0,0,1,30560000
nn_kernel_gpu_mem,47478,1,1,238750,128,244480000,122240000,122240000,244480000,1,30560000
nn_kernel_cpu,27161,0,1,1,64,0,0,0,0,1,30570000
nn_kernel_gpu,1815,1,1,238829,128,0,0,0,0,1,30570000
nn_kernel_gpu_mem,46172,1,1,238829,128,244560000,122280000,122280000,244560000,1,30570000
nn_kernel_cpu,35592,0,1,1,64,0,0,0,0,1,30580000
nn_kernel_gpu,1839,1,1,238907,128,0,0,0,0,1,30580000
nn_kernel_gpu_mem,41485,1,1,238907,128,244640000,122320000,122320000,244640000,1,30580000
nn_kernel_cpu,26665,0,1,1,64,0,0,0,0,1,30590000
nn_kernel_gpu,1818,1,1,238985,128,0,0,0,0,1,30590000
nn_kernel_gpu_mem,48682,1,1,238985,128,244720000,122360000,122360000,244720000,1,30590000
nn_kernel_cpu,30459,0,1,1,64,0,0,0,0,1,30600000
nn_kernel_gpu,1835,1,1,239063,128,0,0,0,0,1,30600000
nn_kernel_gpu_mem,36914,1,1,239063,128,244800000,122400000,122400000,244800000,1,30600000
nn_kernel_cpu,23937,0,1,1,64,0,0,0,0,1,3060000
nn_kernel_gpu,219,1,1,23907,128,0,0,0,0,1,3060000
nn_kernel_gpu_mem,7293,1,1,23907,128,24480000,12240000,12240000,24480000,1,3060000
nn_kernel_cpu,40723,0,1,1,64,0,0,0,0,1,30610000
nn_kernel_gpu,1831,1,1,239141,128,0,0,0,0,1,30610000
nn_kernel_gpu_mem,41016,1,1,239141,128,244880000,122440000,122440000,244880000,1,30610000
nn_kernel_cpu,25032,0,1,1,64,0,0,0,0,1,30620000
nn_kernel_gpu,1841,1,1,239219,128,0,0,0,0,1,30620000
nn_kernel_gpu_mem,46062,1,1,239219,128,244960000,122480000,122480000,244960000,1,30620000
nn_kernel_cpu,26458,0,1,1,64,0,0,0,0,1,30630000
nn_kernel_gpu,1836,1,1,239297,128,0,0,0,0,1,30630000
nn_kernel_gpu_mem,48495,1,1,239297,128,245040000,122520000,122520000,245040000,1,30630000
nn_kernel_cpu,38583,0,1,1,64,0,0,0,0,1,30640000
nn_kernel_gpu,1898,1,1,239375,128,0,0,0,0,1,30640000
nn_kernel_gpu_mem,46459,1,1,239375,128,245120000,122560000,122560000,245120000,1,30640000
nn_kernel_cpu,23898,0,1,1,64,0,0,0,0,1,30650000
nn_kernel_gpu,1825,1,1,239454,128,0,0,0,0,1,30650000
nn_kernel_gpu_mem,43070,1,1,239454,128,245200000,122600000,122600000,245200000,1,30650000
nn_kernel_cpu,16563,0,1,1,64,0,0,0,0,1,30660000
nn_kernel_gpu,1847,1,1,239532,128,0,0,0,0,1,30660000
nn_kernel_gpu_mem,35144,1,1,239532,128,245280000,122640000,122640000,245280000,1,30660000
nn_kernel_cpu,25595,0,1,1,64,0,0,0,0,1,30670000
nn_kernel_gpu,1829,1,1,239610,128,0,0,0,0,1,30670000
nn_kernel_gpu_mem,44946,1,1,239610,128,245360000,122680000,122680000,245360000,1,30670000
nn_kernel_cpu,27326,0,1,1,64,0,0,0,0,1,30680000
nn_kernel_gpu,1830,1,1,239688,128,0,0,0,0,1,30680000
nn_kernel_gpu_mem,46751,1,1,239688,128,245440000,122720000,122720000,245440000,1,30680000
nn_kernel_cpu,35714,0,1,1,64,0,0,0,0,1,30690000
nn_kernel_gpu,1845,1,1,239766,128,0,0,0,0,1,30690000
nn_kernel_gpu_mem,38033,1,1,239766,128,245520000,122760000,122760000,245520000,1,30690000
nn_kernel_cpu,19535,0,1,1,64,0,0,0,0,1,30700000
nn_kernel_gpu,1830,1,1,239844,128,0,0,0,0,1,30700000
nn_kernel_gpu_mem,45775,1,1,239844,128,245600000,122800000,122800000,245600000,1,30700000
nn_kernel_cpu,23611,0,1,1,64,0,0,0,0,1,3070000
nn_kernel_gpu,233,1,1,23985,128,0,0,0,0,1,3070000
nn_kernel_gpu_mem,4220,1,1,23985,128,24560000,12280000,12280000,24560000,1,3070000
nn_kernel_cpu,25791,0,1,1,64,0,0,0,0,1,30710000
nn_kernel_gpu,1845,1,1,239922,128,0,0,0,0,1,30710000
nn_kernel_gpu_mem,49312,1,1,239922,128,245680000,122840000,122840000,245680000,1,30710000
nn_kernel_cpu,13846,0,1,1,64,0,0,0,0,1,30720000
nn_kernel_gpu,1852,1,1,240000,128,0,0,0,0,1,30720000
nn_kernel_gpu_mem,47164,1,1,240000,128,245760000,122880000,122880000,245760000,1,30720000
nn_kernel_cpu,33230,0,1,1,64,0,0,0,0,1,30730000
nn_kernel_gpu,1830,1,1,240079,128,0,0,0,0,1,30730000
nn_kernel_gpu_mem,55465,1,1,240079,128,245840000,122920000,122920000,245840000,1,30730000
nn_kernel_cpu,30692,0,1,1,64,0,0,0,0,1,30740000
nn_kernel_gpu,1841,1,1,240157,128,0,0,0,0,1,30740000
nn_kernel_gpu_mem,40389,1,1,240157,128,245920000,122960000,122960000,245920000,1,30740000
nn_kernel_cpu,37420,0,1,1,64,0,0,0,0,1,30750000
nn_kernel_gpu,1832,1,1,240235,128,0,0,0,0,1,30750000
nn_kernel_gpu_mem,37638,1,1,240235,128,246000000,123000000,123000000,246000000,1,30750000
nn_kernel_cpu,27279,0,1,1,64,0,0,0,0,1,30760000
nn_kernel_gpu,1841,1,1,240313,128,0,0,0,0,1,30760000
nn_kernel_gpu_mem,48310,1,1,240313,128,246080000,123040000,123040000,246080000,1,30760000
nn_kernel_cpu,25025,0,1,1,64,0,0,0,0,1,30770000
nn_kernel_gpu,1849,1,1,240391,128,0,0,0,0,1,30770000
nn_kernel_gpu_mem,40085,1,1,240391,128,246160000,123080000,123080000,246160000,1,30770000
nn_kernel_cpu,24095,0,1,1,64,0,0,0,0,1,30780000
nn_kernel_gpu,1846,1,1,240469,128,0,0,0,0,1,30780000
nn_kernel_gpu_mem,44429,1,1,240469,128,246240000,123120000,123120000,246240000,1,30780000
nn_kernel_cpu,29896,0,1,1,64,0,0,0,0,1,30790000
nn_kernel_gpu,1863,1,1,240547,128,0,0,0,0,1,30790000
nn_kernel_gpu_mem,51017,1,1,240547,128,246320000,123160000,123160000,246320000,1,30790000
nn_kernel_cpu,47181,0,1,1,64,0,0,0,0,1,30800000
nn_kernel_gpu,1831,1,1,240625,128,0,0,0,0,1,30800000
nn_kernel_gpu_mem,42723,1,1,240625,128,246400000,123200000,123200000,246400000,1,30800000
nn_kernel_cpu,35523,0,1,1,64,0,0,0,0,1,3080000
nn_kernel_gpu,222,1,1,24063,128,0,0,0,0,1,3080000
nn_kernel_gpu_mem,4548,1,1,24063,128,24640000,12320000,12320000,24640000,1,3080000
nn_kernel_cpu,26950,0,1,1,64,0,0,0,0,1,30810000
nn_kernel_gpu,1840,1,1,240704,128,0,0,0,0,1,30810000
nn_kernel_gpu_mem,39394,1,1,240704,128,246480000,123240000,123240000,246480000,1,30810000
nn_kernel_cpu,26090,0,1,1,64,0,0,0,0,1,30820000
nn_kernel_gpu,1831,1,1,240782,128,0,0,0,0,1,30820000
nn_kernel_gpu_mem,47609,1,1,240782,128,246560000,123280000,123280000,246560000,1,30820000
nn_kernel_cpu,22428,0,1,1,64,0,0,0,0,1,30830000
nn_kernel_gpu,1852,1,1,240860,128,0,0,0,0,1,30830000
nn_kernel_gpu_mem,40548,1,1,240860,128,246640000,123320000,123320000,246640000,1,30830000
nn_kernel_cpu,23342,0,1,1,64,0,0,0,0,1,30840000
nn_kernel_gpu,1901,1,1,240938,128,0,0,0,0,1,30840000
nn_kernel_gpu_mem,48816,1,1,240938,128,246720000,123360000,123360000,246720000,1,30840000
nn_kernel_cpu,27566,0,1,1,64,0,0,0,0,1,30850000
nn_kernel_gpu,1820,1,1,241016,128,0,0,0,0,1,30850000
nn_kernel_gpu_mem,50734,1,1,241016,128,246800000,123400000,123400000,246800000,1,30850000
nn_kernel_cpu,27116,0,1,1,64,0,0,0,0,1,30860000
nn_kernel_gpu,1843,1,1,241094,128,0,0,0,0,1,30860000
nn_kernel_gpu_mem,44644,1,1,241094,128,246880000,123440000,123440000,246880000,1,30860000
nn_kernel_cpu,19605,0,1,1,64,0,0,0,0,1,30870000
nn_kernel_gpu,1830,1,1,241172,128,0,0,0,0,1,30870000
nn_kernel_gpu_mem,47700,1,1,241172,128,246960000,123480000,123480000,246960000,1,30870000
nn_kernel_cpu,28078,0,1,1,64,0,0,0,0,1,30880000
nn_kernel_gpu,1832,1,1,241250,128,0,0,0,0,1,30880000
nn_kernel_gpu_mem,49530,1,1,241250,128,247040000,123520000,123520000,247040000,1,30880000
nn_kernel_cpu,33694,0,1,1,64,0,0,0,0,1,30890000
nn_kernel_gpu,1834,1,1,241329,128,0,0,0,0,1,30890000
nn_kernel_gpu_mem,47406,1,1,241329,128,247120000,123560000,123560000,247120000,1,30890000
nn_kernel_cpu,22366,0,1,1,64,0,0,0,0,1,30900000
nn_kernel_gpu,1840,1,1,241407,128,0,0,0,0,1,30900000
nn_kernel_gpu_mem,39979,1,1,241407,128,247200000,123600000,123600000,247200000,1,30900000
nn_kernel_cpu,16159,0,1,1,64,0,0,0,0,1,3090000
nn_kernel_gpu,239,1,1,24141,128,0,0,0,0,1,3090000
nn_kernel_gpu_mem,11897,1,1,24141,128,24720000,12360000,12360000,24720000,1,3090000
nn_kernel_cpu,18600,0,1,1,64,0,0,0,0,1,30910000
nn_kernel_gpu,2082,1,1,241485,128,0,0,0,0,1,30910000
nn_kernel_gpu_mem,43377,1,1,241485,128,247280000,123640000,123640000,247280000,1,30910000
nn_kernel_cpu,51747,0,1,1,64,0,0,0,0,1,30920000
nn_kernel_gpu,1855,1,1,241563,128,0,0,0,0,1,30920000
nn_kernel_gpu_mem,44057,1,1,241563,128,247360000,123680000,123680000,247360000,1,30920000
nn_kernel_cpu,25101,0,1,1,64,0,0,0,0,1,30930000
nn_kernel_gpu,1853,1,1,241641,128,0,0,0,0,1,30930000
nn_kernel_gpu_mem,38347,1,1,241641,128,247440000,123720000,123720000,247440000,1,30930000
nn_kernel_cpu,32943,0,1,1,64,0,0,0,0,1,30940000
nn_kernel_gpu,1866,1,1,241719,128,0,0,0,0,1,30940000
nn_kernel_gpu_mem,47138,1,1,241719,128,247520000,123760000,123760000,247520000,1,30940000
nn_kernel_cpu,34139,0,1,1,64,0,0,0,0,1,30950000
nn_kernel_gpu,1837,1,1,241797,128,0,0,0,0,1,30950000
nn_kernel_gpu_mem,47499,1,1,241797,128,247600000,123800000,123800000,247600000,1,30950000
nn_kernel_cpu,28571,0,1,1,64,0,0,0,0,1,30960000
nn_kernel_gpu,1835,1,1,241875,128,0,0,0,0,1,30960000
nn_kernel_gpu_mem,36648,1,1,241875,128,247680000,123840000,123840000,247680000,1,30960000
nn_kernel_cpu,28067,0,1,1,64,0,0,0,0,1,30970000
nn_kernel_gpu,1838,1,1,241954,128,0,0,0,0,1,30970000
nn_kernel_gpu_mem,46337,1,1,241954,128,247760000,123880000,123880000,247760000,1,30970000
nn_kernel_cpu,24815,0,1,1,64,0,0,0,0,1,30980000
nn_kernel_gpu,1840,1,1,242032,128,0,0,0,0,1,30980000
nn_kernel_gpu_mem,47654,1,1,242032,128,247840000,123920000,123920000,247840000,1,30980000
nn_kernel_cpu,16631,0,1,1,64,0,0,0,0,1,30990000
nn_kernel_gpu,1840,1,1,242110,128,0,0,0,0,1,30990000
nn_kernel_gpu_mem,47824,1,1,242110,128,247920000,123960000,123960000,247920000,1,30990000
nn_kernel_cpu,26478,0,1,1,64,0,0,0,0,1,31000000
nn_kernel_gpu,1847,1,1,242188,128,0,0,0,0,1,31000000
nn_kernel_gpu_mem,41615,1,1,242188,128,248000000,124000000,124000000,248000000,1,31000000
nn_kernel_cpu,19380,0,1,1,64,0,0,0,0,1,3100000
nn_kernel_gpu,235,1,1,24219,128,0,0,0,0,1,3100000
nn_kernel_gpu_mem,8645,1,1,24219,128,24800000,12400000,12400000,24800000,1,3100000
nn_kernel_cpu,23689,0,1,1,64,0,0,0,0,1,310000
nn_kernel_gpu,59,1,1,2422,128,0,0,0,0,1,310000
nn_kernel_gpu_mem,720,1,1,2422,128,2480000,1240000,1240000,2480000,1,310000
nn_kernel_cpu,23161,0,1,1,64,0,0,0,0,1,31010000
nn_kernel_gpu,1856,1,1,242266,128,0,0,0,0,1,31010000
nn_kernel_gpu_mem,49382,1,1,242266,128,248080000,124040000,124040000,248080000,1,31010000
nn_kernel_cpu,23337,0,1,1,64,0,0,0,0,1,31020000
nn_kernel_gpu,1879,1,1,242344,128,0,0,0,0,1,31020000
nn_kernel_gpu_mem,41056,1,1,242344,128,248160000,124080000,124080000,248160000,1,31020000
nn_kernel_cpu,34977,0,1,1,64,0,0,0,0,1,31030000
nn_kernel_gpu,1855,1,1,242422,128,0,0,0,0,1,31030000
nn_kernel_gpu_mem,40755,1,1,242422,128,248240000,124120000,124120000,248240000,1,31030000
nn_kernel_cpu,24225,0,1,1,64,0,0,0,0,1,31040000
nn_kernel_gpu,1844,1,1,242500,128,0,0,0,0,1,31040000
nn_kernel_gpu_mem,46720,1,1,242500,128,248320000,124160000,124160000,248320000,1,31040000
nn_kernel_cpu,26060,0,1,1,64,0,0,0,0,1,31050000
nn_kernel_gpu,1853,1,1,242579,128,0,0,0,0,1,31050000
nn_kernel_gpu_mem,40438,1,1,242579,128,248400000,124200000,124200000,248400000,1,31050000
nn_kernel_cpu,26814,0,1,1,64,0,0,0,0,1,31060000
nn_kernel_gpu,1855,1,1,242657,128,0,0,0,0,1,31060000
nn_kernel_gpu_mem,48658,1,1,242657,128,248480000,124240000,124240000,248480000,1,31060000
nn_kernel_cpu,25622,0,1,1,64,0,0,0,0,1,31070000
nn_kernel_gpu,1869,1,1,242735,128,0,0,0,0,1,31070000
nn_kernel_gpu_mem,47443,1,1,242735,128,248560000,124280000,124280000,248560000,1,31070000
nn_kernel_cpu,26588,0,1,1,64,0,0,0,0,1,31080000
nn_kernel_gpu,1849,1,1,242813,128,0,0,0,0,1,31080000
nn_kernel_gpu_mem,42510,1,1,242813,128,248640000,124320000,124320000,248640000,1,31080000
nn_kernel_cpu,31329,0,1,1,64,0,0,0,0,1,31090000
nn_kernel_gpu,1863,1,1,242891,128,0,0,0,0,1,31090000
nn_kernel_gpu_mem,47091,1,1,242891,128,248720000,124360000,124360000,248720000,1,31090000
nn_kernel_cpu,12770,0,1,1,64,0,0,0,0,1,31100000
nn_kernel_gpu,1870,1,1,242969,128,0,0,0,0,1,31100000
nn_kernel_gpu_mem,46929,1,1,242969,128,248800000,124400000,124400000,248800000,1,31100000
nn_kernel_cpu,28098,0,1,1,64,0,0,0,0,1,3110000
nn_kernel_gpu,233,1,1,24297,128,0,0,0,0,1,3110000
nn_kernel_gpu_mem,4437,1,1,24297,128,24880000,12440000,12440000,24880000,1,3110000
nn_kernel_cpu,23289,0,1,1,64,0,0,0,0,1,31110000
nn_kernel_gpu,1854,1,1,243047,128,0,0,0,0,1,31110000
nn_kernel_gpu_mem,40415,1,1,243047,128,248880000,124440000,124440000,248880000,1,31110000
nn_kernel_cpu,23191,0,1,1,64,0,0,0,0,1,31120000
nn_kernel_gpu,1882,1,1,243125,128,0,0,0,0,1,31120000
nn_kernel_gpu_mem,40651,1,1,243125,128,248960000,124480000,124480000,248960000,1,31120000
nn_kernel_cpu,25114,0,1,1,64,0,0,0,0,1,31130000
nn_kernel_gpu,1855,1,1,243204,128,0,0,0,0,1,31130000
nn_kernel_gpu_mem,40562,1,1,243204,128,249040000,124520000,124520000,249040000,1,31130000
nn_kernel_cpu,29530,0,1,1,64,0,0,0,0,1,31140000
nn_kernel_gpu,1851,1,1,243282,128,0,0,0,0,1,31140000
nn_kernel_gpu_mem,45516,1,1,243282,128,249120000,124560000,124560000,249120000,1,31140000
nn_kernel_cpu,25322,0,1,1,64,0,0,0,0,1,31150000
nn_kernel_gpu,1887,1,1,243360,128,0,0,0,0,1,31150000
nn_kernel_gpu_mem,48388,1,1,243360,128,249200000,124600000,124600000,249200000,1,31150000
nn_kernel_cpu,27003,0,1,1,64,0,0,0,0,1,31160000
nn_kernel_gpu,1847,1,1,243438,128,0,0,0,0,1,31160000
nn_kernel_gpu_mem,47705,1,1,243438,128,249280000,124640000,124640000,249280000,1,31160000
nn_kernel_cpu,23615,0,1,1,64,0,0,0,0,1,31170000
nn_kernel_gpu,1867,1,1,243516,128,0,0,0,0,1,31170000
nn_kernel_gpu_mem,40248,1,1,243516,128,249360000,124680000,124680000,249360000,1,31170000
nn_kernel_cpu,28095,0,1,1,64,0,0,0,0,1,31180000
nn_kernel_gpu,1874,1,1,243594,128,0,0,0,0,1,31180000
nn_kernel_gpu_mem,49640,1,1,243594,128,249440000,124720000,124720000,249440000,1,31180000
nn_kernel_cpu,27417,0,1,1,64,0,0,0,0,1,31190000
nn_kernel_gpu,1860,1,1,243672,128,0,0,0,0,1,31190000
nn_kernel_gpu_mem,38451,1,1,243672,128,249520000,124760000,124760000,249520000,1,31190000
nn_kernel_cpu,15527,0,1,1,64,0,0,0,0,1,31200000
nn_kernel_gpu,1867,1,1,243750,128,0,0,0,0,1,31200000
nn_kernel_gpu_mem,47488,1,1,243750,128,249600000,124800000,124800000,249600000,1,31200000
nn_kernel_cpu,15127,0,1,1,64,0,0,0,0,1,3120000
nn_kernel_gpu,237,1,1,24375,128,0,0,0,0,1,3120000
nn_kernel_gpu_mem,11261,1,1,24375,128,24960000,12480000,12480000,24960000,1,3120000
nn_kernel_cpu,24579,0,1,1,64,0,0,0,0,1,31210000
nn_kernel_gpu,1856,1,1,243829,128,0,0,0,0,1,31210000
nn_kernel_gpu_mem,47054,1,1,243829,128,249680000,124840000,124840000,249680000,1,31210000
nn_kernel_cpu,29400,0,1,1,64,0,0,0,0,1,31220000
nn_kernel_gpu,1877,1,1,243907,128,0,0,0,0,1,31220000
nn_kernel_gpu_mem,46011,1,1,243907,128,249760000,124880000,124880000,249760000,1,31220000
nn_kernel_cpu,27623,0,1,1,64,0,0,0,0,1,31230000
nn_kernel_gpu,1866,1,1,243985,128,0,0,0,0,1,31230000
nn_kernel_gpu_mem,47776,1,1,243985,128,249840000,124920000,124920000,249840000,1,31230000
nn_kernel_cpu,35441,0,1,1,64,0,0,0,0,1,31240000
nn_kernel_gpu,1881,1,1,244063,128,0,0,0,0,1,31240000
nn_kernel_gpu_mem,41085,1,1,244063,128,249920000,124960000,124960000,249920000,1,31240000
nn_kernel_cpu,42805,0,1,1,64,0,0,0,0,1,31250000
nn_kernel_gpu,1872,1,1,244141,128,0,0,0,0,1,31250000
nn_kernel_gpu_mem,65965,1,1,244141,128,250000000,125000000,125000000,250000000,1,31250000
nn_kernel_cpu,26018,0,1,1,64,0,0,0,0,1,31260000
nn_kernel_gpu,1887,1,1,244219,128,0,0,0,0,1,31260000
nn_kernel_gpu_mem,49322,1,1,244219,128,250080000,125040000,125040000,250080000,1,31260000
nn_kernel_cpu,30557,0,1,1,64,0,0,0,0,1,31270000
nn_kernel_gpu,1878,1,1,244297,128,0,0,0,0,1,31270000
nn_kernel_gpu_mem,42658,1,1,244297,128,250160000,125080000,125080000,250160000,1,31270000
nn_kernel_cpu,26394,0,1,1,64,0,0,0,0,1,31280000
nn_kernel_gpu,1872,1,1,244375,128,0,0,0,0,1,31280000
nn_kernel_gpu_mem,46541,1,1,244375,128,250240000,125120000,125120000,250240000,1,31280000
nn_kernel_cpu,24638,0,1,1,64,0,0,0,0,1,31290000
nn_kernel_gpu,1910,1,1,244454,128,0,0,0,0,1,31290000
nn_kernel_gpu_mem,40466,1,1,244454,128,250320000,125160000,125160000,250320000,1,31290000
nn_kernel_cpu,26124,0,1,1,64,0,0,0,0,1,31300000
nn_kernel_gpu,1870,1,1,244532,128,0,0,0,0,1,31300000
nn_kernel_gpu_mem,39828,1,1,244532,128,250400000,125200000,125200000,250400000,1,31300000
nn_kernel_cpu,17785,0,1,1,64,0,0,0,0,1,3130000
nn_kernel_gpu,246,1,1,24454,128,0,0,0,0,1,3130000
nn_kernel_gpu_mem,12989,1,1,24454,128,25040000,12520000,12520000,25040000,1,3130000
nn_kernel_cpu,30783,0,1,1,64,0,0,0,0,1,31310000
nn_kernel_gpu,1862,1,1,244610,128,0,0,0,0,1,31310000
nn_kernel_gpu_mem,44121,1,1,244610,128,250480000,125240000,125240000,250480000,1,31310000
nn_kernel_cpu,20554,0,1,1,64,0,0,0,0,1,31320000
nn_kernel_gpu,1888,1,1,244688,128,0,0,0,0,1,31320000
nn_kernel_gpu_mem,42394,1,1,244688,128,250560000,125280000,125280000,250560000,1,31320000
nn_kernel_cpu,29209,0,1,1,64,0,0,0,0,1,31330000
nn_kernel_gpu,1882,1,1,244766,128,0,0,0,0,1,31330000
nn_kernel_gpu_mem,40574,1,1,244766,128,250640000,125320000,125320000,250640000,1,31330000
nn_kernel_cpu,29548,0,1,1,64,0,0,0,0,1,31340000
nn_kernel_gpu,1873,1,1,244844,128,0,0,0,0,1,31340000
nn_kernel_gpu_mem,47675,1,1,244844,128,250720000,125360000,125360000,250720000,1,31340000
nn_kernel_cpu,27276,0,1,1,64,0,0,0,0,1,31350000
nn_kernel_gpu,1876,1,1,244922,128,0,0,0,0,1,31350000
nn_kernel_gpu_mem,41294,1,1,244922,128,250800000,125400000,125400000,250800000,1,31350000
nn_kernel_cpu,17686,0,1,1,64,0,0,0,0,1,31360000
nn_kernel_gpu,1896,1,1,245000,128,0,0,0,0,1,31360000
nn_kernel_gpu_mem,58139,1,1,245000,128,250880000,125440000,125440000,250880000,1,31360000
nn_kernel_cpu,27185,0,1,1,64,0,0,0,0,1,31370000
nn_kernel_gpu,1865,1,1,245079,128,0,0,0,0,1,31370000
nn_kernel_gpu_mem,45086,1,1,245079,128,250960000,125480000,125480000,250960000,1,31370000
nn_kernel_cpu,21872,0,1,1,64,0,0,0,0,1,31380000
nn_kernel_gpu,1894,1,1,245157,128,0,0,0,0,1,31380000
nn_kernel_gpu_mem,62700,1,1,245157,128,251040000,125520000,125520000,251040000,1,31380000
nn_kernel_cpu,44213,0,1,1,64,0,0,0,0,1,31390000
nn_kernel_gpu,1911,1,1,245235,128,0,0,0,0,1,31390000
nn_kernel_gpu_mem,38344,1,1,245235,128,251120000,125560000,125560000,251120000,1,31390000
nn_kernel_cpu,26978,0,1,1,64,0,0,0,0,1,31400000
nn_kernel_gpu,1887,1,1,245313,128,0,0,0,0,1,31400000
nn_kernel_gpu_mem,41300,1,1,245313,128,251200000,125600000,125600000,251200000,1,31400000
nn_kernel_cpu,28072,0,1,1,64,0,0,0,0,1,3140000
nn_kernel_gpu,237,1,1,24532,128,0,0,0,0,1,3140000
nn_kernel_gpu_mem,6573,1,1,24532,128,25120000,12560000,12560000,25120000,1,3140000
nn_kernel_cpu,32234,0,1,1,64,0,0,0,0,1,31410000
nn_kernel_gpu,1884,1,1,245391,128,0,0,0,0,1,31410000
nn_kernel_gpu_mem,41088,1,1,245391,128,251280000,125640000,125640000,251280000,1,31410000
nn_kernel_cpu,27648,0,1,1,64,0,0,0,0,1,31420000
nn_kernel_gpu,1898,1,1,245469,128,0,0,0,0,1,31420000
nn_kernel_gpu_mem,47755,1,1,245469,128,251360000,125680000,125680000,251360000,1,31420000
nn_kernel_cpu,9650,0,1,1,64,0,0,0,0,1,31430000
nn_kernel_gpu,1876,1,1,245547,128,0,0,0,0,1,31430000
nn_kernel_gpu_mem,47050,1,1,245547,128,251440000,125720000,125720000,251440000,1,31430000
nn_kernel_cpu,36563,0,1,1,64,0,0,0,0,1,31440000
nn_kernel_gpu,1900,1,1,245625,128,0,0,0,0,1,31440000
nn_kernel_gpu_mem,37446,1,1,245625,128,251520000,125760000,125760000,251520000,1,31440000
nn_kernel_cpu,26512,0,1,1,64,0,0,0,0,1,31450000
nn_kernel_gpu,1866,1,1,245704,128,0,0,0,0,1,31450000
nn_kernel_gpu_mem,49996,1,1,245704,128,251600000,125800000,125800000,251600000,1,31450000
nn_kernel_cpu,15260,0,1,1,64,0,0,0,0,1,31460000
nn_kernel_gpu,1870,1,1,245782,128,0,0,0,0,1,31460000
nn_kernel_gpu_mem,42751,1,1,245782,128,251680000,125840000,125840000,251680000,1,31460000
nn_kernel_cpu,16456,0,1,1,64,0,0,0,0,1,31470000
nn_kernel_gpu,1869,1,1,245860,128,0,0,0,0,1,31470000
nn_kernel_gpu_mem,45615,1,1,245860,128,251760000,125880000,125880000,251760000,1,31470000
nn_kernel_cpu,9262,0,1,1,64,0,0,0,0,1,31480000
nn_kernel_gpu,1893,1,1,245938,128,0,0,0,0,1,31480000
nn_kernel_gpu_mem,48431,1,1,245938,128,251840000,125920000,125920000,251840000,1,31480000
nn_kernel_cpu,21817,0,1,1,64,0,0,0,0,1,31490000
nn_kernel_gpu,1883,1,1,246016,128,0,0,0,0,1,31490000
nn_kernel_gpu_mem,45488,1,1,246016,128,251920000,125960000,125960000,251920000,1,31490000
nn_kernel_cpu,26839,0,1,1,64,0,0,0,0,1,31500000
nn_kernel_gpu,1880,1,1,246094,128,0,0,0,0,1,31500000
nn_kernel_gpu_mem,39690,1,1,246094,128,252000000,126000000,126000000,252000000,1,31500000
nn_kernel_cpu,21429,0,1,1,64,0,0,0,0,1,3150000
nn_kernel_gpu,224,1,1,24610,128,0,0,0,0,1,3150000
nn_kernel_gpu_mem,10369,1,1,24610,128,25200000,12600000,12600000,25200000,1,3150000
nn_kernel_cpu,26214,0,1,1,64,0,0,0,0,1,31510000
nn_kernel_gpu,1862,1,1,246172,128,0,0,0,0,1,31510000
nn_kernel_gpu_mem,49549,1,1,246172,128,252080000,126040000,126040000,252080000,1,31510000
nn_kernel_cpu,19655,0,1,1,64,0,0,0,0,1,31520000
nn_kernel_gpu,1887,1,1,246250,128,0,0,0,0,1,31520000
nn_kernel_gpu_mem,37902,1,1,246250,128,252160000,126080000,126080000,252160000,1,31520000
nn_kernel_cpu,27503,0,1,1,64,0,0,0,0,1,31530000
nn_kernel_gpu,1865,1,1,246329,128,0,0,0,0,1,31530000
nn_kernel_gpu_mem,47471,1,1,246329,128,252240000,126120000,126120000,252240000,1,31530000
nn_kernel_cpu,29196,0,1,1,64,0,0,0,0,1,31540000
nn_kernel_gpu,1889,1,1,246407,128,0,0,0,0,1,31540000
nn_kernel_gpu_mem,41243,1,1,246407,128,252320000,126160000,126160000,252320000,1,31540000
nn_kernel_cpu,23085,0,1,1,64,0,0,0,0,1,31550000
nn_kernel_gpu,1862,1,1,246485,128,0,0,0,0,1,31550000
nn_kernel_gpu_mem,49074,1,1,246485,128,252400000,126200000,126200000,252400000,1,31550000
nn_kernel_cpu,27265,0,1,1,64,0,0,0,0,1,31560000
nn_kernel_gpu,1868,1,1,246563,128,0,0,0,0,1,31560000
nn_kernel_gpu_mem,46316,1,1,246563,128,252480000,126240000,126240000,252480000,1,31560000
nn_kernel_cpu,19316,0,1,1,64,0,0,0,0,1,31570000
nn_kernel_gpu,1857,1,1,246641,128,0,0,0,0,1,31570000
nn_kernel_gpu_mem,48499,1,1,246641,128,252560000,126280000,126280000,252560000,1,31570000
nn_kernel_cpu,12864,0,1,1,64,0,0,0,0,1,31580000
nn_kernel_gpu,1878,1,1,246719,128,0,0,0,0,1,31580000
nn_kernel_gpu_mem,50280,1,1,246719,128,252640000,126320000,126320000,252640000,1,31580000
nn_kernel_cpu,24108,0,1,1,64,0,0,0,0,1,31590000
nn_kernel_gpu,1897,1,1,246797,128,0,0,0,0,1,31590000
nn_kernel_gpu_mem,47844,1,1,246797,128,252720000,126360000,126360000,252720000,1,31590000
nn_kernel_cpu,21743,0,1,1,64,0,0,0,0,1,31600000
nn_kernel_gpu,1865,1,1,246875,128,0,0,0,0,1,31600000
nn_kernel_gpu_mem,48208,1,1,246875,128,252800000,126400000,126400000,252800000,1,31600000
nn_kernel_cpu,21573,0,1,1,64,0,0,0,0,1,3160000
nn_kernel_gpu,247,1,1,24688,128,0,0,0,0,1,3160000
nn_kernel_gpu_mem,4957,1,1,24688,128,25280000,12640000,12640000,25280000,1,3160000
nn_kernel_cpu,16936,0,1,1,64,0,0,0,0,1,31610000
nn_kernel_gpu,1885,1,1,246954,128,0,0,0,0,1,31610000
nn_kernel_gpu_mem,47607,1,1,246954,128,252880000,126440000,126440000,252880000,1,31610000
nn_kernel_cpu,27453,0,1,1,64,0,0,0,0,1,31620000
nn_kernel_gpu,1882,1,1,247032,128,0,0,0,0,1,31620000
nn_kernel_gpu_mem,42164,1,1,247032,128,252960000,126480000,126480000,252960000,1,31620000
nn_kernel_cpu,24487,0,1,1,64,0,0,0,0,1,31630000
nn_kernel_gpu,1883,1,1,247110,128,0,0,0,0,1,31630000
nn_kernel_gpu_mem,48361,1,1,247110,128,253040000,126520000,126520000,253040000,1,31630000
nn_kernel_cpu,39978,0,1,1,64,0,0,0,0,1,31640000
nn_kernel_gpu,1865,1,1,247188,128,0,0,0,0,1,31640000
nn_kernel_gpu_mem,45976,1,1,247188,128,253120000,126560000,126560000,253120000,1,31640000
nn_kernel_cpu,47474,0,1,1,64,0,0,0,0,1,31650000
nn_kernel_gpu,1877,1,1,247266,128,0,0,0,0,1,31650000
nn_kernel_gpu_mem,46890,1,1,247266,128,253200000,126600000,126600000,253200000,1,31650000
nn_kernel_cpu,12541,0,1,1,64,0,0,0,0,1,31660000
nn_kernel_gpu,1889,1,1,247344,128,0,0,0,0,1,31660000
nn_kernel_gpu_mem,43138,1,1,247344,128,253280000,126640000,126640000,253280000,1,31660000
nn_kernel_cpu,20496,0,1,1,64,0,0,0,0,1,31670000
nn_kernel_gpu,1873,1,1,247422,128,0,0,0,0,1,31670000
nn_kernel_gpu_mem,46589,1,1,247422,128,253360000,126680000,126680000,253360000,1,31670000
nn_kernel_cpu,37790,0,1,1,64,0,0,0,0,1,31680000
nn_kernel_gpu,1900,1,1,247500,128,0,0,0,0,1,31680000
nn_kernel_gpu_mem,48062,1,1,247500,128,253440000,126720000,126720000,253440000,1,31680000
nn_kernel_cpu,52919,0,1,1,64,0,0,0,0,1,31690000
nn_kernel_gpu,1897,1,1,247579,128,0,0,0,0,1,31690000
nn_kernel_gpu_mem,38533,1,1,247579,128,253520000,126760000,126760000,253520000,1,31690000
nn_kernel_cpu,15427,0,1,1,64,0,0,0,0,1,31700000
nn_kernel_gpu,1893,1,1,247657,128,0,0,0,0,1,31700000
nn_kernel_gpu_mem,43180,1,1,247657,128,253600000,126800000,126800000,253600000,1,31700000
nn_kernel_cpu,6586,0,1,1,64,0,0,0,0,1,3170000
nn_kernel_gpu,233,1,1,24766,128,0,0,0,0,1,3170000
nn_kernel_gpu_mem,5183,1,1,24766,128,25360000,12680000,12680000,25360000,1,3170000
nn_kernel_cpu,15155,0,1,1,64,0,0,0,0,1,31710000
nn_kernel_gpu,1885,1,1,247735,128,0,0,0,0,1,31710000
nn_kernel_gpu_mem,48794,1,1,247735,128,253680000,126840000,126840000,253680000,1,31710000
nn_kernel_cpu,24298,0,1,1,64,0,0,0,0,1,31720000
nn_kernel_gpu,1894,1,1,247813,128,0,0,0,0,1,31720000
nn_kernel_gpu_mem,50989,1,1,247813,128,253760000,126880000,126880000,253760000,1,31720000
nn_kernel_cpu,28948,0,1,1,64,0,0,0,0,1,31730000
nn_kernel_gpu,1896,1,1,247891,128,0,0,0,0,1,31730000
nn_kernel_gpu_mem,42291,1,1,247891,128,253840000,126920000,126920000,253840000,1,31730000
nn_kernel_cpu,11788,0,1,1,64,0,0,0,0,1,31740000
nn_kernel_gpu,1891,1,1,247969,128,0,0,0,0,1,31740000
nn_kernel_gpu_mem,47950,1,1,247969,128,253920000,126960000,126960000,253920000,1,31740000
nn_kernel_cpu,17146,0,1,1,64,0,0,0,0,1,31750000
nn_kernel_gpu,1897,1,1,248047,128,0,0,0,0,1,31750000
nn_kernel_gpu_mem,48399,1,1,248047,128,254000000,127000000,127000000,254000000,1,31750000
nn_kernel_cpu,16608,0,1,1,64,0,0,0,0,1,31760000
nn_kernel_gpu,1899,1,1,248125,128,0,0,0,0,1,31760000
nn_kernel_gpu_mem,48175,1,1,248125,128,254080000,127040000,127040000,254080000,1,31760000
nn_kernel_cpu,31857,0,1,1,64,0,0,0,0,1,31770000
nn_kernel_gpu,1901,1,1,248204,128,0,0,0,0,1,31770000
nn_kernel_gpu_mem,42664,1,1,248204,128,254160000,127080000,127080000,254160000,1,31770000
nn_kernel_cpu,19049,0,1,1,64,0,0,0,0,1,31780000
nn_kernel_gpu,1889,1,1,248282,128,0,0,0,0,1,31780000
nn_kernel_gpu_mem,48885,1,1,248282,128,254240000,127120000,127120000,254240000,1,31780000
nn_kernel_cpu,17923,0,1,1,64,0,0,0,0,1,31790000
nn_kernel_gpu,1895,1,1,248360,128,0,0,0,0,1,31790000
nn_kernel_gpu_mem,51683,1,1,248360,128,254320000,127160000,127160000,254320000,1,31790000
nn_kernel_cpu,22281,0,1,1,64,0,0,0,0,1,31800000
nn_kernel_gpu,1889,1,1,248438,128,0,0,0,0,1,31800000
nn_kernel_gpu_mem,46781,1,1,248438,128,254400000,127200000,127200000,254400000,1,31800000
nn_kernel_cpu,2371,0,1,1,64,0,0,0,0,1,3180000
nn_kernel_gpu,258,1,1,24844,128,0,0,0,0,1,3180000
nn_kernel_gpu_mem,4937,1,1,24844,128,25440000,12720000,12720000,25440000,1,3180000
nn_kernel_cpu,43487,0,1,1,64,0,0,0,0,1,31810000
nn_kernel_gpu,1907,1,1,248516,128,0,0,0,0,1,31810000
nn_kernel_gpu_mem,43127,1,1,248516,128,254480000,127240000,127240000,254480000,1,31810000
nn_kernel_cpu,20109,0,1,1,64,0,0,0,0,1,31820000
nn_kernel_gpu,1909,1,1,248594,128,0,0,0,0,1,31820000
nn_kernel_gpu_mem,48683,1,1,248594,128,254560000,127280000,127280000,254560000,1,31820000
nn_kernel_cpu,35610,0,1,1,64,0,0,0,0,1,31830000
nn_kernel_gpu,1897,1,1,248672,128,0,0,0,0,1,31830000
nn_kernel_gpu_mem,50513,1,1,248672,128,254640000,127320000,127320000,254640000,1,31830000
nn_kernel_cpu,21775,0,1,1,64,0,0,0,0,1,31840000
nn_kernel_gpu,1906,1,1,248750,128,0,0,0,0,1,31840000
nn_kernel_gpu_mem,48982,1,1,248750,128,254720000,127360000,127360000,254720000,1,31840000
nn_kernel_cpu,19332,0,1,1,64,0,0,0,0,1,31850000
nn_kernel_gpu,1876,1,1,248829,128,0,0,0,0,1,31850000
nn_kernel_gpu_mem,50205,1,1,248829,128,254800000,127400000,127400000,254800000,1,31850000
nn_kernel_cpu,28950,0,1,1,64,0,0,0,0,1,31860000
nn_kernel_gpu,1898,1,1,248907,128,0,0,0,0,1,31860000
nn_kernel_gpu_mem,50616,1,1,248907,128,254880000,127440000,127440000,254880000,1,31860000
nn_kernel_cpu,10315,0,1,1,64,0,0,0,0,1,31870000
nn_kernel_gpu,1899,1,1,248985,128,0,0,0,0,1,31870000
nn_kernel_gpu_mem,42322,1,1,248985,128,254960000,127480000,127480000,254960000,1,31870000
nn_kernel_cpu,38069,0,1,1,64,0,0,0,0,1,31880000
nn_kernel_gpu,1925,1,1,249063,128,0,0,0,0,1,31880000
nn_kernel_gpu_mem,47929,1,1,249063,128,255040000,127520000,127520000,255040000,1,31880000
nn_kernel_cpu,24228,0,1,1,64,0,0,0,0,1,31890000
nn_kernel_gpu,1901,1,1,249141,128,0,0,0,0,1,31890000
nn_kernel_gpu_mem,42558,1,1,249141,128,255120000,127560000,127560000,255120000,1,31890000
nn_kernel_cpu,28027,0,1,1,64,0,0,0,0,1,31900000
nn_kernel_gpu,1905,1,1,249219,128,0,0,0,0,1,31900000
nn_kernel_gpu_mem,44029,1,1,249219,128,255200000,127600000,127600000,255200000,1,31900000
nn_kernel_cpu,23322,0,1,1,64,0,0,0,0,1,3190000
nn_kernel_gpu,242,1,1,24922,128,0,0,0,0,1,3190000
nn_kernel_gpu_mem,5340,1,1,24922,128,25520000,12760000,12760000,25520000,1,3190000
nn_kernel_cpu,15639,0,1,1,64,0,0,0,0,1,31910000
nn_kernel_gpu,1904,1,1,249297,128,0,0,0,0,1,31910000
nn_kernel_gpu_mem,42664,1,1,249297,128,255280000,127640000,127640000,255280000,1,31910000
nn_kernel_cpu,19978,0,1,1,64,0,0,0,0,1,31920000
nn_kernel_gpu,1902,1,1,249375,128,0,0,0,0,1,31920000
nn_kernel_gpu_mem,49497,1,1,249375,128,255360000,127680000,127680000,255360000,1,31920000
nn_kernel_cpu,10526,0,1,1,64,0,0,0,0,1,31930000
nn_kernel_gpu,1885,1,1,249454,128,0,0,0,0,1,31930000
nn_kernel_gpu_mem,48112,1,1,249454,128,255440000,127720000,127720000,255440000,1,31930000
nn_kernel_cpu,25102,0,1,1,64,0,0,0,0,1,31940000
nn_kernel_gpu,1910,1,1,249532,128,0,0,0,0,1,31940000
nn_kernel_gpu_mem,50121,1,1,249532,128,255520000,127760000,127760000,255520000,1,31940000
nn_kernel_cpu,17017,0,1,1,64,0,0,0,0,1,31950000
nn_kernel_gpu,1901,1,1,249610,128,0,0,0,0,1,31950000
nn_kernel_gpu_mem,48749,1,1,249610,128,255600000,127800000,127800000,255600000,1,31950000
nn_kernel_cpu,22445,0,1,1,64,0,0,0,0,1,31960000
nn_kernel_gpu,1878,1,1,249688,128,0,0,0,0,1,31960000
nn_kernel_gpu_mem,49906,1,1,249688,128,255680000,127840000,127840000,255680000,1,31960000
nn_kernel_cpu,25199,0,1,1,64,0,0,0,0,1,31970000
nn_kernel_gpu,1897,1,1,249766,128,0,0,0,0,1,31970000
nn_kernel_gpu_mem,43304,1,1,249766,128,255760000,127880000,127880000,255760000,1,31970000
nn_kernel_cpu,13960,0,1,1,64,0,0,0,0,1,31980000
nn_kernel_gpu,1915,1,1,249844,128,0,0,0,0,1,31980000
nn_kernel_gpu_mem,49612,1,1,249844,128,255840000,127920000,127920000,255840000,1,31980000
nn_kernel_cpu,20330,0,1,1,64,0,0,0,0,1,31990000
nn_kernel_gpu,1911,1,1,249922,128,0,0,0,0,1,31990000
nn_kernel_gpu_mem,40974,1,1,249922,128,255920000,127960000,127960000,255920000,1,31990000
nn_kernel_cpu,28046,0,1,1,64,0,0,0,0,1,32000000
nn_kernel_gpu,1904,1,1,250000,128,0,0,0,0,1,32000000
nn_kernel_gpu_mem,41286,1,1,250000,128,256000000,128000000,128000000,256000000,1,32000000
nn_kernel_cpu,18082,0,1,1,64,0,0,0,0,1,3200000
nn_kernel_gpu,245,1,1,25000,128,0,0,0,0,1,3200000
nn_kernel_gpu_mem,5132,1,1,25000,128,25600000,12800000,12800000,25600000,1,3200000
nn_kernel_cpu,23708,0,1,1,64,0,0,0,0,1,320000
nn_kernel_gpu,77,1,1,2500,128,0,0,0,0,1,320000
nn_kernel_gpu_mem,770,1,1,2500,128,2560000,1280000,1280000,2560000,1,320000
nn_kernel_cpu,22298,0,1,1,64,0,0,0,0,1,32010000
nn_kernel_gpu,1901,1,1,250079,128,0,0,0,0,1,32010000
nn_kernel_gpu_mem,44232,1,1,250079,128,256080000,128040000,128040000,256080000,1,32010000
nn_kernel_cpu,25277,0,1,1,64,0,0,0,0,1,32020000
nn_kernel_gpu,1921,1,1,250157,128,0,0,0,0,1,32020000
nn_kernel_gpu_mem,43281,1,1,250157,128,256160000,128080000,128080000,256160000,1,32020000
nn_kernel_cpu,20427,0,1,1,64,0,0,0,0,1,32030000
nn_kernel_gpu,1891,1,1,250235,128,0,0,0,0,1,32030000
nn_kernel_gpu_mem,48267,1,1,250235,128,256240000,128120000,128120000,256240000,1,32030000
nn_kernel_cpu,22211,0,1,1,64,0,0,0,0,1,32040000
nn_kernel_gpu,1915,1,1,250313,128,0,0,0,0,1,32040000
nn_kernel_gpu_mem,49008,1,1,250313,128,256320000,128160000,128160000,256320000,1,32040000
nn_kernel_cpu,23889,0,1,1,64,0,0,0,0,1,32050000
nn_kernel_gpu,1904,1,1,250391,128,0,0,0,0,1,32050000
nn_kernel_gpu_mem,42427,1,1,250391,128,256400000,128200000,128200000,256400000,1,32050000
nn_kernel_cpu,21080,0,1,1,64,0,0,0,0,1,32060000
nn_kernel_gpu,1892,1,1,250469,128,0,0,0,0,1,32060000
nn_kernel_gpu_mem,41361,1,1,250469,128,256480000,128240000,128240000,256480000,1,32060000
nn_kernel_cpu,23321,0,1,1,64,0,0,0,0,1,32070000
nn_kernel_gpu,1927,1,1,250547,128,0,0,0,0,1,32070000
nn_kernel_gpu_mem,49877,1,1,250547,128,256560000,128280000,128280000,256560000,1,32070000
nn_kernel_cpu,10238,0,1,1,64,0,0,0,0,1,32080000
nn_kernel_gpu,1891,1,1,250625,128,0,0,0,0,1,32080000
nn_kernel_gpu_mem,43816,1,1,250625,128,256640000,128320000,128320000,256640000,1,32080000
nn_kernel_cpu,41328,0,1,1,64,0,0,0,0,1,32090000
nn_kernel_gpu,1920,1,1,250704,128,0,0,0,0,1,32090000
nn_kernel_gpu_mem,49882,1,1,250704,128,256720000,128360000,128360000,256720000,1,32090000
nn_kernel_cpu,37647,0,1,1,64,0,0,0,0,1,32100000
nn_kernel_gpu,1903,1,1,250782,128,0,0,0,0,1,32100000
nn_kernel_gpu_mem,39557,1,1,250782,128,256800000,128400000,128400000,256800000,1,32100000
nn_kernel_cpu,7395,0,1,1,64,0,0,0,0,1,3210000
nn_kernel_gpu,252,1,1,25079,128,0,0,0,0,1,3210000
nn_kernel_gpu_mem,5087,1,1,25079,128,25680000,12840000,12840000,25680000,1,3210000
nn_kernel_cpu,32097,0,1,1,64,0,0,0,0,1,32110000
nn_kernel_gpu,1918,1,1,250860,128,0,0,0,0,1,32110000
nn_kernel_gpu_mem,49538,1,1,250860,128,256880000,128440000,128440000,256880000,1,32110000
nn_kernel_cpu,24138,0,1,1,64,0,0,0,0,1,32120000
nn_kernel_gpu,2105,1,1,250938,128,0,0,0,0,1,32120000
nn_kernel_gpu_mem,49507,1,1,250938,128,256960000,128480000,128480000,256960000,1,32120000
nn_kernel_cpu,18609,0,1,1,64,0,0,0,0,1,32130000
nn_kernel_gpu,1916,1,1,251016,128,0,0,0,0,1,32130000
nn_kernel_gpu_mem,42807,1,1,251016,128,257040000,128520000,128520000,257040000,1,32130000
nn_kernel_cpu,24296,0,1,1,64,0,0,0,0,1,32140000
nn_kernel_gpu,1906,1,1,251094,128,0,0,0,0,1,32140000
nn_kernel_gpu_mem,48417,1,1,251094,128,257120000,128560000,128560000,257120000,1,32140000
nn_kernel_cpu,27358,0,1,1,64,0,0,0,0,1,32150000
nn_kernel_gpu,1916,1,1,251172,128,0,0,0,0,1,32150000
nn_kernel_gpu_mem,49066,1,1,251172,128,257200000,128600000,128600000,257200000,1,32150000
nn_kernel_cpu,17829,0,1,1,64,0,0,0,0,1,32160000
nn_kernel_gpu,1918,1,1,251250,128,0,0,0,0,1,32160000
nn_kernel_gpu_mem,49877,1,1,251250,128,257280000,128640000,128640000,257280000,1,32160000
nn_kernel_cpu,28054,0,1,1,64,0,0,0,0,1,32170000
nn_kernel_gpu,1955,1,1,251329,128,0,0,0,0,1,32170000
nn_kernel_gpu_mem,48870,1,1,251329,128,257360000,128680000,128680000,257360000,1,32170000
nn_kernel_cpu,25232,0,1,1,64,0,0,0,0,1,32180000
nn_kernel_gpu,1900,1,1,251407,128,0,0,0,0,1,32180000
nn_kernel_gpu_mem,41555,1,1,251407,128,257440000,128720000,128720000,257440000,1,32180000
nn_kernel_cpu,21518,0,1,1,64,0,0,0,0,1,32190000
nn_kernel_gpu,1941,1,1,251485,128,0,0,0,0,1,32190000
nn_kernel_gpu_mem,40129,1,1,251485,128,257520000,128760000,128760000,257520000,1,32190000
nn_kernel_cpu,12515,0,1,1,64,0,0,0,0,1,32200000
nn_kernel_gpu,1918,1,1,251563,128,0,0,0,0,1,32200000
nn_kernel_gpu_mem,49049,1,1,251563,128,257600000,128800000,128800000,257600000,1,32200000
nn_kernel_cpu,7464,0,1,1,64,0,0,0,0,1,3220000
nn_kernel_gpu,242,1,1,25157,128,0,0,0,0,1,3220000
nn_kernel_gpu_mem,5219,1,1,25157,128,25760000,12880000,12880000,25760000,1,3220000
nn_kernel_cpu,22730,0,1,1,64,0,0,0,0,1,32210000
nn_kernel_gpu,1923,1,1,251641,128,0,0,0,0,1,32210000
nn_kernel_gpu_mem,49147,1,1,251641,128,257680000,128840000,128840000,257680000,1,32210000
nn_kernel_cpu,12409,0,1,1,64,0,0,0,0,1,32220000
nn_kernel_gpu,1937,1,1,251719,128,0,0,0,0,1,32220000
nn_kernel_gpu_mem,48248,1,1,251719,128,257760000,128880000,128880000,257760000,1,32220000
nn_kernel_cpu,11233,0,1,1,64,0,0,0,0,1,32230000
nn_kernel_gpu,1902,1,1,251797,128,0,0,0,0,1,32230000
nn_kernel_gpu_mem,41864,1,1,251797,128,257840000,128920000,128920000,257840000,1,32230000
nn_kernel_cpu,24575,0,1,1,64,0,0,0,0,1,32240000
nn_kernel_gpu,1913,1,1,251875,128,0,0,0,0,1,32240000
nn_kernel_gpu_mem,42583,1,1,251875,128,257920000,128960000,128960000,257920000,1,32240000
nn_kernel_cpu,14295,0,1,1,64,0,0,0,0,1,32250000
nn_kernel_gpu,1927,1,1,251954,128,0,0,0,0,1,32250000
nn_kernel_gpu_mem,45358,1,1,251954,128,258000000,129000000,129000000,258000000,1,32250000
nn_kernel_cpu,14039,0,1,1,64,0,0,0,0,1,32260000
nn_kernel_gpu,1921,1,1,252032,128,0,0,0,0,1,32260000
nn_kernel_gpu_mem,46765,1,1,252032,128,258080000,129040000,129040000,258080000,1,32260000
nn_kernel_cpu,19441,0,1,1,64,0,0,0,0,1,32270000
nn_kernel_gpu,1916,1,1,252110,128,0,0,0,0,1,32270000
nn_kernel_gpu_mem,50826,1,1,252110,128,258160000,129080000,129080000,258160000,1,32270000
nn_kernel_cpu,18793,0,1,1,64,0,0,0,0,1,32280000
nn_kernel_gpu,1931,1,1,252188,128,0,0,0,0,1,32280000
nn_kernel_gpu_mem,49809,1,1,252188,128,258240000,129120000,129120000,258240000,1,32280000
nn_kernel_cpu,14391,0,1,1,64,0,0,0,0,1,32290000
nn_kernel_gpu,1917,1,1,252266,128,0,0,0,0,1,32290000
nn_kernel_gpu_mem,44341,1,1,252266,128,258320000,129160000,129160000,258320000,1,32290000
nn_kernel_cpu,20642,0,1,1,64,0,0,0,0,1,32300000
nn_kernel_gpu,1934,1,1,252344,128,0,0,0,0,1,32300000
nn_kernel_gpu_mem,55393,1,1,252344,128,258400000,129200000,129200000,258400000,1,32300000
nn_kernel_cpu,14490,0,1,1,64,0,0,0,0,1,3230000
nn_kernel_gpu,247,1,1,25235,128,0,0,0,0,1,3230000
nn_kernel_gpu_mem,5238,1,1,25235,128,25840000,12920000,12920000,25840000,1,3230000
nn_kernel_cpu,26284,0,1,1,64,0,0,0,0,1,32310000
nn_kernel_gpu,1928,1,1,252422,128,0,0,0,0,1,32310000
nn_kernel_gpu_mem,44674,1,1,252422,128,258480000,129240000,129240000,258480000,1,32310000
nn_kernel_cpu,21785,0,1,1,64,0,0,0,0,1,32320000
nn_kernel_gpu,1927,1,1,252500,128,0,0,0,0,1,32320000
nn_kernel_gpu_mem,49901,1,1,252500,128,258560000,129280000,129280000,258560000,1,32320000
nn_kernel_cpu,24952,0,1,1,64,0,0,0,0,1,32330000
nn_kernel_gpu,1913,1,1,252579,128,0,0,0,0,1,32330000
nn_kernel_gpu_mem,49450,1,1,252579,128,258640000,129320000,129320000,258640000,1,32330000
nn_kernel_cpu,16902,0,1,1,64,0,0,0,0,1,32340000
nn_kernel_gpu,1923,1,1,252657,128,0,0,0,0,1,32340000
nn_kernel_gpu_mem,49054,1,1,252657,128,258720000,129360000,129360000,258720000,1,32340000
nn_kernel_cpu,21779,0,1,1,64,0,0,0,0,1,32350000
nn_kernel_gpu,1926,1,1,252735,128,0,0,0,0,1,32350000
nn_kernel_gpu_mem,50152,1,1,252735,128,258800000,129400000,129400000,258800000,1,32350000
nn_kernel_cpu,29356,0,1,1,64,0,0,0,0,1,32360000
nn_kernel_gpu,1928,1,1,252813,128,0,0,0,0,1,32360000
nn_kernel_gpu_mem,50155,1,1,252813,128,258880000,129440000,129440000,258880000,1,32360000
nn_kernel_cpu,25101,0,1,1,64,0,0,0,0,1,32370000
nn_kernel_gpu,1939,1,1,252891,128,0,0,0,0,1,32370000
nn_kernel_gpu_mem,46151,1,1,252891,128,258960000,129480000,129480000,258960000,1,32370000
nn_kernel_cpu,21416,0,1,1,64,0,0,0,0,1,32380000
nn_kernel_gpu,1973,1,1,252969,128,0,0,0,0,1,32380000
nn_kernel_gpu_mem,41705,1,1,252969,128,259040000,129520000,129520000,259040000,1,32380000
nn_kernel_cpu,12584,0,1,1,64,0,0,0,0,1,32390000
nn_kernel_gpu,1906,1,1,253047,128,0,0,0,0,1,32390000
nn_kernel_gpu_mem,41176,1,1,253047,128,259120000,129560000,129560000,259120000,1,32390000
nn_kernel_cpu,24941,0,1,1,64,0,0,0,0,1,32400000
nn_kernel_gpu,1943,1,1,253125,128,0,0,0,0,1,32400000
nn_kernel_gpu_mem,50036,1,1,253125,128,259200000,129600000,129600000,259200000,1,32400000
nn_kernel_cpu,24065,0,1,1,64,0,0,0,0,1,3240000
nn_kernel_gpu,236,1,1,25313,128,0,0,0,0,1,3240000
nn_kernel_gpu_mem,5063,1,1,25313,128,25920000,12960000,12960000,25920000,1,3240000
nn_kernel_cpu,11266,0,1,1,64,0,0,0,0,1,32410000
nn_kernel_gpu,1941,1,1,253204,128,0,0,0,0,1,32410000
nn_kernel_gpu_mem,42484,1,1,253204,128,259280000,129640000,129640000,259280000,1,32410000
nn_kernel_cpu,17531,0,1,1,64,0,0,0,0,1,32420000
nn_kernel_gpu,1938,1,1,253282,128,0,0,0,0,1,32420000
nn_kernel_gpu_mem,47819,1,1,253282,128,259360000,129680000,129680000,259360000,1,32420000
nn_kernel_cpu,22372,0,1,1,64,0,0,0,0,1,32430000
nn_kernel_gpu,1926,1,1,253360,128,0,0,0,0,1,32430000
nn_kernel_gpu_mem,45024,1,1,253360,128,259440000,129720000,129720000,259440000,1,32430000
nn_kernel_cpu,23909,0,1,1,64,0,0,0,0,1,32440000
nn_kernel_gpu,1939,1,1,253438,128,0,0,0,0,1,32440000
nn_kernel_gpu_mem,48814,1,1,253438,128,259520000,129760000,129760000,259520000,1,32440000
nn_kernel_cpu,17705,0,1,1,64,0,0,0,0,1,32450000
nn_kernel_gpu,1926,1,1,253516,128,0,0,0,0,1,32450000
nn_kernel_gpu_mem,50381,1,1,253516,128,259600000,129800000,129800000,259600000,1,32450000
nn_kernel_cpu,29878,0,1,1,64,0,0,0,0,1,32460000
nn_kernel_gpu,1934,1,1,253594,128,0,0,0,0,1,32460000
nn_kernel_gpu_mem,49382,1,1,253594,128,259680000,129840000,129840000,259680000,1,32460000
nn_kernel_cpu,19790,0,1,1,64,0,0,0,0,1,32470000
nn_kernel_gpu,1924,1,1,253672,128,0,0,0,0,1,32470000
nn_kernel_gpu_mem,43707,1,1,253672,128,259760000,129880000,129880000,259760000,1,32470000
nn_kernel_cpu,24084,0,1,1,64,0,0,0,0,1,32480000
nn_kernel_gpu,1950,1,1,253750,128,0,0,0,0,1,32480000
nn_kernel_gpu_mem,45362,1,1,253750,128,259840000,129920000,129920000,259840000,1,32480000
nn_kernel_cpu,13614,0,1,1,64,0,0,0,0,1,32490000
nn_kernel_gpu,1927,1,1,253829,128,0,0,0,0,1,32490000
nn_kernel_gpu_mem,49113,1,1,253829,128,259920000,129960000,129960000,259920000,1,32490000
nn_kernel_cpu,36528,0,1,1,64,0,0,0,0,1,32500000
nn_kernel_gpu,1940,1,1,253907,128,0,0,0,0,1,32500000
nn_kernel_gpu_mem,44083,1,1,253907,128,260000000,130000000,130000000,260000000,1,32500000
nn_kernel_cpu,3731,0,1,1,64,0,0,0,0,1,3250000
nn_kernel_gpu,243,1,1,25391,128,0,0,0,0,1,3250000
nn_kernel_gpu_mem,5034,1,1,25391,128,26000000,13000000,13000000,26000000,1,3250000
nn_kernel_cpu,18448,0,1,1,64,0,0,0,0,1,32510000
nn_kernel_gpu,1935,1,1,253985,128,0,0,0,0,1,32510000
nn_kernel_gpu_mem,38823,1,1,253985,128,260080000,130040000,130040000,260080000,1,32510000
nn_kernel_cpu,17398,0,1,1,64,0,0,0,0,1,32520000
nn_kernel_gpu,1937,1,1,254063,128,0,0,0,0,1,32520000
nn_kernel_gpu_mem,50624,1,1,254063,128,260160000,130080000,130080000,260160000,1,32520000
nn_kernel_cpu,24154,0,1,1,64,0,0,0,0,1,32530000
nn_kernel_gpu,1942,1,1,254141,128,0,0,0,0,1,32530000
nn_kernel_gpu_mem,48640,1,1,254141,128,260240000,130120000,130120000,260240000,1,32530000
nn_kernel_cpu,27051,0,1,1,64,0,0,0,0,1,32540000
nn_kernel_gpu,1918,1,1,254219,128,0,0,0,0,1,32540000
nn_kernel_gpu_mem,47495,1,1,254219,128,260320000,130160000,130160000,260320000,1,32540000
nn_kernel_cpu,16200,0,1,1,64,0,0,0,0,1,32550000
nn_kernel_gpu,1920,1,1,254297,128,0,0,0,0,1,32550000
nn_kernel_gpu_mem,40567,1,1,254297,128,260400000,130200000,130200000,260400000,1,32550000
nn_kernel_cpu,15962,0,1,1,64,0,0,0,0,1,32560000
nn_kernel_gpu,1954,1,1,254375,128,0,0,0,0,1,32560000
nn_kernel_gpu_mem,43062,1,1,254375,128,260480000,130240000,130240000,260480000,1,32560000
nn_kernel_cpu,18778,0,1,1,64,0,0,0,0,1,32570000
nn_kernel_gpu,1947,1,1,254454,128,0,0,0,0,1,32570000
nn_kernel_gpu_mem,51235,1,1,254454,128,260560000,130280000,130280000,260560000,1,32570000
nn_kernel_cpu,13576,0,1,1,64,0,0,0,0,1,32580000
nn_kernel_gpu,1926,1,1,254532,128,0,0,0,0,1,32580000
nn_kernel_gpu_mem,50237,1,1,254532,128,260640000,130320000,130320000,260640000,1,32580000
nn_kernel_cpu,16212,0,1,1,64,0,0,0,0,1,32590000
nn_kernel_gpu,1946,1,1,254610,128,0,0,0,0,1,32590000
nn_kernel_gpu_mem,43264,1,1,254610,128,260720000,130360000,130360000,260720000,1,32590000
nn_kernel_cpu,31330,0,1,1,64,0,0,0,0,1,32600000
nn_kernel_gpu,1922,1,1,254688,128,0,0,0,0,1,32600000
nn_kernel_gpu_mem,40601,1,1,254688,128,260800000,130400000,130400000,260800000,1,32600000
nn_kernel_cpu,46247,0,1,1,64,0,0,0,0,1,3260000
nn_kernel_gpu,238,1,1,25469,128,0,0,0,0,1,3260000
nn_kernel_gpu_mem,5372,1,1,25469,128,26080000,13040000,13040000,26080000,1,3260000
nn_kernel_cpu,21059,0,1,1,64,0,0,0,0,1,32610000
nn_kernel_gpu,1945,1,1,254766,128,0,0,0,0,1,32610000
nn_kernel_gpu_mem,48935,1,1,254766,128,260880000,130440000,130440000,260880000,1,32610000
nn_kernel_cpu,17482,0,1,1,64,0,0,0,0,1,32620000
nn_kernel_gpu,1955,1,1,254844,128,0,0,0,0,1,32620000
nn_kernel_gpu_mem,48664,1,1,254844,128,260960000,130480000,130480000,260960000,1,32620000
nn_kernel_cpu,20101,0,1,1,64,0,0,0,0,1,32630000
nn_kernel_gpu,1927,1,1,254922,128,0,0,0,0,1,32630000
nn_kernel_gpu_mem,48868,1,1,254922,128,261040000,130520000,130520000,261040000,1,32630000
nn_kernel_cpu,18970,0,1,1,64,0,0,0,0,1,32640000
nn_kernel_gpu,1948,1,1,255000,128,0,0,0,0,1,32640000
nn_kernel_gpu_mem,49306,1,1,255000,128,261120000,130560000,130560000,261120000,1,32640000
nn_kernel_cpu,19636,0,1,1,64,0,0,0,0,1,32650000
nn_kernel_gpu,1940,1,1,255079,128,0,0,0,0,1,32650000
nn_kernel_gpu_mem,44921,1,1,255079,128,261200000,130600000,130600000,261200000,1,32650000
nn_kernel_cpu,19998,0,1,1,64,0,0,0,0,1,32660000
nn_kernel_gpu,1962,1,1,255157,128,0,0,0,0,1,32660000
nn_kernel_gpu_mem,48857,1,1,255157,128,261280000,130640000,130640000,261280000,1,32660000
nn_kernel_cpu,14984,0,1,1,64,0,0,0,0,1,32670000
nn_kernel_gpu,1959,1,1,255235,128,0,0,0,0,1,32670000
nn_kernel_gpu_mem,49110,1,1,255235,128,261360000,130680000,130680000,261360000,1,32670000
nn_kernel_cpu,24951,0,1,1,64,0,0,0,0,1,32680000
nn_kernel_gpu,1939,1,1,255313,128,0,0,0,0,1,32680000
nn_kernel_gpu_mem,49900,1,1,255313,128,261440000,130720000,130720000,261440000,1,32680000
nn_kernel_cpu,9487,0,1,1,64,0,0,0,0,1,32690000
nn_kernel_gpu,1964,1,1,255391,128,0,0,0,0,1,32690000
nn_kernel_gpu_mem,49004,1,1,255391,128,261520000,130760000,130760000,261520000,1,32690000
nn_kernel_cpu,17792,0,1,1,64,0,0,0,0,1,32700000
nn_kernel_gpu,1935,1,1,255469,128,0,0,0,0,1,32700000
nn_kernel_gpu_mem,49960,1,1,255469,128,261600000,130800000,130800000,261600000,1,32700000
nn_kernel_cpu,20052,0,1,1,64,0,0,0,0,1,3270000
nn_kernel_gpu,253,1,1,25547,128,0,0,0,0,1,3270000
nn_kernel_gpu_mem,5063,1,1,25547,128,26160000,13080000,13080000,26160000,1,3270000
nn_kernel_cpu,26688,0,1,1,64,0,0,0,0,1,32710000
nn_kernel_gpu,1965,1,1,255547,128,0,0,0,0,1,32710000
nn_kernel_gpu_mem,48997,1,1,255547,128,261680000,130840000,130840000,261680000,1,32710000
nn_kernel_cpu,25262,0,1,1,64,0,0,0,0,1,32720000
nn_kernel_gpu,1955,1,1,255625,128,0,0,0,0,1,32720000
nn_kernel_gpu_mem,46453,1,1,255625,128,261760000,130880000,130880000,261760000,1,32720000
nn_kernel_cpu,20462,0,1,1,64,0,0,0,0,1,32730000
nn_kernel_gpu,1949,1,1,255704,128,0,0,0,0,1,32730000
nn_kernel_gpu_mem,50890,1,1,255704,128,261840000,130920000,130920000,261840000,1,32730000
nn_kernel_cpu,17581,0,1,1,64,0,0,0,0,1,32740000
nn_kernel_gpu,1950,1,1,255782,128,0,0,0,0,1,32740000
nn_kernel_gpu_mem,48572,1,1,255782,128,261920000,130960000,130960000,261920000,1,32740000
nn_kernel_cpu,25756,0,1,1,64,0,0,0,0,1,32750000
nn_kernel_gpu,1935,1,1,255860,128,0,0,0,0,1,32750000
nn_kernel_gpu_mem,50051,1,1,255860,128,262000000,131000000,131000000,262000000,1,32750000
nn_kernel_cpu,19412,0,1,1,64,0,0,0,0,1,32760000
nn_kernel_gpu,1959,1,1,255938,128,0,0,0,0,1,32760000
nn_kernel_gpu_mem,40398,1,1,255938,128,262080000,131040000,131040000,262080000,1,32760000
nn_kernel_cpu,25519,0,1,1,64,0,0,0,0,1,32770000
nn_kernel_gpu,1929,1,1,256016,128,0,0,0,0,1,32770000
nn_kernel_gpu_mem,44136,1,1,256016,128,262160000,131080000,131080000,262160000,1,32770000
nn_kernel_cpu,19579,0,1,1,64,0,0,0,0,1,32780000
nn_kernel_gpu,1935,1,1,256094,128,0,0,0,0,1,32780000
nn_kernel_gpu_mem,50163,1,1,256094,128,262240000,131120000,131120000,262240000,1,32780000
nn_kernel_cpu,22159,0,1,1,64,0,0,0,0,1,32790000
nn_kernel_gpu,1962,1,1,256172,128,0,0,0,0,1,32790000
nn_kernel_gpu_mem,43174,1,1,256172,128,262320000,131160000,131160000,262320000,1,32790000
nn_kernel_cpu,9691,0,1,1,64,0,0,0,0,1,32800000
nn_kernel_gpu,1943,1,1,256250,128,0,0,0,0,1,32800000
nn_kernel_gpu_mem,44121,1,1,256250,128,262400000,131200000,131200000,262400000,1,32800000
nn_kernel_cpu,13783,0,1,1,64,0,0,0,0,1,3280000
nn_kernel_gpu,242,1,1,25625,128,0,0,0,0,1,3280000
nn_kernel_gpu_mem,4854,1,1,25625,128,26240000,13120000,13120000,26240000,1,3280000
nn_kernel_cpu,32988,0,1,1,64,0,0,0,0,1,32810000
nn_kernel_gpu,1949,1,1,256329,128,0,0,0,0,1,32810000
nn_kernel_gpu_mem,50525,1,1,256329,128,262480000,131240000,131240000,262480000,1,32810000
nn_kernel_cpu,16332,0,1,1,64,0,0,0,0,1,32820000
nn_kernel_gpu,1934,1,1,256407,128,0,0,0,0,1,32820000
nn_kernel_gpu_mem,45085,1,1,256407,128,262560000,131280000,131280000,262560000,1,32820000
nn_kernel_cpu,19983,0,1,1,64,0,0,0,0,1,32830000
nn_kernel_gpu,1963,1,1,256485,128,0,0,0,0,1,32830000
nn_kernel_gpu_mem,50016,1,1,256485,128,262640000,131320000,131320000,262640000,1,32830000
nn_kernel_cpu,22082,0,1,1,64,0,0,0,0,1,32840000
nn_kernel_gpu,1963,1,1,256563,128,0,0,0,0,1,32840000
nn_kernel_gpu_mem,42810,1,1,256563,128,262720000,131360000,131360000,262720000,1,32840000
nn_kernel_cpu,18495,0,1,1,64,0,0,0,0,1,32850000
nn_kernel_gpu,1966,1,1,256641,128,0,0,0,0,1,32850000
nn_kernel_gpu_mem,49569,1,1,256641,128,262800000,131400000,131400000,262800000,1,32850000
nn_kernel_cpu,18581,0,1,1,64,0,0,0,0,1,32860000
nn_kernel_gpu,1955,1,1,256719,128,0,0,0,0,1,32860000
nn_kernel_gpu_mem,51108,1,1,256719,128,262880000,131440000,131440000,262880000,1,32860000
nn_kernel_cpu,18443,0,1,1,64,0,0,0,0,1,32870000
nn_kernel_gpu,1974,1,1,256797,128,0,0,0,0,1,32870000
nn_kernel_gpu_mem,49843,1,1,256797,128,262960000,131480000,131480000,262960000,1,32870000
nn_kernel_cpu,12537,0,1,1,64,0,0,0,0,1,32880000
nn_kernel_gpu,1954,1,1,256875,128,0,0,0,0,1,32880000
nn_kernel_gpu_mem,42453,1,1,256875,128,263040000,131520000,131520000,263040000,1,32880000
nn_kernel_cpu,23320,0,1,1,64,0,0,0,0,1,32890000
nn_kernel_gpu,1962,1,1,256954,128,0,0,0,0,1,32890000
nn_kernel_gpu_mem,41977,1,1,256954,128,263120000,131560000,131560000,263120000,1,32890000
nn_kernel_cpu,26424,0,1,1,64,0,0,0,0,1,32900000
nn_kernel_gpu,1968,1,1,257032,128,0,0,0,0,1,32900000
nn_kernel_gpu_mem,43296,1,1,257032,128,263200000,131600000,131600000,263200000,1,32900000
nn_kernel_cpu,21713,0,1,1,64,0,0,0,0,1,3290000
nn_kernel_gpu,250,1,1,25704,128,0,0,0,0,1,3290000
nn_kernel_gpu_mem,5004,1,1,25704,128,26320000,13160000,13160000,26320000,1,3290000
nn_kernel_cpu,12076,0,1,1,64,0,0,0,0,1,32910000
nn_kernel_gpu,1956,1,1,257110,128,0,0,0,0,1,32910000
nn_kernel_gpu_mem,47511,1,1,257110,128,263280000,131640000,131640000,263280000,1,32910000
nn_kernel_cpu,12969,0,1,1,64,0,0,0,0,1,32920000
nn_kernel_gpu,1968,1,1,257188,128,0,0,0,0,1,32920000
nn_kernel_gpu_mem,45595,1,1,257188,128,263360000,131680000,131680000,263360000,1,32920000
nn_kernel_cpu,19870,0,1,1,64,0,0,0,0,1,32930000
nn_kernel_gpu,1948,1,1,257266,128,0,0,0,0,1,32930000
nn_kernel_gpu_mem,48699,1,1,257266,128,263440000,131720000,131720000,263440000,1,32930000
nn_kernel_cpu,11320,0,1,1,64,0,0,0,0,1,32940000
nn_kernel_gpu,1961,1,1,257344,128,0,0,0,0,1,32940000
nn_kernel_gpu_mem,45075,1,1,257344,128,263520000,131760000,131760000,263520000,1,32940000
nn_kernel_cpu,29591,0,1,1,64,0,0,0,0,1,32950000
nn_kernel_gpu,1952,1,1,257422,128,0,0,0,0,1,32950000
nn_kernel_gpu_mem,47815,1,1,257422,128,263600000,131800000,131800000,263600000,1,32950000
nn_kernel_cpu,21579,0,1,1,64,0,0,0,0,1,32960000
nn_kernel_gpu,1957,1,1,257500,128,0,0,0,0,1,32960000
nn_kernel_gpu_mem,49398,1,1,257500,128,263680000,131840000,131840000,263680000,1,32960000
nn_kernel_cpu,11522,0,1,1,64,0,0,0,0,1,32970000
nn_kernel_gpu,1972,1,1,257579,128,0,0,0,0,1,32970000
nn_kernel_gpu_mem,50559,1,1,257579,128,263760000,131880000,131880000,263760000,1,32970000
nn_kernel_cpu,16325,0,1,1,64,0,0,0,0,1,32980000
nn_kernel_gpu,1960,1,1,257657,128,0,0,0,0,1,32980000
nn_kernel_gpu_mem,48956,1,1,257657,128,263840000,131920000,131920000,263840000,1,32980000
nn_kernel_cpu,16849,0,1,1,64,0,0,0,0,1,32990000
nn_kernel_gpu,1946,1,1,257735,128,0,0,0,0,1,32990000
nn_kernel_gpu_mem,42573,1,1,257735,128,263920000,131960000,131960000,263920000,1,32990000
nn_kernel_cpu,23789,0,1,1,64,0,0,0,0,1,33000000
nn_kernel_gpu,1963,1,1,257813,128,0,0,0,0,1,33000000
nn_kernel_gpu_mem,48738,1,1,257813,128,264000000,132000000,132000000,264000000,1,33000000
nn_kernel_cpu,5584,0,1,1,64,0,0,0,0,1,3300000
nn_kernel_gpu,242,1,1,25782,128,0,0,0,0,1,3300000
nn_kernel_gpu_mem,4941,1,1,25782,128,26400000,13200000,13200000,26400000,1,3300000
nn_kernel_cpu,1315,0,1,1,64,0,0,0,0,1,330000
nn_kernel_gpu,57,1,1,2579,128,0,0,0,0,1,330000
nn_kernel_gpu_mem,1179,1,1,2579,128,2640000,1320000,1320000,2640000,1,330000
nn_kernel_cpu,22961,0,1,1,64,0,0,0,0,1,33010000
nn_kernel_gpu,1978,1,1,257891,128,0,0,0,0,1,33010000
nn_kernel_gpu_mem,49859,1,1,257891,128,264080000,132040000,132040000,264080000,1,33010000
nn_kernel_cpu,32162,0,1,1,64,0,0,0,0,1,33020000
nn_kernel_gpu,1982,1,1,257969,128,0,0,0,0,1,33020000
nn_kernel_gpu_mem,49757,1,1,257969,128,264160000,132080000,132080000,264160000,1,33020000
nn_kernel_cpu,18134,0,1,1,64,0,0,0,0,1,33030000
nn_kernel_gpu,1973,1,1,258047,128,0,0,0,0,1,33030000
nn_kernel_gpu_mem,48600,1,1,258047,128,264240000,132120000,132120000,264240000,1,33030000
nn_kernel_cpu,16699,0,1,1,64,0,0,0,0,1,33040000
nn_kernel_gpu,1957,1,1,258125,128,0,0,0,0,1,33040000
nn_kernel_gpu_mem,41698,1,1,258125,128,264320000,132160000,132160000,264320000,1,33040000
nn_kernel_cpu,34509,0,1,1,64,0,0,0,0,1,33050000
nn_kernel_gpu,1964,1,1,258204,128,0,0,0,0,1,33050000
nn_kernel_gpu_mem,41745,1,1,258204,128,264400000,132200000,132200000,264400000,1,33050000
nn_kernel_cpu,25780,0,1,1,64,0,0,0,0,1,33060000
nn_kernel_gpu,1964,1,1,258282,128,0,0,0,0,1,33060000
nn_kernel_gpu_mem,43653,1,1,258282,128,264480000,132240000,132240000,264480000,1,33060000
nn_kernel_cpu,28294,0,1,1,64,0,0,0,0,1,33070000
nn_kernel_gpu,1958,1,1,258360,128,0,0,0,0,1,33070000
nn_kernel_gpu_mem,53538,1,1,258360,128,264560000,132280000,132280000,264560000,1,33070000
nn_kernel_cpu,23755,0,1,1,64,0,0,0,0,1,33080000
nn_kernel_gpu,1964,1,1,258438,128,0,0,0,0,1,33080000
nn_kernel_gpu_mem,43642,1,1,258438,128,264640000,132320000,132320000,264640000,1,33080000
nn_kernel_cpu,6799,0,1,1,64,0,0,0,0,1,33090000
nn_kernel_gpu,1972,1,1,258516,128,0,0,0,0,1,33090000
nn_kernel_gpu_mem,43752,1,1,258516,128,264720000,132360000,132360000,264720000,1,33090000
nn_kernel_cpu,23327,0,1,1,64,0,0,0,0,1,33100000
nn_kernel_gpu,1954,1,1,258594,128,0,0,0,0,1,33100000
nn_kernel_gpu_mem,41005,1,1,258594,128,264800000,132400000,132400000,264800000,1,33100000
nn_kernel_cpu,5864,0,1,1,64,0,0,0,0,1,3310000
nn_kernel_gpu,255,1,1,25860,128,0,0,0,0,1,3310000
nn_kernel_gpu_mem,5120,1,1,25860,128,26480000,13240000,13240000,26480000,1,3310000
nn_kernel_cpu,19331,0,1,1,64,0,0,0,0,1,33110000
nn_kernel_gpu,1963,1,1,258672,128,0,0,0,0,1,33110000
nn_kernel_gpu_mem,48932,1,1,258672,128,264880000,132440000,132440000,264880000,1,33110000
nn_kernel_cpu,23696,0,1,1,64,0,0,0,0,1,33120000
nn_kernel_gpu,1960,1,1,258750,128,0,0,0,0,1,33120000
nn_kernel_gpu_mem,47960,1,1,258750,128,264960000,132480000,132480000,264960000,1,33120000
nn_kernel_cpu,27972,0,1,1,64,0,0,0,0,1,33130000
nn_kernel_gpu,1960,1,1,258829,128,0,0,0,0,1,33130000
nn_kernel_gpu_mem,43261,1,1,258829,128,265040000,132520000,132520000,265040000,1,33130000
nn_kernel_cpu,17957,0,1,1,64,0,0,0,0,1,33140000
nn_kernel_gpu,1997,1,1,258907,128,0,0,0,0,1,33140000
nn_kernel_gpu_mem,50082,1,1,258907,128,265120000,132560000,132560000,265120000,1,33140000
nn_kernel_cpu,18231,0,1,1,64,0,0,0,0,1,33150000
nn_kernel_gpu,1954,1,1,258985,128,0,0,0,0,1,33150000
nn_kernel_gpu_mem,43512,1,1,258985,128,265200000,132600000,132600000,265200000,1,33150000
nn_kernel_cpu,13332,0,1,1,64,0,0,0,0,1,33160000
nn_kernel_gpu,1969,1,1,259063,128,0,0,0,0,1,33160000
nn_kernel_gpu_mem,50603,1,1,259063,128,265280000,132640000,132640000,265280000,1,33160000
nn_kernel_cpu,11818,0,1,1,64,0,0,0,0,1,33170000
nn_kernel_gpu,1978,1,1,259141,128,0,0,0,0,1,33170000
nn_kernel_gpu_mem,49262,1,1,259141,128,265360000,132680000,132680000,265360000,1,33170000
nn_kernel_cpu,21747,0,1,1,64,0,0,0,0,1,33180000
nn_kernel_gpu,1989,1,1,259219,128,0,0,0,0,1,33180000
nn_kernel_gpu_mem,43524,1,1,259219,128,265440000,132720000,132720000,265440000,1,33180000
nn_kernel_cpu,14531,0,1,1,64,0,0,0,0,1,33190000
nn_kernel_gpu,1978,1,1,259297,128,0,0,0,0,1,33190000
nn_kernel_gpu_mem,49838,1,1,259297,128,265520000,132760000,132760000,265520000,1,33190000
nn_kernel_cpu,25342,0,1,1,64,0,0,0,0,1,33200000
nn_kernel_gpu,1992,1,1,259375,128,0,0,0,0,1,33200000
nn_kernel_gpu_mem,43367,1,1,259375,128,265600000,132800000,132800000,265600000,1,33200000
nn_kernel_cpu,10636,0,1,1,64,0,0,0,0,1,3320000
nn_kernel_gpu,246,1,1,25938,128,0,0,0,0,1,3320000
nn_kernel_gpu_mem,7835,1,1,25938,128,26560000,13280000,13280000,26560000,1,3320000
nn_kernel_cpu,11339,0,1,1,64,0,0,0,0,1,33210000
nn_kernel_gpu,1980,1,1,259454,128,0,0,0,0,1,33210000
nn_kernel_gpu_mem,49547,1,1,259454,128,265680000,132840000,132840000,265680000,1,33210000
nn_kernel_cpu,28371,0,1,1,64,0,0,0,0,1,33220000
nn_kernel_gpu,1991,1,1,259532,128,0,0,0,0,1,33220000
nn_kernel_gpu_mem,50320,1,1,259532,128,265760000,132880000,132880000,265760000,1,33220000
nn_kernel_cpu,27253,0,1,1,64,0,0,0,0,1,33230000
nn_kernel_gpu,1983,1,1,259610,128,0,0,0,0,1,33230000
nn_kernel_gpu_mem,42223,1,1,259610,128,265840000,132920000,132920000,265840000,1,33230000
nn_kernel_cpu,14358,0,1,1,64,0,0,0,0,1,33240000
nn_kernel_gpu,1984,1,1,259688,128,0,0,0,0,1,33240000
nn_kernel_gpu_mem,44133,1,1,259688,128,265920000,132960000,132960000,265920000,1,33240000
nn_kernel_cpu,15716,0,1,1,64,0,0,0,0,1,33250000
nn_kernel_gpu,2018,1,1,259766,128,0,0,0,0,1,33250000
nn_kernel_gpu_mem,50827,1,1,259766,128,266000000,133000000,133000000,266000000,1,33250000
nn_kernel_cpu,30971,0,1,1,64,0,0,0,0,1,33260000
nn_kernel_gpu,2032,1,1,259844,128,0,0,0,0,1,33260000
nn_kernel_gpu_mem,42212,1,1,259844,128,266080000,133040000,133040000,266080000,1,33260000
nn_kernel_cpu,27362,0,1,1,64,0,0,0,0,1,33270000
nn_kernel_gpu,1982,1,1,259922,128,0,0,0,0,1,33270000
nn_kernel_gpu_mem,43636,1,1,259922,128,266160000,133080000,133080000,266160000,1,33270000
nn_kernel_cpu,15628,0,1,1,64,0,0,0,0,1,33280000
nn_kernel_gpu,1973,1,1,260000,128,0,0,0,0,1,33280000
nn_kernel_gpu_mem,53665,1,1,260000,128,266240000,133120000,133120000,266240000,1,33280000
nn_kernel_cpu,22538,0,1,1,64,0,0,0,0,1,33290000
nn_kernel_gpu,1970,1,1,260079,128,0,0,0,0,1,33290000
nn_kernel_gpu_mem,47485,1,1,260079,128,266320000,133160000,133160000,266320000,1,33290000
nn_kernel_cpu,27380,0,1,1,64,0,0,0,0,1,33300000
nn_kernel_gpu,1978,1,1,260157,128,0,0,0,0,1,33300000
nn_kernel_gpu_mem,42504,1,1,260157,128,266400000,133200000,133200000,266400000,1,33300000
nn_kernel_cpu,4743,0,1,1,64,0,0,0,0,1,3330000
nn_kernel_gpu,259,1,1,26016,128,0,0,0,0,1,3330000
nn_kernel_gpu_mem,4903,1,1,26016,128,26640000,13320000,13320000,26640000,1,3330000
nn_kernel_cpu,26318,0,1,1,64,0,0,0,0,1,33310000
nn_kernel_gpu,1985,1,1,260235,128,0,0,0,0,1,33310000
nn_kernel_gpu_mem,53080,1,1,260235,128,266480000,133240000,133240000,266480000,1,33310000
nn_kernel_cpu,24870,0,1,1,64,0,0,0,0,1,33320000
nn_kernel_gpu,1993,1,1,260313,128,0,0,0,0,1,33320000
nn_kernel_gpu_mem,50026,1,1,260313,128,266560000,133280000,133280000,266560000,1,33320000
nn_kernel_cpu,16819,0,1,1,64,0,0,0,0,1,33330000
nn_kernel_gpu,1993,1,1,260391,128,0,0,0,0,1,33330000
nn_kernel_gpu_mem,42635,1,1,260391,128,266640000,133320000,133320000,266640000,1,33330000
nn_kernel_cpu,26685,0,1,1,64,0,0,0,0,1,33340000
nn_kernel_gpu,1993,1,1,260469,128,0,0,0,0,1,33340000
nn_kernel_gpu_mem,43213,1,1,260469,128,266720000,133360000,133360000,266720000,1,33340000
nn_kernel_cpu,20690,0,1,1,64,0,0,0,0,1,33350000
nn_kernel_gpu,1989,1,1,260547,128,0,0,0,0,1,33350000
nn_kernel_gpu_mem,43371,1,1,260547,128,266800000,133400000,133400000,266800000,1,33350000
nn_kernel_cpu,20545,0,1,1,64,0,0,0,0,1,33360000
nn_kernel_gpu,2006,1,1,260625,128,0,0,0,0,1,33360000
nn_kernel_gpu_mem,43322,1,1,260625,128,266880000,133440000,133440000,266880000,1,33360000
nn_kernel_cpu,27387,0,1,1,64,0,0,0,0,1,33370000
nn_kernel_gpu,1982,1,1,260704,128,0,0,0,0,1,33370000
nn_kernel_gpu_mem,53242,1,1,260704,128,266960000,133480000,133480000,266960000,1,33370000
nn_kernel_cpu,18045,0,1,1,64,0,0,0,0,1,33380000
nn_kernel_gpu,1980,1,1,260782,128,0,0,0,0,1,33380000
nn_kernel_gpu_mem,52939,1,1,260782,128,267040000,133520000,133520000,267040000,1,33380000
nn_kernel_cpu,22638,0,1,1,64,0,0,0,0,1,33390000
nn_kernel_gpu,2018,1,1,260860,128,0,0,0,0,1,33390000
nn_kernel_gpu_mem,42503,1,1,260860,128,267120000,133560000,133560000,267120000,1,33390000
nn_kernel_cpu,32404,0,1,1,64,0,0,0,0,1,33400000
nn_kernel_gpu,1990,1,1,260938,128,0,0,0,0,1,33400000
nn_kernel_gpu_mem,49059,1,1,260938,128,267200000,133600000,133600000,267200000,1,33400000
nn_kernel_cpu,4332,0,1,1,64,0,0,0,0,1,3340000
nn_kernel_gpu,240,1,1,26094,128,0,0,0,0,1,3340000
nn_kernel_gpu_mem,8277,1,1,26094,128,26720000,13360000,13360000,26720000,1,3340000
nn_kernel_cpu,16758,0,1,1,64,0,0,0,0,1,33410000
nn_kernel_gpu,1988,1,1,261016,128,0,0,0,0,1,33410000
nn_kernel_gpu_mem,44830,1,1,261016,128,267280000,133640000,133640000,267280000,1,33410000
nn_kernel_cpu,10871,0,1,1,64,0,0,0,0,1,33420000
nn_kernel_gpu,1988,1,1,261094,128,0,0,0,0,1,33420000
nn_kernel_gpu_mem,49857,1,1,261094,128,267360000,133680000,133680000,267360000,1,33420000
nn_kernel_cpu,8874,0,1,1,64,0,0,0,0,1,33430000
nn_kernel_gpu,2005,1,1,261172,128,0,0,0,0,1,33430000
nn_kernel_gpu_mem,50794,1,1,261172,128,267440000,133720000,133720000,267440000,1,33430000
nn_kernel_cpu,21110,0,1,1,64,0,0,0,0,1,33440000
nn_kernel_gpu,1995,1,1,261250,128,0,0,0,0,1,33440000
nn_kernel_gpu_mem,43788,1,1,261250,128,267520000,133760000,133760000,267520000,1,33440000
nn_kernel_cpu,25250,0,1,1,64,0,0,0,0,1,33450000
nn_kernel_gpu,1998,1,1,261329,128,0,0,0,0,1,33450000
nn_kernel_gpu_mem,66859,1,1,261329,128,267600000,133800000,133800000,267600000,1,33450000
nn_kernel_cpu,18583,0,1,1,64,0,0,0,0,1,33460000
nn_kernel_gpu,1986,1,1,261407,128,0,0,0,0,1,33460000
nn_kernel_gpu_mem,50563,1,1,261407,128,267680000,133840000,133840000,267680000,1,33460000
nn_kernel_cpu,32792,0,1,1,64,0,0,0,0,1,33470000
nn_kernel_gpu,1986,1,1,261485,128,0,0,0,0,1,33470000
nn_kernel_gpu_mem,45738,1,1,261485,128,267760000,133880000,133880000,267760000,1,33470000
nn_kernel_cpu,27681,0,1,1,64,0,0,0,0,1,33480000
nn_kernel_gpu,2008,1,1,261563,128,0,0,0,0,1,33480000
nn_kernel_gpu_mem,50462,1,1,261563,128,267840000,133920000,133920000,267840000,1,33480000
nn_kernel_cpu,28170,0,1,1,64,0,0,0,0,1,33490000
nn_kernel_gpu,2003,1,1,261641,128,0,0,0,0,1,33490000
nn_kernel_gpu_mem,51120,1,1,261641,128,267920000,133960000,133960000,267920000,1,33490000
nn_kernel_cpu,13913,0,1,1,64,0,0,0,0,1,33500000
nn_kernel_gpu,2004,1,1,261719,128,0,0,0,0,1,33500000
nn_kernel_gpu_mem,51266,1,1,261719,128,268000000,134000000,134000000,268000000,1,33500000
nn_kernel_cpu,16116,0,1,1,64,0,0,0,0,1,3350000
nn_kernel_gpu,247,1,1,26172,128,0,0,0,0,1,3350000
nn_kernel_gpu_mem,5079,1,1,26172,128,26800000,13400000,13400000,26800000,1,3350000
nn_kernel_cpu,18460,0,1,1,64,0,0,0,0,1,33510000
nn_kernel_gpu,1999,1,1,261797,128,0,0,0,0,1,33510000
nn_kernel_gpu_mem,48878,1,1,261797,128,268080000,134040000,134040000,268080000,1,33510000
nn_kernel_cpu,25390,0,1,1,64,0,0,0,0,1,33520000
nn_kernel_gpu,1989,1,1,261875,128,0,0,0,0,1,33520000
nn_kernel_gpu_mem,43735,1,1,261875,128,268160000,134080000,134080000,268160000,1,33520000
nn_kernel_cpu,28872,0,1,1,64,0,0,0,0,1,33530000
nn_kernel_gpu,1977,1,1,261954,128,0,0,0,0,1,33530000
nn_kernel_gpu_mem,42680,1,1,261954,128,268240000,134120000,134120000,268240000,1,33530000
nn_kernel_cpu,20572,0,1,1,64,0,0,0,0,1,33540000
nn_kernel_gpu,2012,1,1,262032,128,0,0,0,0,1,33540000
nn_kernel_gpu_mem,50093,1,1,262032,128,268320000,134160000,134160000,268320000,1,33540000
nn_kernel_cpu,28809,0,1,1,64,0,0,0,0,1,33550000
nn_kernel_gpu,1991,1,1,262110,128,0,0,0,0,1,33550000
nn_kernel_gpu_mem,44329,1,1,262110,128,268400000,134200000,134200000,268400000,1,33550000
nn_kernel_cpu,28343,0,1,1,64,0,0,0,0,1,33560000
nn_kernel_gpu,2134,1,1,262188,128,0,0,0,0,1,33560000
nn_kernel_gpu_mem,41918,1,1,262188,128,268480000,134240000,134240000,268480000,1,33560000
nn_kernel_cpu,23466,0,1,1,64,0,0,0,0,1,33570000
nn_kernel_gpu,2004,1,1,262266,128,0,0,0,0,1,33570000
nn_kernel_gpu_mem,53749,1,1,262266,128,268560000,134280000,134280000,268560000,1,33570000
nn_kernel_cpu,10212,0,1,1,64,0,0,0,0,1,33580000
nn_kernel_gpu,2013,1,1,262344,128,0,0,0,0,1,33580000
nn_kernel_gpu_mem,50884,1,1,262344,128,268640000,134320000,134320000,268640000,1,33580000
nn_kernel_cpu,16679,0,1,1,64,0,0,0,0,1,33590000
nn_kernel_gpu,1989,1,1,262422,128,0,0,0,0,1,33590000
nn_kernel_gpu_mem,50403,1,1,262422,128,268720000,134360000,134360000,268720000,1,33590000
nn_kernel_cpu,26778,0,1,1,64,0,0,0,0,1,33600000
nn_kernel_gpu,2009,1,1,262500,128,0,0,0,0,1,33600000
nn_kernel_gpu_mem,44218,1,1,262500,128,268800000,134400000,134400000,268800000,1,33600000
nn_kernel_cpu,28552,0,1,1,64,0,0,0,0,1,3360000
nn_kernel_gpu,248,1,1,26250,128,0,0,0,0,1,3360000
nn_kernel_gpu_mem,5382,1,1,26250,128,26880000,13440000,13440000,26880000,1,3360000
nn_kernel_cpu,13481,0,1,1,64,0,0,0,0,1,33610000
nn_kernel_gpu,1984,1,1,262579,128,0,0,0,0,1,33610000
nn_kernel_gpu_mem,41781,1,1,262579,128,268880000,134440000,134440000,268880000,1,33610000
nn_kernel_cpu,28002,0,1,1,64,0,0,0,0,1,33620000
nn_kernel_gpu,1991,1,1,262657,128,0,0,0,0,1,33620000
nn_kernel_gpu_mem,41873,1,1,262657,128,268960000,134480000,134480000,268960000,1,33620000
nn_kernel_cpu,20479,0,1,1,64,0,0,0,0,1,33630000
nn_kernel_gpu,2020,1,1,262735,128,0,0,0,0,1,33630000
nn_kernel_gpu_mem,51568,1,1,262735,128,269040000,134520000,134520000,269040000,1,33630000
nn_kernel_cpu,28026,0,1,1,64,0,0,0,0,1,33640000
nn_kernel_gpu,2005,1,1,262813,128,0,0,0,0,1,33640000
nn_kernel_gpu_mem,49451,1,1,262813,128,269120000,134560000,134560000,269120000,1,33640000
nn_kernel_cpu,24496,0,1,1,64,0,0,0,0,1,33650000
nn_kernel_gpu,1984,1,1,262891,128,0,0,0,0,1,33650000
nn_kernel_gpu_mem,49152,1,1,262891,128,269200000,134600000,134600000,269200000,1,33650000
nn_kernel_cpu,18863,0,1,1,64,0,0,0,0,1,33660000
nn_kernel_gpu,2008,1,1,262969,128,0,0,0,0,1,33660000
nn_kernel_gpu_mem,52989,1,1,262969,128,269280000,134640000,134640000,269280000,1,33660000
nn_kernel_cpu,43865,0,1,1,64,0,0,0,0,1,33670000
nn_kernel_gpu,2009,1,1,263047,128,0,0,0,0,1,33670000
nn_kernel_gpu_mem,41135,1,1,263047,128,269360000,134680000,134680000,269360000,1,33670000
nn_kernel_cpu,28305,0,1,1,64,0,0,0,0,1,33680000
nn_kernel_gpu,2024,1,1,263125,128,0,0,0,0,1,33680000
nn_kernel_gpu_mem,50801,1,1,263125,128,269440000,134720000,134720000,269440000,1,33680000
nn_kernel_cpu,22124,0,1,1,64,0,0,0,0,1,33690000
nn_kernel_gpu,2024,1,1,263204,128,0,0,0,0,1,33690000
nn_kernel_gpu_mem,44415,1,1,263204,128,269520000,134760000,134760000,269520000,1,33690000
nn_kernel_cpu,35036,0,1,1,64,0,0,0,0,1,33700000
nn_kernel_gpu,1995,1,1,263282,128,0,0,0,0,1,33700000
nn_kernel_gpu_mem,44801,1,1,263282,128,269600000,134800000,134800000,269600000,1,33700000
nn_kernel_cpu,36701,0,1,1,64,0,0,0,0,1,3370000
nn_kernel_gpu,249,1,1,26329,128,0,0,0,0,1,3370000
nn_kernel_gpu_mem,5865,1,1,26329,128,26960000,13480000,13480000,26960000,1,3370000
nn_kernel_cpu,24705,0,1,1,64,0,0,0,0,1,33710000
nn_kernel_gpu,2026,1,1,263360,128,0,0,0,0,1,33710000
nn_kernel_gpu_mem,52176,1,1,263360,128,269680000,134840000,134840000,269680000,1,33710000
nn_kernel_cpu,21476,0,1,1,64,0,0,0,0,1,33720000
nn_kernel_gpu,2015,1,1,263438,128,0,0,0,0,1,33720000
nn_kernel_gpu_mem,41068,1,1,263438,128,269760000,134880000,134880000,269760000,1,33720000
nn_kernel_cpu,35263,0,1,1,64,0,0,0,0,1,33730000
nn_kernel_gpu,1996,1,1,263516,128,0,0,0,0,1,33730000
nn_kernel_gpu_mem,43144,1,1,263516,128,269840000,134920000,134920000,269840000,1,33730000
nn_kernel_cpu,19320,0,1,1,64,0,0,0,0,1,33740000
nn_kernel_gpu,2013,1,1,263594,128,0,0,0,0,1,33740000
nn_kernel_gpu_mem,44737,1,1,263594,128,269920000,134960000,134960000,269920000,1,33740000
nn_kernel_cpu,16670,0,1,1,64,0,0,0,0,1,33750000
nn_kernel_gpu,2002,1,1,263672,128,0,0,0,0,1,33750000
nn_kernel_gpu_mem,53051,1,1,263672,128,270000000,135000000,135000000,270000000,1,33750000
nn_kernel_cpu,6927,0,1,1,64,0,0,0,0,1,33760000
nn_kernel_gpu,2004,1,1,263750,128,0,0,0,0,1,33760000
nn_kernel_gpu_mem,42769,1,1,263750,128,270080000,135040000,135040000,270080000,1,33760000
nn_kernel_cpu,34745,0,1,1,64,0,0,0,0,1,33770000
nn_kernel_gpu,2002,1,1,263829,128,0,0,0,0,1,33770000
nn_kernel_gpu_mem,39947,1,1,263829,128,270160000,135080000,135080000,270160000,1,33770000
nn_kernel_cpu,18033,0,1,1,64,0,0,0,0,1,33780000
nn_kernel_gpu,2000,1,1,263907,128,0,0,0,0,1,33780000
nn_kernel_gpu_mem,46519,1,1,263907,128,270240000,135120000,135120000,270240000,1,33780000
nn_kernel_cpu,12817,0,1,1,64,0,0,0,0,1,33790000
nn_kernel_gpu,2010,1,1,263985,128,0,0,0,0,1,33790000
nn_kernel_gpu_mem,51628,1,1,263985,128,270320000,135160000,135160000,270320000,1,33790000
nn_kernel_cpu,31881,0,1,1,64,0,0,0,0,1,33800000
nn_kernel_gpu,2023,1,1,264063,128,0,0,0,0,1,33800000
nn_kernel_gpu_mem,50924,1,1,264063,128,270400000,135200000,135200000,270400000,1,33800000
nn_kernel_cpu,15719,0,1,1,64,0,0,0,0,1,3380000
nn_kernel_gpu,247,1,1,26407,128,0,0,0,0,1,3380000
nn_kernel_gpu_mem,5166,1,1,26407,128,27040000,13520000,13520000,27040000,1,3380000
nn_kernel_cpu,13192,0,1,1,64,0,0,0,0,1,33810000
nn_kernel_gpu,2024,1,1,264141,128,0,0,0,0,1,33810000
nn_kernel_gpu_mem,43138,1,1,264141,128,270480000,135240000,135240000,270480000,1,33810000
nn_kernel_cpu,27482,0,1,1,64,0,0,0,0,1,33820000
nn_kernel_gpu,2032,1,1,264219,128,0,0,0,0,1,33820000
nn_kernel_gpu_mem,52404,1,1,264219,128,270560000,135280000,135280000,270560000,1,33820000
nn_kernel_cpu,22401,0,1,1,64,0,0,0,0,1,33830000
nn_kernel_gpu,2002,1,1,264297,128,0,0,0,0,1,33830000
nn_kernel_gpu_mem,54401,1,1,264297,128,270640000,135320000,135320000,270640000,1,33830000
nn_kernel_cpu,20614,0,1,1,64,0,0,0,0,1,33840000
nn_kernel_gpu,2227,1,1,264375,128,0,0,0,0,1,33840000
nn_kernel_gpu_mem,51020,1,1,264375,128,270720000,135360000,135360000,270720000,1,33840000
nn_kernel_cpu,22533,0,1,1,64,0,0,0,0,1,33850000
nn_kernel_gpu,2030,1,1,264454,128,0,0,0,0,1,33850000
nn_kernel_gpu_mem,50680,1,1,264454,128,270800000,135400000,135400000,270800000,1,33850000
nn_kernel_cpu,30352,0,1,1,64,0,0,0,0,1,33860000
nn_kernel_gpu,2011,1,1,264532,128,0,0,0,0,1,33860000
nn_kernel_gpu_mem,50912,1,1,264532,128,270880000,135440000,135440000,270880000,1,33860000
nn_kernel_cpu,9555,0,1,1,64,0,0,0,0,1,33870000
nn_kernel_gpu,2028,1,1,264610,128,0,0,0,0,1,33870000
nn_kernel_gpu_mem,58688,1,1,264610,128,270960000,135480000,135480000,270960000,1,33870000
nn_kernel_cpu,12415,0,1,1,64,0,0,0,0,1,33880000
nn_kernel_gpu,2025,1,1,264688,128,0,0,0,0,1,33880000
nn_kernel_gpu_mem,48948,1,1,264688,128,271040000,135520000,135520000,271040000,1,33880000
nn_kernel_cpu,19720,0,1,1,64,0,0,0,0,1,33890000
nn_kernel_gpu,2022,1,1,264766,128,0,0,0,0,1,33890000
nn_kernel_gpu_mem,45061,1,1,264766,128,271120000,135560000,135560000,271120000,1,33890000
nn_kernel_cpu,18743,0,1,1,64,0,0,0,0,1,33900000
nn_kernel_gpu,2027,1,1,264844,128,0,0,0,0,1,33900000
nn_kernel_gpu_mem,49763,1,1,264844,128,271200000,135600000,135600000,271200000,1,33900000
nn_kernel_cpu,6875,0,1,1,64,0,0,0,0,1,3390000
nn_kernel_gpu,254,1,1,26485,128,0,0,0,0,1,3390000
nn_kernel_gpu_mem,5163,1,1,26485,128,27120000,13560000,13560000,27120000,1,3390000
nn_kernel_cpu,8144,0,1,1,64,0,0,0,0,1,33910000
nn_kernel_gpu,2021,1,1,264922,128,0,0,0,0,1,33910000
nn_kernel_gpu_mem,51819,1,1,264922,128,271280000,135640000,135640000,271280000,1,33910000
nn_kernel_cpu,33565,0,1,1,64,0,0,0,0,1,33920000
nn_kernel_gpu,2027,1,1,265000,128,0,0,0,0,1,33920000
nn_kernel_gpu_mem,52160,1,1,265000,128,271360000,135680000,135680000,271360000,1,33920000
nn_kernel_cpu,13590,0,1,1,64,0,0,0,0,1,33930000
nn_kernel_gpu,2016,1,1,265079,128,0,0,0,0,1,33930000
nn_kernel_gpu_mem,50767,1,1,265079,128,271440000,135720000,135720000,271440000,1,33930000
nn_kernel_cpu,27798,0,1,1,64,0,0,0,0,1,33940000
nn_kernel_gpu,2036,1,1,265157,128,0,0,0,0,1,33940000
nn_kernel_gpu_mem,43075,1,1,265157,128,271520000,135760000,135760000,271520000,1,33940000
nn_kernel_cpu,23321,0,1,1,64,0,0,0,0,1,33950000
nn_kernel_gpu,2024,1,1,265235,128,0,0,0,0,1,33950000
nn_kernel_gpu_mem,41756,1,1,265235,128,271600000,135800000,135800000,271600000,1,33950000
nn_kernel_cpu,30100,0,1,1,64,0,0,0,0,1,33960000
nn_kernel_gpu,2026,1,1,265313,128,0,0,0,0,1,33960000
nn_kernel_gpu_mem,45027,1,1,265313,128,271680000,135840000,135840000,271680000,1,33960000
nn_kernel_cpu,26085,0,1,1,64,0,0,0,0,1,33970000
nn_kernel_gpu,2018,1,1,265391,128,0,0,0,0,1,33970000
nn_kernel_gpu_mem,43573,1,1,265391,128,271760000,135880000,135880000,271760000,1,33970000
nn_kernel_cpu,22709,0,1,1,64,0,0,0,0,1,33980000
nn_kernel_gpu,2024,1,1,265469,128,0,0,0,0,1,33980000
nn_kernel_gpu_mem,48673,1,1,265469,128,271840000,135920000,135920000,271840000,1,33980000
nn_kernel_cpu,38665,0,1,1,64,0,0,0,0,1,33990000
nn_kernel_gpu,2030,1,1,265547,128,0,0,0,0,1,33990000
nn_kernel_gpu_mem,45251,1,1,265547,128,271920000,135960000,135960000,271920000,1,33990000
nn_kernel_cpu,24985,0,1,1,64,0,0,0,0,1,34000000
nn_kernel_gpu,2040,1,1,265625,128,0,0,0,0,1,34000000
nn_kernel_gpu_mem,44648,1,1,265625,128,272000000,136000000,136000000,272000000,1,34000000
nn_kernel_cpu,5776,0,1,1,64,0,0,0,0,1,3400000
nn_kernel_gpu,237,1,1,26563,128,0,0,0,0,1,3400000
nn_kernel_gpu_mem,5346,1,1,26563,128,27200000,13600000,13600000,27200000,1,3400000
nn_kernel_cpu,777,0,1,1,64,0,0,0,0,1,340000
nn_kernel_gpu,61,1,1,2657,128,0,0,0,0,1,340000
nn_kernel_gpu_mem,1217,1,1,2657,128,2720000,1360000,1360000,2720000,1,340000
nn_kernel_cpu,24786,0,1,1,64,0,0,0,0,1,34010000
nn_kernel_gpu,2037,1,1,265704,128,0,0,0,0,1,34010000
nn_kernel_gpu_mem,52371,1,1,265704,128,272080000,136040000,136040000,272080000,1,34010000
nn_kernel_cpu,18359,0,1,1,64,0,0,0,0,1,34020000
nn_kernel_gpu,2026,1,1,265782,128,0,0,0,0,1,34020000
nn_kernel_gpu_mem,52187,1,1,265782,128,272160000,136080000,136080000,272160000,1,34020000
nn_kernel_cpu,24935,0,1,1,64,0,0,0,0,1,34030000
nn_kernel_gpu,2014,1,1,265860,128,0,0,0,0,1,34030000
nn_kernel_gpu_mem,45760,1,1,265860,128,272240000,136120000,136120000,272240000,1,34030000
nn_kernel_cpu,18126,0,1,1,64,0,0,0,0,1,34040000
nn_kernel_gpu,2049,1,1,265938,128,0,0,0,0,1,34040000
nn_kernel_gpu_mem,51795,1,1,265938,128,272320000,136160000,136160000,272320000,1,34040000
nn_kernel_cpu,28583,0,1,1,64,0,0,0,0,1,34050000
nn_kernel_gpu,2021,1,1,266016,128,0,0,0,0,1,34050000
nn_kernel_gpu_mem,53017,1,1,266016,128,272400000,136200000,136200000,272400000,1,34050000
nn_kernel_cpu,19033,0,1,1,64,0,0,0,0,1,34060000
nn_kernel_gpu,2048,1,1,266094,128,0,0,0,0,1,34060000
nn_kernel_gpu_mem,44889,1,1,266094,128,272480000,136240000,136240000,272480000,1,34060000
nn_kernel_cpu,16845,0,1,1,64,0,0,0,0,1,34070000
nn_kernel_gpu,2021,1,1,266172,128,0,0,0,0,1,34070000
nn_kernel_gpu_mem,54779,1,1,266172,128,272560000,136280000,136280000,272560000,1,34070000
nn_kernel_cpu,21848,0,1,1,64,0,0,0,0,1,34080000
nn_kernel_gpu,2057,1,1,266250,128,0,0,0,0,1,34080000
nn_kernel_gpu_mem,52020,1,1,266250,128,272640000,136320000,136320000,272640000,1,34080000
nn_kernel_cpu,29817,0,1,1,64,0,0,0,0,1,34090000
nn_kernel_gpu,2022,1,1,266329,128,0,0,0,0,1,34090000
nn_kernel_gpu_mem,50081,1,1,266329,128,272720000,136360000,136360000,272720000,1,34090000
nn_kernel_cpu,16231,0,1,1,64,0,0,0,0,1,34100000
nn_kernel_gpu,2033,1,1,266407,128,0,0,0,0,1,34100000
nn_kernel_gpu_mem,42350,1,1,266407,128,272800000,136400000,136400000,272800000,1,34100000
nn_kernel_cpu,10496,0,1,1,64,0,0,0,0,1,3410000
nn_kernel_gpu,252,1,1,26641,128,0,0,0,0,1,3410000
nn_kernel_gpu_mem,5340,1,1,26641,128,27280000,13640000,13640000,27280000,1,3410000
nn_kernel_cpu,24868,0,1,1,64,0,0,0,0,1,34110000
nn_kernel_gpu,2025,1,1,266485,128,0,0,0,0,1,34110000
nn_kernel_gpu_mem,52260,1,1,266485,128,272880000,136440000,136440000,272880000,1,34110000
nn_kernel_cpu,23774,0,1,1,64,0,0,0,0,1,34120000
nn_kernel_gpu,2048,1,1,266563,128,0,0,0,0,1,34120000
nn_kernel_gpu_mem,58027,1,1,266563,128,272960000,136480000,136480000,272960000,1,34120000
nn_kernel_cpu,11599,0,1,1,64,0,0,0,0,1,34130000
nn_kernel_gpu,2014,1,1,266641,128,0,0,0,0,1,34130000
nn_kernel_gpu_mem,51958,1,1,266641,128,273040000,136520000,136520000,273040000,1,34130000
nn_kernel_cpu,10950,0,1,1,64,0,0,0,0,1,34140000
nn_kernel_gpu,2036,1,1,266719,128,0,0,0,0,1,34140000
nn_kernel_gpu_mem,47392,1,1,266719,128,273120000,136560000,136560000,273120000,1,34140000
nn_kernel_cpu,22698,0,1,1,64,0,0,0,0,1,34150000
nn_kernel_gpu,2014,1,1,266797,128,0,0,0,0,1,34150000
nn_kernel_gpu_mem,43718,1,1,266797,128,273200000,136600000,136600000,273200000,1,34150000
nn_kernel_cpu,11704,0,1,1,64,0,0,0,0,1,34160000
nn_kernel_gpu,2083,1,1,266875,128,0,0,0,0,1,34160000
nn_kernel_gpu_mem,48606,1,1,266875,128,273280000,136640000,136640000,273280000,1,34160000
nn_kernel_cpu,16129,0,1,1,64,0,0,0,0,1,34170000
nn_kernel_gpu,2009,1,1,266954,128,0,0,0,0,1,34170000
nn_kernel_gpu_mem,41022,1,1,266954,128,273360000,136680000,136680000,273360000,1,34170000
nn_kernel_cpu,17025,0,1,1,64,0,0,0,0,1,34180000
nn_kernel_gpu,2023,1,1,267032,128,0,0,0,0,1,34180000
nn_kernel_gpu_mem,42079,1,1,267032,128,273440000,136720000,136720000,273440000,1,34180000
nn_kernel_cpu,10401,0,1,1,64,0,0,0,0,1,34190000
nn_kernel_gpu,2043,1,1,267110,128,0,0,0,0,1,34190000
nn_kernel_gpu_mem,51315,1,1,267110,128,273520000,136760000,136760000,273520000,1,34190000
nn_kernel_cpu,14738,0,1,1,64,0,0,0,0,1,34200000
nn_kernel_gpu,2036,1,1,267188,128,0,0,0,0,1,34200000
nn_kernel_gpu_mem,53946,1,1,267188,128,273600000,136800000,136800000,273600000,1,34200000
nn_kernel_cpu,20971,0,1,1,64,0,0,0,0,1,3420000
nn_kernel_gpu,251,1,1,26719,128,0,0,0,0,1,3420000
nn_kernel_gpu_mem,5269,1,1,26719,128,27360000,13680000,13680000,27360000,1,3420000
nn_kernel_cpu,30931,0,1,1,64,0,0,0,0,1,34210000
nn_kernel_gpu,2051,1,1,267266,128,0,0,0,0,1,34210000
nn_kernel_gpu_mem,52261,1,1,267266,128,273680000,136840000,136840000,273680000,1,34210000
nn_kernel_cpu,14843,0,1,1,64,0,0,0,0,1,34220000
nn_kernel_gpu,2064,1,1,267344,128,0,0,0,0,1,34220000
nn_kernel_gpu_mem,48183,1,1,267344,128,273760000,136880000,136880000,273760000,1,34220000
nn_kernel_cpu,25322,0,1,1,64,0,0,0,0,1,34230000
nn_kernel_gpu,2034,1,1,267422,128,0,0,0,0,1,34230000
nn_kernel_gpu_mem,50891,1,1,267422,128,273840000,136920000,136920000,273840000,1,34230000
nn_kernel_cpu,21678,0,1,1,64,0,0,0,0,1,34240000
nn_kernel_gpu,2034,1,1,267500,128,0,0,0,0,1,34240000
nn_kernel_gpu_mem,51392,1,1,267500,128,273920000,136960000,136960000,273920000,1,34240000
nn_kernel_cpu,15345,0,1,1,64,0,0,0,0,1,34250000
nn_kernel_gpu,2042,1,1,267579,128,0,0,0,0,1,34250000
nn_kernel_gpu_mem,52860,1,1,267579,128,274000000,137000000,137000000,274000000,1,34250000
nn_kernel_cpu,24686,0,1,1,64,0,0,0,0,1,34260000
nn_kernel_gpu,2049,1,1,267657,128,0,0,0,0,1,34260000
nn_kernel_gpu_mem,51944,1,1,267657,128,274080000,137040000,137040000,274080000,1,34260000
nn_kernel_cpu,13719,0,1,1,64,0,0,0,0,1,34270000
nn_kernel_gpu,2049,1,1,267735,128,0,0,0,0,1,34270000
nn_kernel_gpu_mem,51871,1,1,267735,128,274160000,137080000,137080000,274160000,1,34270000
nn_kernel_cpu,26523,0,1,1,64,0,0,0,0,1,34280000
nn_kernel_gpu,2040,1,1,267813,128,0,0,0,0,1,34280000
nn_kernel_gpu_mem,43732,1,1,267813,128,274240000,137120000,137120000,274240000,1,34280000
nn_kernel_cpu,24331,0,1,1,64,0,0,0,0,1,34290000
nn_kernel_gpu,2051,1,1,267891,128,0,0,0,0,1,34290000
nn_kernel_gpu_mem,56175,1,1,267891,128,274320000,137160000,137160000,274320000,1,34290000
nn_kernel_cpu,10441,0,1,1,64,0,0,0,0,1,34300000
nn_kernel_gpu,2056,1,1,267969,128,0,0,0,0,1,34300000
nn_kernel_gpu_mem,51463,1,1,267969,128,274400000,137200000,137200000,274400000,1,34300000
nn_kernel_cpu,25644,0,1,1,64,0,0,0,0,1,3430000
nn_kernel_gpu,259,1,1,26797,128,0,0,0,0,1,3430000
nn_kernel_gpu_mem,5480,1,1,26797,128,27440000,13720000,13720000,27440000,1,3430000
nn_kernel_cpu,18631,0,1,1,64,0,0,0,0,1,34310000
nn_kernel_gpu,2056,1,1,268047,128,0,0,0,0,1,34310000
nn_kernel_gpu_mem,51484,1,1,268047,128,274480000,137240000,137240000,274480000,1,34310000
nn_kernel_cpu,24721,0,1,1,64,0,0,0,0,1,34320000
nn_kernel_gpu,2035,1,1,268125,128,0,0,0,0,1,34320000
nn_kernel_gpu_mem,43010,1,1,268125,128,274560000,137280000,137280000,274560000,1,34320000
nn_kernel_cpu,17096,0,1,1,64,0,0,0,0,1,34330000
nn_kernel_gpu,2040,1,1,268204,128,0,0,0,0,1,34330000
nn_kernel_gpu_mem,57764,1,1,268204,128,274640000,137320000,137320000,274640000,1,34330000
nn_kernel_cpu,15542,0,1,1,64,0,0,0,0,1,34340000
nn_kernel_gpu,2087,1,1,268282,128,0,0,0,0,1,34340000
nn_kernel_gpu_mem,45087,1,1,268282,128,274720000,137360000,137360000,274720000,1,34340000
nn_kernel_cpu,12516,0,1,1,64,0,0,0,0,1,34350000
nn_kernel_gpu,2062,1,1,268360,128,0,0,0,0,1,34350000
nn_kernel_gpu_mem,51326,1,1,268360,128,274800000,137400000,137400000,274800000,1,34350000
nn_kernel_cpu,26154,0,1,1,64,0,0,0,0,1,34360000
nn_kernel_gpu,2029,1,1,268438,128,0,0,0,0,1,34360000
nn_kernel_gpu_mem,48781,1,1,268438,128,274880000,137440000,137440000,274880000,1,34360000
nn_kernel_cpu,25069,0,1,1,64,0,0,0,0,1,34370000
nn_kernel_gpu,2054,1,1,268516,128,0,0,0,0,1,34370000
nn_kernel_gpu_mem,46854,1,1,268516,128,274960000,137480000,137480000,274960000,1,34370000
nn_kernel_cpu,27554,0,1,1,64,0,0,0,0,1,34380000
nn_kernel_gpu,2042,1,1,268594,128,0,0,0,0,1,34380000
nn_kernel_gpu_mem,52793,1,1,268594,128,275040000,137520000,137520000,275040000,1,34380000
nn_kernel_cpu,16021,0,1,1,64,0,0,0,0,1,34390000
nn_kernel_gpu,2040,1,1,268672,128,0,0,0,0,1,34390000
nn_kernel_gpu_mem,43546,1,1,268672,128,275120000,137560000,137560000,275120000,1,34390000
nn_kernel_cpu,34680,0,1,1,64,0,0,0,0,1,34400000
nn_kernel_gpu,2048,1,1,268750,128,0,0,0,0,1,34400000
nn_kernel_gpu_mem,51879,1,1,268750,128,275200000,137600000,137600000,275200000,1,34400000
nn_kernel_cpu,20931,0,1,1,64,0,0,0,0,1,3440000
nn_kernel_gpu,241,1,1,26875,128,0,0,0,0,1,3440000
nn_kernel_gpu_mem,5644,1,1,26875,128,27520000,13760000,13760000,27520000,1,3440000
nn_kernel_cpu,24514,0,1,1,64,0,0,0,0,1,34410000
nn_kernel_gpu,2051,1,1,268829,128,0,0,0,0,1,34410000
nn_kernel_gpu_mem,51504,1,1,268829,128,275280000,137640000,137640000,275280000,1,34410000
nn_kernel_cpu,19902,0,1,1,64,0,0,0,0,1,34420000
nn_kernel_gpu,2024,1,1,268907,128,0,0,0,0,1,34420000
nn_kernel_gpu_mem,53491,1,1,268907,128,275360000,137680000,137680000,275360000,1,34420000
nn_kernel_cpu,18155,0,1,1,64,0,0,0,0,1,34430000
nn_kernel_gpu,2033,1,1,268985,128,0,0,0,0,1,34430000
nn_kernel_gpu_mem,52647,1,1,268985,128,275440000,137720000,137720000,275440000,1,34430000
nn_kernel_cpu,29090,0,1,1,64,0,0,0,0,1,34440000
nn_kernel_gpu,2059,1,1,269063,128,0,0,0,0,1,34440000
nn_kernel_gpu_mem,52721,1,1,269063,128,275520000,137760000,137760000,275520000,1,34440000
nn_kernel_cpu,10305,0,1,1,64,0,0,0,0,1,34450000
nn_kernel_gpu,2067,1,1,269141,128,0,0,0,0,1,34450000
nn_kernel_gpu_mem,44308,1,1,269141,128,275600000,137800000,137800000,275600000,1,34450000
nn_kernel_cpu,36332,0,1,1,64,0,0,0,0,1,34460000
nn_kernel_gpu,2054,1,1,269219,128,0,0,0,0,1,34460000
nn_kernel_gpu_mem,49549,1,1,269219,128,275680000,137840000,137840000,275680000,1,34460000
nn_kernel_cpu,27477,0,1,1,64,0,0,0,0,1,34470000
nn_kernel_gpu,2046,1,1,269297,128,0,0,0,0,1,34470000
nn_kernel_gpu_mem,46870,1,1,269297,128,275760000,137880000,137880000,275760000,1,34470000
nn_kernel_cpu,30007,0,1,1,64,0,0,0,0,1,34480000
nn_kernel_gpu,2037,1,1,269375,128,0,0,0,0,1,34480000
nn_kernel_gpu_mem,54308,1,1,269375,128,275840000,137920000,137920000,275840000,1,34480000
nn_kernel_cpu,18021,0,1,1,64,0,0,0,0,1,34490000
nn_kernel_gpu,2101,1,1,269454,128,0,0,0,0,1,34490000
nn_kernel_gpu_mem,43568,1,1,269454,128,275920000,137960000,137960000,275920000,1,34490000
nn_kernel_cpu,9952,0,1,1,64,0,0,0,0,1,34500000
nn_kernel_gpu,2046,1,1,269532,128,0,0,0,0,1,34500000
nn_kernel_gpu_mem,54839,1,1,269532,128,276000000,138000000,138000000,276000000,1,34500000
nn_kernel_cpu,9145,0,1,1,64,0,0,0,0,1,3450000
nn_kernel_gpu,241,1,1,26954,128,0,0,0,0,1,3450000
nn_kernel_gpu_mem,4739,1,1,26954,128,27600000,13800000,13800000,27600000,1,3450000
nn_kernel_cpu,25046,0,1,1,64,0,0,0,0,1,34510000
nn_kernel_gpu,2054,1,1,269610,128,0,0,0,0,1,34510000
nn_kernel_gpu_mem,46791,1,1,269610,128,276080000,138040000,138040000,276080000,1,34510000
nn_kernel_cpu,22165,0,1,1,64,0,0,0,0,1,34520000
nn_kernel_gpu,2062,1,1,269688,128,0,0,0,0,1,34520000
nn_kernel_gpu_mem,47761,1,1,269688,128,276160000,138080000,138080000,276160000,1,34520000
nn_kernel_cpu,22236,0,1,1,64,0,0,0,0,1,34530000
nn_kernel_gpu,2058,1,1,269766,128,0,0,0,0,1,34530000
nn_kernel_gpu_mem,52849,1,1,269766,128,276240000,138120000,138120000,276240000,1,34530000
nn_kernel_cpu,14412,0,1,1,64,0,0,0,0,1,34540000
nn_kernel_gpu,2092,1,1,269844,128,0,0,0,0,1,34540000
nn_kernel_gpu_mem,54053,1,1,269844,128,276320000,138160000,138160000,276320000,1,34540000
nn_kernel_cpu,17483,0,1,1,64,0,0,0,0,1,34550000
nn_kernel_gpu,2088,1,1,269922,128,0,0,0,0,1,34550000
nn_kernel_gpu_mem,59277,1,1,269922,128,276400000,138200000,138200000,276400000,1,34550000
nn_kernel_cpu,26820,0,1,1,64,0,0,0,0,1,34560000
nn_kernel_gpu,2062,1,1,270000,128,0,0,0,0,1,34560000
nn_kernel_gpu_mem,51420,1,1,270000,128,276480000,138240000,138240000,276480000,1,34560000
nn_kernel_cpu,27099,0,1,1,64,0,0,0,0,1,34570000
nn_kernel_gpu,2063,1,1,270079,128,0,0,0,0,1,34570000
nn_kernel_gpu_mem,52628,1,1,270079,128,276560000,138280000,138280000,276560000,1,34570000
nn_kernel_cpu,10629,0,1,1,64,0,0,0,0,1,34580000
nn_kernel_gpu,2054,1,1,270157,128,0,0,0,0,1,34580000
nn_kernel_gpu_mem,49962,1,1,270157,128,276640000,138320000,138320000,276640000,1,34580000
nn_kernel_cpu,38319,0,1,1,64,0,0,0,0,1,34590000
nn_kernel_gpu,2070,1,1,270235,128,0,0,0,0,1,34590000
nn_kernel_gpu_mem,44275,1,1,270235,128,276720000,138360000,138360000,276720000,1,34590000
nn_kernel_cpu,24108,0,1,1,64,0,0,0,0,1,34600000
nn_kernel_gpu,2051,1,1,270313,128,0,0,0,0,1,34600000
nn_kernel_gpu_mem,45775,1,1,270313,128,276800000,138400000,138400000,276800000,1,34600000
nn_kernel_cpu,29694,0,1,1,64,0,0,0,0,1,3460000
nn_kernel_gpu,259,1,1,27032,128,0,0,0,0,1,3460000
nn_kernel_gpu_mem,11715,1,1,27032,128,27680000,13840000,13840000,27680000,1,3460000
nn_kernel_cpu,18534,0,1,1,64,0,0,0,0,1,34610000
nn_kernel_gpu,2047,1,1,270391,128,0,0,0,0,1,34610000
nn_kernel_gpu_mem,45062,1,1,270391,128,276880000,138440000,138440000,276880000,1,34610000
nn_kernel_cpu,25780,0,1,1,64,0,0,0,0,1,34620000
nn_kernel_gpu,2059,1,1,270469,128,0,0,0,0,1,34620000
nn_kernel_gpu_mem,44785,1,1,270469,128,276960000,138480000,138480000,276960000,1,34620000
nn_kernel_cpu,20425,0,1,1,64,0,0,0,0,1,34630000
nn_kernel_gpu,2027,1,1,270547,128,0,0,0,0,1,34630000
nn_kernel_gpu_mem,45591,1,1,270547,128,277040000,138520000,138520000,277040000,1,34630000
nn_kernel_cpu,67341,0,1,1,64,0,0,0,0,1,34640000
nn_kernel_gpu,2053,1,1,270625,128,0,0,0,0,1,34640000
nn_kernel_gpu_mem,42000,1,1,270625,128,277120000,138560000,138560000,277120000,1,34640000
nn_kernel_cpu,22046,0,1,1,64,0,0,0,0,1,34650000
nn_kernel_gpu,2086,1,1,270704,128,0,0,0,0,1,34650000
nn_kernel_gpu_mem,54363,1,1,270704,128,277200000,138600000,138600000,277200000,1,34650000
nn_kernel_cpu,26753,0,1,1,64,0,0,0,0,1,34660000
nn_kernel_gpu,2086,1,1,270782,128,0,0,0,0,1,34660000
nn_kernel_gpu_mem,51660,1,1,270782,128,277280000,138640000,138640000,277280000,1,34660000
nn_kernel_cpu,26339,0,1,1,64,0,0,0,0,1,34670000
nn_kernel_gpu,2056,1,1,270860,128,0,0,0,0,1,34670000
nn_kernel_gpu_mem,52835,1,1,270860,128,277360000,138680000,138680000,277360000,1,34670000
nn_kernel_cpu,27394,0,1,1,64,0,0,0,0,1,34680000
nn_kernel_gpu,2072,1,1,270938,128,0,0,0,0,1,34680000
nn_kernel_gpu_mem,54516,1,1,270938,128,277440000,138720000,138720000,277440000,1,34680000
nn_kernel_cpu,30688,0,1,1,64,0,0,0,0,1,34690000
nn_kernel_gpu,2063,1,1,271016,128,0,0,0,0,1,34690000
nn_kernel_gpu_mem,51701,1,1,271016,128,277520000,138760000,138760000,277520000,1,34690000
nn_kernel_cpu,18115,0,1,1,64,0,0,0,0,1,34700000
nn_kernel_gpu,2062,1,1,271094,128,0,0,0,0,1,34700000
nn_kernel_gpu_mem,48059,1,1,271094,128,277600000,138800000,138800000,277600000,1,34700000
nn_kernel_cpu,4775,0,1,1,64,0,0,0,0,1,3470000
nn_kernel_gpu,256,1,1,27110,128,0,0,0,0,1,3470000
nn_kernel_gpu_mem,5575,1,1,27110,128,27760000,13880000,13880000,27760000,1,3470000
nn_kernel_cpu,28927,0,1,1,64,0,0,0,0,1,34710000
nn_kernel_gpu,2057,1,1,271172,128,0,0,0,0,1,34710000
nn_kernel_gpu_mem,54569,1,1,271172,128,277680000,138840000,138840000,277680000,1,34710000
nn_kernel_cpu,26961,0,1,1,64,0,0,0,0,1,34720000
nn_kernel_gpu,2094,1,1,271250,128,0,0,0,0,1,34720000
nn_kernel_gpu_mem,45511,1,1,271250,128,277760000,138880000,138880000,277760000,1,34720000
nn_kernel_cpu,16524,0,1,1,64,0,0,0,0,1,34730000
nn_kernel_gpu,2069,1,1,271329,128,0,0,0,0,1,34730000
nn_kernel_gpu_mem,46012,1,1,271329,128,277840000,138920000,138920000,277840000,1,34730000
nn_kernel_cpu,25543,0,1,1,64,0,0,0,0,1,34740000
nn_kernel_gpu,2062,1,1,271407,128,0,0,0,0,1,34740000
nn_kernel_gpu_mem,45072,1,1,271407,128,277920000,138960000,138960000,277920000,1,34740000
nn_kernel_cpu,21943,0,1,1,64,0,0,0,0,1,34750000
nn_kernel_gpu,2090,1,1,271485,128,0,0,0,0,1,34750000
nn_kernel_gpu_mem,52626,1,1,271485,128,278000000,139000000,139000000,278000000,1,34750000
nn_kernel_cpu,30998,0,1,1,64,0,0,0,0,1,34760000
nn_kernel_gpu,2051,1,1,271563,128,0,0,0,0,1,34760000
nn_kernel_gpu_mem,53778,1,1,271563,128,278080000,139040000,139040000,278080000,1,34760000
nn_kernel_cpu,11278,0,1,1,64,0,0,0,0,1,34770000
nn_kernel_gpu,2063,1,1,271641,128,0,0,0,0,1,34770000
nn_kernel_gpu_mem,52222,1,1,271641,128,278160000,139080000,139080000,278160000,1,34770000
nn_kernel_cpu,12489,0,1,1,64,0,0,0,0,1,34780000
nn_kernel_gpu,2050,1,1,271719,128,0,0,0,0,1,34780000
nn_kernel_gpu_mem,52289,1,1,271719,128,278240000,139120000,139120000,278240000,1,34780000
nn_kernel_cpu,27144,0,1,1,64,0,0,0,0,1,34790000
nn_kernel_gpu,2064,1,1,271797,128,0,0,0,0,1,34790000
nn_kernel_gpu_mem,50579,1,1,271797,128,278320000,139160000,139160000,278320000,1,34790000
nn_kernel_cpu,25641,0,1,1,64,0,0,0,0,1,34800000
nn_kernel_gpu,2064,1,1,271875,128,0,0,0,0,1,34800000
nn_kernel_gpu_mem,69902,1,1,271875,128,278400000,139200000,139200000,278400000,1,34800000
nn_kernel_cpu,28992,0,1,1,64,0,0,0,0,1,3480000
nn_kernel_gpu,261,1,1,27188,128,0,0,0,0,1,3480000
nn_kernel_gpu_mem,4365,1,1,27188,128,27840000,13920000,13920000,27840000,1,3480000
nn_kernel_cpu,25418,0,1,1,64,0,0,0,0,1,34810000
nn_kernel_gpu,2068,1,1,271954,128,0,0,0,0,1,34810000
nn_kernel_gpu_mem,49139,1,1,271954,128,278480000,139240000,139240000,278480000,1,34810000
nn_kernel_cpu,19123,0,1,1,64,0,0,0,0,1,34820000
nn_kernel_gpu,2054,1,1,272032,128,0,0,0,0,1,34820000
nn_kernel_gpu_mem,50568,1,1,272032,128,278560000,139280000,139280000,278560000,1,34820000
nn_kernel_cpu,32949,0,1,1,64,0,0,0,0,1,34830000
nn_kernel_gpu,2064,1,1,272110,128,0,0,0,0,1,34830000
nn_kernel_gpu_mem,65735,1,1,272110,128,278640000,139320000,139320000,278640000,1,34830000
nn_kernel_cpu,23211,0,1,1,64,0,0,0,0,1,34840000
nn_kernel_gpu,2071,1,1,272188,128,0,0,0,0,1,34840000
nn_kernel_gpu_mem,50003,1,1,272188,128,278720000,139360000,139360000,278720000,1,34840000
nn_kernel_cpu,13060,0,1,1,64,0,0,0,0,1,34850000
nn_kernel_gpu,2054,1,1,272266,128,0,0,0,0,1,34850000
nn_kernel_gpu_mem,45074,1,1,272266,128,278800000,139400000,139400000,278800000,1,34850000
nn_kernel_cpu,18516,0,1,1,64,0,0,0,0,1,34860000
nn_kernel_gpu,2075,1,1,272344,128,0,0,0,0,1,34860000
nn_kernel_gpu_mem,50702,1,1,272344,128,278880000,139440000,139440000,278880000,1,34860000
nn_kernel_cpu,27469,0,1,1,64,0,0,0,0,1,34870000
nn_kernel_gpu,2072,1,1,272422,128,0,0,0,0,1,34870000
nn_kernel_gpu_mem,46449,1,1,272422,128,278960000,139480000,139480000,278960000,1,34870000
nn_kernel_cpu,24346,0,1,1,64,0,0,0,0,1,34880000
nn_kernel_gpu,2083,1,1,272500,128,0,0,0,0,1,34880000
nn_kernel_gpu_mem,49398,1,1,272500,128,279040000,139520000,139520000,279040000,1,34880000
nn_kernel_cpu,18423,0,1,1,64,0,0,0,0,1,34890000
nn_kernel_gpu,2069,1,1,272579,128,0,0,0,0,1,34890000
nn_kernel_gpu_mem,43805,1,1,272579,128,279120000,139560000,139560000,279120000,1,34890000
nn_kernel_cpu,39118,0,1,1,64,0,0,0,0,1,34900000
nn_kernel_gpu,2063,1,1,272657,128,0,0,0,0,1,34900000
nn_kernel_gpu_mem,44830,1,1,272657,128,279200000,139600000,139600000,279200000,1,34900000
nn_kernel_cpu,22838,0,1,1,64,0,0,0,0,1,3490000
nn_kernel_gpu,253,1,1,27266,128,0,0,0,0,1,3490000
nn_kernel_gpu_mem,5348,1,1,27266,128,27920000,13960000,13960000,27920000,1,3490000
nn_kernel_cpu,26202,0,1,1,64,0,0,0,0,1,34910000
nn_kernel_gpu,2115,1,1,272735,128,0,0,0,0,1,34910000
nn_kernel_gpu_mem,50252,1,1,272735,128,279280000,139640000,139640000,279280000,1,34910000
nn_kernel_cpu,14349,0,1,1,64,0,0,0,0,1,34920000
nn_kernel_gpu,2072,1,1,272813,128,0,0,0,0,1,34920000
nn_kernel_gpu_mem,52862,1,1,272813,128,279360000,139680000,139680000,279360000,1,34920000
nn_kernel_cpu,12370,0,1,1,64,0,0,0,0,1,34930000
nn_kernel_gpu,2064,1,1,272891,128,0,0,0,0,1,34930000
nn_kernel_gpu_mem,44716,1,1,272891,128,279440000,139720000,139720000,279440000,1,34930000
nn_kernel_cpu,18218,0,1,1,64,0,0,0,0,1,34940000
nn_kernel_gpu,2076,1,1,272969,128,0,0,0,0,1,34940000
nn_kernel_gpu_mem,52385,1,1,272969,128,279520000,139760000,139760000,279520000,1,34940000
nn_kernel_cpu,14539,0,1,1,64,0,0,0,0,1,34950000
nn_kernel_gpu,2055,1,1,273047,128,0,0,0,0,1,34950000
nn_kernel_gpu_mem,43520,1,1,273047,128,279600000,139800000,139800000,279600000,1,34950000
nn_kernel_cpu,15231,0,1,1,64,0,0,0,0,1,34960000
nn_kernel_gpu,2065,1,1,273125,128,0,0,0,0,1,34960000
nn_kernel_gpu_mem,45541,1,1,273125,128,279680000,139840000,139840000,279680000,1,34960000
nn_kernel_cpu,32217,0,1,1,64,0,0,0,0,1,34970000
nn_kernel_gpu,2080,1,1,273204,128,0,0,0,0,1,34970000
nn_kernel_gpu_mem,52714,1,1,273204,128,279760000,139880000,139880000,279760000,1,34970000
nn_kernel_cpu,21146,0,1,1,64,0,0,0,0,1,34980000
nn_kernel_gpu,2088,1,1,273282,128,0,0,0,0,1,34980000
nn_kernel_gpu_mem,52128,1,1,273282,128,279840000,139920000,139920000,279840000,1,34980000
nn_kernel_cpu,10540,0,1,1,64,0,0,0,0,1,34990000
nn_kernel_gpu,2098,1,1,273360,128,0,0,0,0,1,34990000
nn_kernel_gpu_mem,52863,1,1,273360,128,279920000,139960000,139960000,279920000,1,34990000
nn_kernel_cpu,14683,0,1,1,64,0,0,0,0,1,35000000
nn_kernel_gpu,2092,1,1,273438,128,0,0,0,0,1,35000000
nn_kernel_gpu_mem,53536,1,1,273438,128,280000000,140000000,140000000,280000000,1,35000000
nn_kernel_cpu,10469,0,1,1,64,0,0,0,0,1,3500000
nn_kernel_gpu,264,1,1,27344,128,0,0,0,0,1,3500000
nn_kernel_gpu_mem,5482,1,1,27344,128,28000000,14000000,14000000,28000000,1,3500000
nn_kernel_cpu,30345,0,1,1,64,0,0,0,0,1,350000
nn_kernel_gpu,72,1,1,2735,128,0,0,0,0,1,350000
nn_kernel_gpu_mem,891,1,1,2735,128,2800000,1400000,1400000,2800000,1,350000
nn_kernel_cpu,25546,0,1,1,64,0,0,0,0,1,35010000
nn_kernel_gpu,2062,1,1,273516,128,0,0,0,0,1,35010000
nn_kernel_gpu_mem,44086,1,1,273516,128,280080000,140040000,140040000,280080000,1,35010000
nn_kernel_cpu,11071,0,1,1,64,0,0,0,0,1,35020000
nn_kernel_gpu,2065,1,1,273594,128,0,0,0,0,1,35020000
nn_kernel_gpu_mem,51667,1,1,273594,128,280160000,140080000,140080000,280160000,1,35020000
nn_kernel_cpu,24033,0,1,1,64,0,0,0,0,1,35030000
nn_kernel_gpu,2076,1,1,273672,128,0,0,0,0,1,35030000
nn_kernel_gpu_mem,53054,1,1,273672,128,280240000,140120000,140120000,280240000,1,35030000
nn_kernel_cpu,26088,0,1,1,64,0,0,0,0,1,35040000
nn_kernel_gpu,2094,1,1,273750,128,0,0,0,0,1,35040000
nn_kernel_gpu_mem,54517,1,1,273750,128,280320000,140160000,140160000,280320000,1,35040000
nn_kernel_cpu,23258,0,1,1,64,0,0,0,0,1,35050000
nn_kernel_gpu,2094,1,1,273829,128,0,0,0,0,1,35050000
nn_kernel_gpu_mem,51351,1,1,273829,128,280400000,140200000,140200000,280400000,1,35050000
nn_kernel_cpu,27593,0,1,1,64,0,0,0,0,1,35060000
nn_kernel_gpu,2091,1,1,273907,128,0,0,0,0,1,35060000
nn_kernel_gpu_mem,51970,1,1,273907,128,280480000,140240000,140240000,280480000,1,35060000
nn_kernel_cpu,30688,0,1,1,64,0,0,0,0,1,35070000
nn_kernel_gpu,2099,1,1,273985,128,0,0,0,0,1,35070000
nn_kernel_gpu_mem,46584,1,1,273985,128,280560000,140280000,140280000,280560000,1,35070000
nn_kernel_cpu,21931,0,1,1,64,0,0,0,0,1,35080000
nn_kernel_gpu,2055,1,1,274063,128,0,0,0,0,1,35080000
nn_kernel_gpu_mem,43558,1,1,274063,128,280640000,140320000,140320000,280640000,1,35080000
nn_kernel_cpu,23482,0,1,1,64,0,0,0,0,1,35090000
nn_kernel_gpu,2093,1,1,274141,128,0,0,0,0,1,35090000
nn_kernel_gpu_mem,48097,1,1,274141,128,280720000,140360000,140360000,280720000,1,35090000
nn_kernel_cpu,39967,0,1,1,64,0,0,0,0,1,35100000
nn_kernel_gpu,2098,1,1,274219,128,0,0,0,0,1,35100000
nn_kernel_gpu_mem,45924,1,1,274219,128,280800000,140400000,140400000,280800000,1,35100000
nn_kernel_cpu,17231,0,1,1,64,0,0,0,0,1,3510000
nn_kernel_gpu,259,1,1,27422,128,0,0,0,0,1,3510000
nn_kernel_gpu_mem,9774,1,1,27422,128,28080000,14040000,14040000,28080000,1,3510000
nn_kernel_cpu,25590,0,1,1,64,0,0,0,0,1,35110000
nn_kernel_gpu,2081,1,1,274297,128,0,0,0,0,1,35110000
nn_kernel_gpu_mem,58486,1,1,274297,128,280880000,140440000,140440000,280880000,1,35110000
nn_kernel_cpu,26945,0,1,1,64,0,0,0,0,1,35120000
nn_kernel_gpu,2099,1,1,274375,128,0,0,0,0,1,35120000
nn_kernel_gpu_mem,52811,1,1,274375,128,280960000,140480000,140480000,280960000,1,35120000
nn_kernel_cpu,35331,0,1,1,64,0,0,0,0,1,35130000
nn_kernel_gpu,2091,1,1,274454,128,0,0,0,0,1,35130000
nn_kernel_gpu_mem,48532,1,1,274454,128,281040000,140520000,140520000,281040000,1,35130000
nn_kernel_cpu,29500,0,1,1,64,0,0,0,0,1,35140000
nn_kernel_gpu,2128,1,1,274532,128,0,0,0,0,1,35140000
nn_kernel_gpu_mem,46561,1,1,274532,128,281120000,140560000,140560000,281120000,1,35140000
nn_kernel_cpu,26255,0,1,1,64,0,0,0,0,1,35150000
nn_kernel_gpu,2115,1,1,274610,128,0,0,0,0,1,35150000
nn_kernel_gpu_mem,46522,1,1,274610,128,281200000,140600000,140600000,281200000,1,35150000
nn_kernel_cpu,26383,0,1,1,64,0,0,0,0,1,35160000
nn_kernel_gpu,2072,1,1,274688,128,0,0,0,0,1,35160000
nn_kernel_gpu_mem,43810,1,1,274688,128,281280000,140640000,140640000,281280000,1,35160000
nn_kernel_cpu,17720,0,1,1,64,0,0,0,0,1,35170000
nn_kernel_gpu,2092,1,1,274766,128,0,0,0,0,1,35170000
nn_kernel_gpu_mem,45447,1,1,274766,128,281360000,140680000,140680000,281360000,1,35170000
nn_kernel_cpu,8497,0,1,1,64,0,0,0,0,1,35180000
nn_kernel_gpu,2097,1,1,274844,128,0,0,0,0,1,35180000
nn_kernel_gpu_mem,53299,1,1,274844,128,281440000,140720000,140720000,281440000,1,35180000
nn_kernel_cpu,27214,0,1,1,64,0,0,0,0,1,35190000
nn_kernel_gpu,2107,1,1,274922,128,0,0,0,0,1,35190000
nn_kernel_gpu_mem,44716,1,1,274922,128,281520000,140760000,140760000,281520000,1,35190000
nn_kernel_cpu,8567,0,1,1,64,0,0,0,0,1,35200000
nn_kernel_gpu,2120,1,1,275000,128,0,0,0,0,1,35200000
nn_kernel_gpu_mem,52704,1,1,275000,128,281600000,140800000,140800000,281600000,1,35200000
nn_kernel_cpu,5451,0,1,1,64,0,0,0,0,1,3520000
nn_kernel_gpu,269,1,1,27500,128,0,0,0,0,1,3520000
nn_kernel_gpu_mem,5164,1,1,27500,128,28160000,14080000,14080000,28160000,1,3520000
nn_kernel_cpu,24908,0,1,1,64,0,0,0,0,1,35210000
nn_kernel_gpu,2090,1,1,275079,128,0,0,0,0,1,35210000
nn_kernel_gpu_mem,53645,1,1,275079,128,281680000,140840000,140840000,281680000,1,35210000
nn_kernel_cpu,20962,0,1,1,64,0,0,0,0,1,35220000
nn_kernel_gpu,2108,1,1,275157,128,0,0,0,0,1,35220000
nn_kernel_gpu_mem,45310,1,1,275157,128,281760000,140880000,140880000,281760000,1,35220000
nn_kernel_cpu,10909,0,1,1,64,0,0,0,0,1,35230000
nn_kernel_gpu,2095,1,1,275235,128,0,0,0,0,1,35230000
nn_kernel_gpu_mem,53116,1,1,275235,128,281840000,140920000,140920000,281840000,1,35230000
nn_kernel_cpu,28379,0,1,1,64,0,0,0,0,1,35240000
nn_kernel_gpu,2112,1,1,275313,128,0,0,0,0,1,35240000
nn_kernel_gpu_mem,52692,1,1,275313,128,281920000,140960000,140960000,281920000,1,35240000
nn_kernel_cpu,12492,0,1,1,64,0,0,0,0,1,35250000
nn_kernel_gpu,2111,1,1,275391,128,0,0,0,0,1,35250000
nn_kernel_gpu_mem,45124,1,1,275391,128,282000000,141000000,141000000,282000000,1,35250000
nn_kernel_cpu,14144,0,1,1,64,0,0,0,0,1,35260000
nn_kernel_gpu,2115,1,1,275469,128,0,0,0,0,1,35260000
nn_kernel_gpu_mem,53182,1,1,275469,128,282080000,141040000,141040000,282080000,1,35260000
nn_kernel_cpu,21629,0,1,1,64,0,0,0,0,1,35270000
nn_kernel_gpu,2087,1,1,275547,128,0,0,0,0,1,35270000
nn_kernel_gpu_mem,54301,1,1,275547,128,282160000,141080000,141080000,282160000,1,35270000
nn_kernel_cpu,20014,0,1,1,64,0,0,0,0,1,35280000
nn_kernel_gpu,2154,1,1,275625,128,0,0,0,0,1,35280000
nn_kernel_gpu_mem,46458,1,1,275625,128,282240000,141120000,141120000,282240000,1,35280000
nn_kernel_cpu,18214,0,1,1,64,0,0,0,0,1,35290000
nn_kernel_gpu,2097,1,1,275704,128,0,0,0,0,1,35290000
nn_kernel_gpu_mem,58044,1,1,275704,128,282320000,141160000,141160000,282320000,1,35290000
nn_kernel_cpu,24041,0,1,1,64,0,0,0,0,1,35300000
nn_kernel_gpu,2089,1,1,275782,128,0,0,0,0,1,35300000
nn_kernel_gpu_mem,52413,1,1,275782,128,282400000,141200000,141200000,282400000,1,35300000
nn_kernel_cpu,18615,0,1,1,64,0,0,0,0,1,3530000
nn_kernel_gpu,250,1,1,27579,128,0,0,0,0,1,3530000
nn_kernel_gpu_mem,5748,1,1,27579,128,28240000,14120000,14120000,28240000,1,3530000
nn_kernel_cpu,61550,0,1,1,64,0,0,0,0,1,35310000
nn_kernel_gpu,2115,1,1,275860,128,0,0,0,0,1,35310000
nn_kernel_gpu_mem,53316,1,1,275860,128,282480000,141240000,141240000,282480000,1,35310000
nn_kernel_cpu,25720,0,1,1,64,0,0,0,0,1,35320000
nn_kernel_gpu,2086,1,1,275938,128,0,0,0,0,1,35320000
nn_kernel_gpu_mem,53778,1,1,275938,128,282560000,141280000,141280000,282560000,1,35320000
nn_kernel_cpu,24479,0,1,1,64,0,0,0,0,1,35330000
nn_kernel_gpu,2106,1,1,276016,128,0,0,0,0,1,35330000
nn_kernel_gpu_mem,53575,1,1,276016,128,282640000,141320000,141320000,282640000,1,35330000
nn_kernel_cpu,16698,0,1,1,64,0,0,0,0,1,35340000
nn_kernel_gpu,2110,1,1,276094,128,0,0,0,0,1,35340000
nn_kernel_gpu_mem,53184,1,1,276094,128,282720000,141360000,141360000,282720000,1,35340000
nn_kernel_cpu,28309,0,1,1,64,0,0,0,0,1,35350000
nn_kernel_gpu,2102,1,1,276172,128,0,0,0,0,1,35350000
nn_kernel_gpu_mem,47988,1,1,276172,128,282800000,141400000,141400000,282800000,1,35350000
nn_kernel_cpu,13626,0,1,1,64,0,0,0,0,1,35360000
nn_kernel_gpu,2111,1,1,276250,128,0,0,0,0,1,35360000
nn_kernel_gpu_mem,53110,1,1,276250,128,282880000,141440000,141440000,282880000,1,35360000
nn_kernel_cpu,22097,0,1,1,64,0,0,0,0,1,35370000
nn_kernel_gpu,2109,1,1,276329,128,0,0,0,0,1,35370000
nn_kernel_gpu_mem,53572,1,1,276329,128,282960000,141480000,141480000,282960000,1,35370000
nn_kernel_cpu,17010,0,1,1,64,0,0,0,0,1,35380000
nn_kernel_gpu,2102,1,1,276407,128,0,0,0,0,1,35380000
nn_kernel_gpu_mem,52700,1,1,276407,128,283040000,141520000,141520000,283040000,1,35380000
nn_kernel_cpu,14326,0,1,1,64,0,0,0,0,1,35390000
nn_kernel_gpu,2105,1,1,276485,128,0,0,0,0,1,35390000
nn_kernel_gpu_mem,42127,1,1,276485,128,283120000,141560000,141560000,283120000,1,35390000
nn_kernel_cpu,21546,0,1,1,64,0,0,0,0,1,35400000
nn_kernel_gpu,2135,1,1,276563,128,0,0,0,0,1,35400000
nn_kernel_gpu_mem,51137,1,1,276563,128,283200000,141600000,141600000,283200000,1,35400000
nn_kernel_cpu,5775,0,1,1,64,0,0,0,0,1,3540000
nn_kernel_gpu,268,1,1,27657,128,0,0,0,0,1,3540000
nn_kernel_gpu_mem,5326,1,1,27657,128,28320000,14160000,14160000,28320000,1,3540000
nn_kernel_cpu,28894,0,1,1,64,0,0,0,0,1,35410000
nn_kernel_gpu,2096,1,1,276641,128,0,0,0,0,1,35410000
nn_kernel_gpu_mem,50867,1,1,276641,128,283280000,141640000,141640000,283280000,1,35410000
nn_kernel_cpu,23926,0,1,1,64,0,0,0,0,1,35420000
nn_kernel_gpu,2140,1,1,276719,128,0,0,0,0,1,35420000
nn_kernel_gpu_mem,52997,1,1,276719,128,283360000,141680000,141680000,283360000,1,35420000
nn_kernel_cpu,17860,0,1,1,64,0,0,0,0,1,35430000
nn_kernel_gpu,2106,1,1,276797,128,0,0,0,0,1,35430000
nn_kernel_gpu_mem,50595,1,1,276797,128,283440000,141720000,141720000,283440000,1,35430000
nn_kernel_cpu,20558,0,1,1,64,0,0,0,0,1,35440000
nn_kernel_gpu,2124,1,1,276875,128,0,0,0,0,1,35440000
nn_kernel_gpu_mem,53057,1,1,276875,128,283520000,141760000,141760000,283520000,1,35440000
nn_kernel_cpu,26305,0,1,1,64,0,0,0,0,1,35450000
nn_kernel_gpu,2117,1,1,276954,128,0,0,0,0,1,35450000
nn_kernel_gpu_mem,54163,1,1,276954,128,283600000,141800000,141800000,283600000,1,35450000
nn_kernel_cpu,27626,0,1,1,64,0,0,0,0,1,35460000
nn_kernel_gpu,2127,1,1,277032,128,0,0,0,0,1,35460000
nn_kernel_gpu_mem,46348,1,1,277032,128,283680000,141840000,141840000,283680000,1,35460000
nn_kernel_cpu,29927,0,1,1,64,0,0,0,0,1,35470000
nn_kernel_gpu,2109,1,1,277110,128,0,0,0,0,1,35470000
nn_kernel_gpu_mem,47322,1,1,277110,128,283760000,141880000,141880000,283760000,1,35470000
nn_kernel_cpu,27738,0,1,1,64,0,0,0,0,1,35480000
nn_kernel_gpu,2086,1,1,277188,128,0,0,0,0,1,35480000
nn_kernel_gpu_mem,46500,1,1,277188,128,283840000,141920000,141920000,283840000,1,35480000
nn_kernel_cpu,34167,0,1,1,64,0,0,0,0,1,35490000
nn_kernel_gpu,2126,1,1,277266,128,0,0,0,0,1,35490000
nn_kernel_gpu_mem,44777,1,1,277266,128,283920000,141960000,141960000,283920000,1,35490000
nn_kernel_cpu,27891,0,1,1,64,0,0,0,0,1,35500000
nn_kernel_gpu,2122,1,1,277344,128,0,0,0,0,1,35500000
nn_kernel_gpu_mem,52649,1,1,277344,128,284000000,142000000,142000000,284000000,1,35500000
nn_kernel_cpu,6437,0,1,1,64,0,0,0,0,1,3550000
nn_kernel_gpu,263,1,1,27735,128,0,0,0,0,1,3550000
nn_kernel_gpu_mem,5860,1,1,27735,128,28400000,14200000,14200000,28400000,1,3550000
nn_kernel_cpu,28032,0,1,1,64,0,0,0,0,1,35510000
nn_kernel_gpu,2125,1,1,277422,128,0,0,0,0,1,35510000
nn_kernel_gpu_mem,53583,1,1,277422,128,284080000,142040000,142040000,284080000,1,35510000
nn_kernel_cpu,30643,0,1,1,64,0,0,0,0,1,35520000
nn_kernel_gpu,2110,1,1,277500,128,0,0,0,0,1,35520000
nn_kernel_gpu_mem,46149,1,1,277500,128,284160000,142080000,142080000,284160000,1,35520000
nn_kernel_cpu,16116,0,1,1,64,0,0,0,0,1,35530000
nn_kernel_gpu,2129,1,1,277579,128,0,0,0,0,1,35530000
nn_kernel_gpu_mem,46490,1,1,277579,128,284240000,142120000,142120000,284240000,1,35530000
nn_kernel_cpu,23675,0,1,1,64,0,0,0,0,1,35540000
nn_kernel_gpu,2133,1,1,277657,128,0,0,0,0,1,35540000
nn_kernel_gpu_mem,55960,1,1,277657,128,284320000,142160000,142160000,284320000,1,35540000
nn_kernel_cpu,24527,0,1,1,64,0,0,0,0,1,35550000
nn_kernel_gpu,2132,1,1,277735,128,0,0,0,0,1,35550000
nn_kernel_gpu_mem,53291,1,1,277735,128,284400000,142200000,142200000,284400000,1,35550000
nn_kernel_cpu,12849,0,1,1,64,0,0,0,0,1,35560000
nn_kernel_gpu,2104,1,1,277813,128,0,0,0,0,1,35560000
nn_kernel_gpu_mem,45291,1,1,277813,128,284480000,142240000,142240000,284480000,1,35560000
nn_kernel_cpu,22579,0,1,1,64,0,0,0,0,1,35570000
nn_kernel_gpu,2128,1,1,277891,128,0,0,0,0,1,35570000
nn_kernel_gpu_mem,54108,1,1,277891,128,284560000,142280000,142280000,284560000,1,35570000
nn_kernel_cpu,37183,0,1,1,64,0,0,0,0,1,35580000
nn_kernel_gpu,2162,1,1,277969,128,0,0,0,0,1,35580000
nn_kernel_gpu_mem,58219,1,1,277969,128,284640000,142320000,142320000,284640000,1,35580000
nn_kernel_cpu,9760,0,1,1,64,0,0,0,0,1,35590000
nn_kernel_gpu,2113,1,1,278047,128,0,0,0,0,1,35590000
nn_kernel_gpu_mem,44605,1,1,278047,128,284720000,142360000,142360000,284720000,1,35590000
nn_kernel_cpu,18045,0,1,1,64,0,0,0,0,1,35600000
nn_kernel_gpu,2151,1,1,278125,128,0,0,0,0,1,35600000
nn_kernel_gpu_mem,53674,1,1,278125,128,284800000,142400000,142400000,284800000,1,35600000
nn_kernel_cpu,20033,0,1,1,64,0,0,0,0,1,3560000
nn_kernel_gpu,304,1,1,27813,128,0,0,0,0,1,3560000
nn_kernel_gpu_mem,5332,1,1,27813,128,28480000,14240000,14240000,28480000,1,3560000
nn_kernel_cpu,20742,0,1,1,64,0,0,0,0,1,35610000
nn_kernel_gpu,2116,1,1,278204,128,0,0,0,0,1,35610000
nn_kernel_gpu_mem,55202,1,1,278204,128,284880000,142440000,142440000,284880000,1,35610000
nn_kernel_cpu,37978,0,1,1,64,0,0,0,0,1,35620000
nn_kernel_gpu,2131,1,1,278282,128,0,0,0,0,1,35620000
nn_kernel_gpu_mem,51404,1,1,278282,128,284960000,142480000,142480000,284960000,1,35620000
nn_kernel_cpu,26360,0,1,1,64,0,0,0,0,1,35630000
nn_kernel_gpu,2119,1,1,278360,128,0,0,0,0,1,35630000
nn_kernel_gpu_mem,50249,1,1,278360,128,285040000,142520000,142520000,285040000,1,35630000
nn_kernel_cpu,25479,0,1,1,64,0,0,0,0,1,35640000
nn_kernel_gpu,2127,1,1,278438,128,0,0,0,0,1,35640000
nn_kernel_gpu_mem,54277,1,1,278438,128,285120000,142560000,142560000,285120000,1,35640000
nn_kernel_cpu,15681,0,1,1,64,0,0,0,0,1,35650000
nn_kernel_gpu,2100,1,1,278516,128,0,0,0,0,1,35650000
nn_kernel_gpu_mem,52784,1,1,278516,128,285200000,142600000,142600000,285200000,1,35650000
nn_kernel_cpu,30913,0,1,1,64,0,0,0,0,1,35660000
nn_kernel_gpu,2121,1,1,278594,128,0,0,0,0,1,35660000
nn_kernel_gpu_mem,49283,1,1,278594,128,285280000,142640000,142640000,285280000,1,35660000
nn_kernel_cpu,20694,0,1,1,64,0,0,0,0,1,35670000
nn_kernel_gpu,2150,1,1,278672,128,0,0,0,0,1,35670000
nn_kernel_gpu_mem,49060,1,1,278672,128,285360000,142680000,142680000,285360000,1,35670000
nn_kernel_cpu,17326,0,1,1,64,0,0,0,0,1,35680000
nn_kernel_gpu,2157,1,1,278750,128,0,0,0,0,1,35680000
nn_kernel_gpu_mem,46457,1,1,278750,128,285440000,142720000,142720000,285440000,1,35680000
nn_kernel_cpu,19783,0,1,1,64,0,0,0,0,1,35690000
nn_kernel_gpu,2119,1,1,278829,128,0,0,0,0,1,35690000
nn_kernel_gpu_mem,53373,1,1,278829,128,285520000,142760000,142760000,285520000,1,35690000
nn_kernel_cpu,25684,0,1,1,64,0,0,0,0,1,35700000
nn_kernel_gpu,2101,1,1,278907,128,0,0,0,0,1,35700000
nn_kernel_gpu_mem,57735,1,1,278907,128,285600000,142800000,142800000,285600000,1,35700000
nn_kernel_cpu,4447,0,1,1,64,0,0,0,0,1,3570000
nn_kernel_gpu,263,1,1,27891,128,0,0,0,0,1,3570000
nn_kernel_gpu_mem,5888,1,1,27891,128,28560000,14280000,14280000,28560000,1,3570000
nn_kernel_cpu,28026,0,1,1,64,0,0,0,0,1,35710000
nn_kernel_gpu,2138,1,1,278985,128,0,0,0,0,1,35710000
nn_kernel_gpu_mem,52891,1,1,278985,128,285680000,142840000,142840000,285680000,1,35710000
nn_kernel_cpu,34075,0,1,1,64,0,0,0,0,1,35720000
nn_kernel_gpu,2108,1,1,279063,128,0,0,0,0,1,35720000
nn_kernel_gpu_mem,43533,1,1,279063,128,285760000,142880000,142880000,285760000,1,35720000
nn_kernel_cpu,24795,0,1,1,64,0,0,0,0,1,35730000
nn_kernel_gpu,2103,1,1,279141,128,0,0,0,0,1,35730000
nn_kernel_gpu_mem,51403,1,1,279141,128,285840000,142920000,142920000,285840000,1,35730000
nn_kernel_cpu,23744,0,1,1,64,0,0,0,0,1,35740000
nn_kernel_gpu,2135,1,1,279219,128,0,0,0,0,1,35740000
nn_kernel_gpu_mem,45573,1,1,279219,128,285920000,142960000,142960000,285920000,1,35740000
nn_kernel_cpu,14140,0,1,1,64,0,0,0,0,1,35750000
nn_kernel_gpu,2117,1,1,279297,128,0,0,0,0,1,35750000
nn_kernel_gpu_mem,53432,1,1,279297,128,286000000,143000000,143000000,286000000,1,35750000
nn_kernel_cpu,19762,0,1,1,64,0,0,0,0,1,35760000
nn_kernel_gpu,2125,1,1,279375,128,0,0,0,0,1,35760000
nn_kernel_gpu_mem,44996,1,1,279375,128,286080000,143040000,143040000,286080000,1,35760000
nn_kernel_cpu,29383,0,1,1,64,0,0,0,0,1,35770000
nn_kernel_gpu,2115,1,1,279454,128,0,0,0,0,1,35770000
nn_kernel_gpu_mem,44874,1,1,279454,128,286160000,143080000,143080000,286160000,1,35770000
nn_kernel_cpu,11239,0,1,1,64,0,0,0,0,1,35780000
nn_kernel_gpu,2109,1,1,279532,128,0,0,0,0,1,35780000
nn_kernel_gpu_mem,56017,1,1,279532,128,286240000,143120000,143120000,286240000,1,35780000
nn_kernel_cpu,19299,0,1,1,64,0,0,0,0,1,35790000
nn_kernel_gpu,2126,1,1,279610,128,0,0,0,0,1,35790000
nn_kernel_gpu_mem,54262,1,1,279610,128,286320000,143160000,143160000,286320000,1,35790000
nn_kernel_cpu,22380,0,1,1,64,0,0,0,0,1,35800000
nn_kernel_gpu,2165,1,1,279688,128,0,0,0,0,1,35800000
nn_kernel_gpu_mem,47621,1,1,279688,128,286400000,143200000,143200000,286400000,1,35800000
nn_kernel_cpu,3928,0,1,1,64,0,0,0,0,1,3580000
nn_kernel_gpu,276,1,1,27969,128,0,0,0,0,1,3580000
nn_kernel_gpu_mem,5572,1,1,27969,128,28640000,14320000,14320000,28640000,1,3580000
nn_kernel_cpu,16676,0,1,1,64,0,0,0,0,1,35810000
nn_kernel_gpu,2099,1,1,279766,128,0,0,0,0,1,35810000
nn_kernel_gpu_mem,45132,1,1,279766,128,286480000,143240000,143240000,286480000,1,35810000
nn_kernel_cpu,14315,0,1,1,64,0,0,0,0,1,35820000
nn_kernel_gpu,2121,1,1,279844,128,0,0,0,0,1,35820000
nn_kernel_gpu_mem,44808,1,1,279844,128,286560000,143280000,143280000,286560000,1,35820000
nn_kernel_cpu,25969,0,1,1,64,0,0,0,0,1,35830000
nn_kernel_gpu,2133,1,1,279922,128,0,0,0,0,1,35830000
nn_kernel_gpu_mem,52663,1,1,279922,128,286640000,143320000,143320000,286640000,1,35830000
nn_kernel_cpu,11922,0,1,1,64,0,0,0,0,1,35840000
nn_kernel_gpu,2138,1,1,280000,128,0,0,0,0,1,35840000
nn_kernel_gpu_mem,48306,1,1,280000,128,286720000,143360000,143360000,286720000,1,35840000
nn_kernel_cpu,20417,0,1,1,64,0,0,0,0,1,35850000
nn_kernel_gpu,2138,1,1,280079,128,0,0,0,0,1,35850000
nn_kernel_gpu_mem,55076,1,1,280079,128,286800000,143400000,143400000,286800000,1,35850000
nn_kernel_cpu,16492,0,1,1,64,0,0,0,0,1,35860000
nn_kernel_gpu,2145,1,1,280157,128,0,0,0,0,1,35860000
nn_kernel_gpu_mem,52063,1,1,280157,128,286880000,143440000,143440000,286880000,1,35860000
nn_kernel_cpu,23097,0,1,1,64,0,0,0,0,1,35870000
nn_kernel_gpu,2121,1,1,280235,128,0,0,0,0,1,35870000
nn_kernel_gpu_mem,43913,1,1,280235,128,286960000,143480000,143480000,286960000,1,35870000
nn_kernel_cpu,10254,0,1,1,64,0,0,0,0,1,35880000
nn_kernel_gpu,2119,1,1,280313,128,0,0,0,0,1,35880000
nn_kernel_gpu_mem,49891,1,1,280313,128,287040000,143520000,143520000,287040000,1,35880000
nn_kernel_cpu,24611,0,1,1,64,0,0,0,0,1,35890000
nn_kernel_gpu,2124,1,1,280391,128,0,0,0,0,1,35890000
nn_kernel_gpu_mem,45657,1,1,280391,128,287120000,143560000,143560000,287120000,1,35890000
nn_kernel_cpu,27900,0,1,1,64,0,0,0,0,1,35900000
nn_kernel_gpu,2139,1,1,280469,128,0,0,0,0,1,35900000
nn_kernel_gpu_mem,50910,1,1,280469,128,287200000,143600000,143600000,287200000,1,35900000
nn_kernel_cpu,16712,0,1,1,64,0,0,0,0,1,3590000
nn_kernel_gpu,266,1,1,28047,128,0,0,0,0,1,3590000
nn_kernel_gpu_mem,5510,1,1,28047,128,28720000,14360000,14360000,28720000,1,3590000
nn_kernel_cpu,25816,0,1,1,64,0,0,0,0,1,35910000
nn_kernel_gpu,2131,1,1,280547,128,0,0,0,0,1,35910000
nn_kernel_gpu_mem,45358,1,1,280547,128,287280000,143640000,143640000,287280000,1,35910000
nn_kernel_cpu,23123,0,1,1,64,0,0,0,0,1,35920000
nn_kernel_gpu,2128,1,1,280625,128,0,0,0,0,1,35920000
nn_kernel_gpu_mem,53098,1,1,280625,128,287360000,143680000,143680000,287360000,1,35920000
nn_kernel_cpu,7780,0,1,1,64,0,0,0,0,1,35930000
nn_kernel_gpu,2147,1,1,280704,128,0,0,0,0,1,35930000
nn_kernel_gpu_mem,54172,1,1,280704,128,287440000,143720000,143720000,287440000,1,35930000
nn_kernel_cpu,12999,0,1,1,64,0,0,0,0,1,35940000
nn_kernel_gpu,2133,1,1,280782,128,0,0,0,0,1,35940000
nn_kernel_gpu_mem,54311,1,1,280782,128,287520000,143760000,143760000,287520000,1,35940000
nn_kernel_cpu,25882,0,1,1,64,0,0,0,0,1,35950000
nn_kernel_gpu,2138,1,1,280860,128,0,0,0,0,1,35950000
nn_kernel_gpu_mem,47059,1,1,280860,128,287600000,143800000,143800000,287600000,1,35950000
nn_kernel_cpu,35722,0,1,1,64,0,0,0,0,1,35960000
nn_kernel_gpu,2133,1,1,280938,128,0,0,0,0,1,35960000
nn_kernel_gpu_mem,53971,1,1,280938,128,287680000,143840000,143840000,287680000,1,35960000
nn_kernel_cpu,25476,0,1,1,64,0,0,0,0,1,35970000
nn_kernel_gpu,2127,1,1,281016,128,0,0,0,0,1,35970000
nn_kernel_gpu_mem,43901,1,1,281016,128,287760000,143880000,143880000,287760000,1,35970000
nn_kernel_cpu,22115,0,1,1,64,0,0,0,0,1,35980000
nn_kernel_gpu,2180,1,1,281094,128,0,0,0,0,1,35980000
nn_kernel_gpu_mem,48468,1,1,281094,128,287840000,143920000,143920000,287840000,1,35980000
nn_kernel_cpu,29139,0,1,1,64,0,0,0,0,1,35990000
nn_kernel_gpu,2141,1,1,281172,128,0,0,0,0,1,35990000
nn_kernel_gpu_mem,55617,1,1,281172,128,287920000,143960000,143960000,287920000,1,35990000
nn_kernel_cpu,21000,0,1,1,64,0,0,0,0,1,36000000
nn_kernel_gpu,2145,1,1,281250,128,0,0,0,0,1,36000000
nn_kernel_gpu_mem,49774,1,1,281250,128,288000000,144000000,144000000,288000000,1,36000000
nn_kernel_cpu,23839,0,1,1,64,0,0,0,0,1,3600000
nn_kernel_gpu,270,1,1,28125,128,0,0,0,0,1,3600000
nn_kernel_gpu_mem,5545,1,1,28125,128,28800000,14400000,14400000,28800000,1,3600000
nn_kernel_cpu,1264,0,1,1,64,0,0,0,0,1,360000
nn_kernel_gpu,67,1,1,2813,128,0,0,0,0,1,360000
nn_kernel_gpu_mem,2076,1,1,2813,128,2880000,1440000,1440000,2880000,1,360000
nn_kernel_cpu,29846,0,1,1,64,0,0,0,0,1,36010000
nn_kernel_gpu,2114,1,1,281329,128,0,0,0,0,1,36010000
nn_kernel_gpu_mem,53125,1,1,281329,128,288080000,144040000,144040000,288080000,1,36010000
nn_kernel_cpu,12696,0,1,1,64,0,0,0,0,1,36020000
nn_kernel_gpu,2142,1,1,281407,128,0,0,0,0,1,36020000
nn_kernel_gpu_mem,55075,1,1,281407,128,288160000,144080000,144080000,288160000,1,36020000
nn_kernel_cpu,25521,0,1,1,64,0,0,0,0,1,36030000
nn_kernel_gpu,2156,1,1,281485,128,0,0,0,0,1,36030000
nn_kernel_gpu_mem,46512,1,1,281485,128,288240000,144120000,144120000,288240000,1,36030000
nn_kernel_cpu,21164,0,1,1,64,0,0,0,0,1,36040000
nn_kernel_gpu,2148,1,1,281563,128,0,0,0,0,1,36040000
nn_kernel_gpu_mem,55634,1,1,281563,128,288320000,144160000,144160000,288320000,1,36040000
nn_kernel_cpu,24212,0,1,1,64,0,0,0,0,1,36050000
nn_kernel_gpu,2146,1,1,281641,128,0,0,0,0,1,36050000
nn_kernel_gpu_mem,54005,1,1,281641,128,288400000,144200000,144200000,288400000,1,36050000
nn_kernel_cpu,23576,0,1,1,64,0,0,0,0,1,36060000
nn_kernel_gpu,2144,1,1,281719,128,0,0,0,0,1,36060000
nn_kernel_gpu_mem,46157,1,1,281719,128,288480000,144240000,144240000,288480000,1,36060000
nn_kernel_cpu,15714,0,1,1,64,0,0,0,0,1,36070000
nn_kernel_gpu,2137,1,1,281797,128,0,0,0,0,1,36070000
nn_kernel_gpu_mem,55023,1,1,281797,128,288560000,144280000,144280000,288560000,1,36070000
nn_kernel_cpu,25787,0,1,1,64,0,0,0,0,1,36080000
nn_kernel_gpu,2144,1,1,281875,128,0,0,0,0,1,36080000
nn_kernel_gpu_mem,45210,1,1,281875,128,288640000,144320000,144320000,288640000,1,36080000
nn_kernel_cpu,10342,0,1,1,64,0,0,0,0,1,36090000
nn_kernel_gpu,2156,1,1,281954,128,0,0,0,0,1,36090000
nn_kernel_gpu_mem,54489,1,1,281954,128,288720000,144360000,144360000,288720000,1,36090000
nn_kernel_cpu,19741,0,1,1,64,0,0,0,0,1,36100000
nn_kernel_gpu,2161,1,1,282032,128,0,0,0,0,1,36100000
nn_kernel_gpu_mem,43249,1,1,282032,128,288800000,144400000,144400000,288800000,1,36100000
nn_kernel_cpu,22418,0,1,1,64,0,0,0,0,1,3610000
nn_kernel_gpu,265,1,1,28204,128,0,0,0,0,1,3610000
nn_kernel_gpu_mem,5629,1,1,28204,128,28880000,14440000,14440000,28880000,1,3610000
nn_kernel_cpu,19843,0,1,1,64,0,0,0,0,1,36110000
nn_kernel_gpu,2157,1,1,282110,128,0,0,0,0,1,36110000
nn_kernel_gpu_mem,54213,1,1,282110,128,288880000,144440000,144440000,288880000,1,36110000
nn_kernel_cpu,15308,0,1,1,64,0,0,0,0,1,36120000
nn_kernel_gpu,2146,1,1,282188,128,0,0,0,0,1,36120000
nn_kernel_gpu_mem,46573,1,1,282188,128,288960000,144480000,144480000,288960000,1,36120000
nn_kernel_cpu,27404,0,1,1,64,0,0,0,0,1,36130000
nn_kernel_gpu,2160,1,1,282266,128,0,0,0,0,1,36130000
nn_kernel_gpu_mem,54486,1,1,282266,128,289040000,144520000,144520000,289040000,1,36130000
nn_kernel_cpu,21697,0,1,1,64,0,0,0,0,1,36140000
nn_kernel_gpu,2163,1,1,282344,128,0,0,0,0,1,36140000
nn_kernel_gpu_mem,55255,1,1,282344,128,289120000,144560000,144560000,289120000,1,36140000
nn_kernel_cpu,28828,0,1,1,64,0,0,0,0,1,36150000
nn_kernel_gpu,2156,1,1,282422,128,0,0,0,0,1,36150000
nn_kernel_gpu_mem,45993,1,1,282422,128,289200000,144600000,144600000,289200000,1,36150000
nn_kernel_cpu,11000,0,1,1,64,0,0,0,0,1,36160000
nn_kernel_gpu,2165,1,1,282500,128,0,0,0,0,1,36160000
nn_kernel_gpu_mem,54477,1,1,282500,128,289280000,144640000,144640000,289280000,1,36160000
nn_kernel_cpu,25410,0,1,1,64,0,0,0,0,1,36170000
nn_kernel_gpu,2153,1,1,282579,128,0,0,0,0,1,36170000
nn_kernel_gpu_mem,46696,1,1,282579,128,289360000,144680000,144680000,289360000,1,36170000
nn_kernel_cpu,20029,0,1,1,64,0,0,0,0,1,36180000
nn_kernel_gpu,2198,1,1,282657,128,0,0,0,0,1,36180000
nn_kernel_gpu_mem,47547,1,1,282657,128,289440000,144720000,144720000,289440000,1,36180000
nn_kernel_cpu,27524,0,1,1,64,0,0,0,0,1,36190000
nn_kernel_gpu,2162,1,1,282735,128,0,0,0,0,1,36190000
nn_kernel_gpu_mem,54738,1,1,282735,128,289520000,144760000,144760000,289520000,1,36190000
nn_kernel_cpu,30943,0,1,1,64,0,0,0,0,1,36200000
nn_kernel_gpu,2164,1,1,282813,128,0,0,0,0,1,36200000
nn_kernel_gpu_mem,54664,1,1,282813,128,289600000,144800000,144800000,289600000,1,36200000
nn_kernel_cpu,19387,0,1,1,64,0,0,0,0,1,3620000
nn_kernel_gpu,271,1,1,28282,128,0,0,0,0,1,3620000
nn_kernel_gpu_mem,5519,1,1,28282,128,28960000,14480000,14480000,28960000,1,3620000
nn_kernel_cpu,27279,0,1,1,64,0,0,0,0,1,36210000
nn_kernel_gpu,2134,1,1,282891,128,0,0,0,0,1,36210000
nn_kernel_gpu_mem,47323,1,1,282891,128,289680000,144840000,144840000,289680000,1,36210000
nn_kernel_cpu,15108,0,1,1,64,0,0,0,0,1,36220000
nn_kernel_gpu,2152,1,1,282969,128,0,0,0,0,1,36220000
nn_kernel_gpu_mem,55866,1,1,282969,128,289760000,144880000,144880000,289760000,1,36220000
nn_kernel_cpu,27470,0,1,1,64,0,0,0,0,1,36230000
nn_kernel_gpu,2168,1,1,283047,128,0,0,0,0,1,36230000
nn_kernel_gpu_mem,54581,1,1,283047,128,289840000,144920000,144920000,289840000,1,36230000
nn_kernel_cpu,20728,0,1,1,64,0,0,0,0,1,36240000
nn_kernel_gpu,2166,1,1,283125,128,0,0,0,0,1,36240000
nn_kernel_gpu_mem,55259,1,1,283125,128,289920000,144960000,144960000,289920000,1,36240000
nn_kernel_cpu,26043,0,1,1,64,0,0,0,0,1,36250000
nn_kernel_gpu,2148,1,1,283204,128,0,0,0,0,1,36250000
nn_kernel_gpu_mem,49478,1,1,283204,128,290000000,145000000,145000000,290000000,1,36250000
nn_kernel_cpu,33704,0,1,1,64,0,0,0,0,1,36260000
nn_kernel_gpu,2162,1,1,283282,128,0,0,0,0,1,36260000
nn_kernel_gpu_mem,52269,1,1,283282,128,290080000,145040000,145040000,290080000,1,36260000
nn_kernel_cpu,15938,0,1,1,64,0,0,0,0,1,36270000
nn_kernel_gpu,2154,1,1,283360,128,0,0,0,0,1,36270000
nn_kernel_gpu_mem,47093,1,1,283360,128,290160000,145080000,145080000,290160000,1,36270000
nn_kernel_cpu,24808,0,1,1,64,0,0,0,0,1,36280000
nn_kernel_gpu,2168,1,1,283438,128,0,0,0,0,1,36280000
nn_kernel_gpu_mem,54511,1,1,283438,128,290240000,145120000,145120000,290240000,1,36280000
nn_kernel_cpu,10199,0,1,1,64,0,0,0,0,1,36290000
nn_kernel_gpu,2164,1,1,283516,128,0,0,0,0,1,36290000
nn_kernel_gpu_mem,52774,1,1,283516,128,290320000,145160000,145160000,290320000,1,36290000
nn_kernel_cpu,17755,0,1,1,64,0,0,0,0,1,36300000
nn_kernel_gpu,2161,1,1,283594,128,0,0,0,0,1,36300000
nn_kernel_gpu_mem,52673,1,1,283594,128,290400000,145200000,145200000,290400000,1,36300000
nn_kernel_cpu,12995,0,1,1,64,0,0,0,0,1,3630000
nn_kernel_gpu,252,1,1,28360,128,0,0,0,0,1,3630000
nn_kernel_gpu_mem,4891,1,1,28360,128,29040000,14520000,14520000,29040000,1,3630000
nn_kernel_cpu,27309,0,1,1,64,0,0,0,0,1,36310000
nn_kernel_gpu,2151,1,1,283672,128,0,0,0,0,1,36310000
nn_kernel_gpu_mem,55167,1,1,283672,128,290480000,145240000,145240000,290480000,1,36310000
nn_kernel_cpu,17368,0,1,1,64,0,0,0,0,1,36320000
nn_kernel_gpu,2150,1,1,283750,128,0,0,0,0,1,36320000
nn_kernel_gpu_mem,56318,1,1,283750,128,290560000,145280000,145280000,290560000,1,36320000
nn_kernel_cpu,22335,0,1,1,64,0,0,0,0,1,36330000
nn_kernel_gpu,2167,1,1,283829,128,0,0,0,0,1,36330000
nn_kernel_gpu_mem,46838,1,1,283829,128,290640000,145320000,145320000,290640000,1,36330000
nn_kernel_cpu,17703,0,1,1,64,0,0,0,0,1,36340000
nn_kernel_gpu,2153,1,1,283907,128,0,0,0,0,1,36340000
nn_kernel_gpu_mem,51094,1,1,283907,128,290720000,145360000,145360000,290720000,1,36340000
nn_kernel_cpu,13523,0,1,1,64,0,0,0,0,1,36350000
nn_kernel_gpu,2168,1,1,283985,128,0,0,0,0,1,36350000
nn_kernel_gpu_mem,46571,1,1,283985,128,290800000,145400000,145400000,290800000,1,36350000
nn_kernel_cpu,26723,0,1,1,64,0,0,0,0,1,36360000
nn_kernel_gpu,2197,1,1,284063,128,0,0,0,0,1,36360000
nn_kernel_gpu_mem,55046,1,1,284063,128,290880000,145440000,145440000,290880000,1,36360000
nn_kernel_cpu,27705,0,1,1,64,0,0,0,0,1,36370000
nn_kernel_gpu,2179,1,1,284141,128,0,0,0,0,1,36370000
nn_kernel_gpu_mem,53621,1,1,284141,128,290960000,145480000,145480000,290960000,1,36370000
nn_kernel_cpu,9966,0,1,1,64,0,0,0,0,1,36380000
nn_kernel_gpu,2140,1,1,284219,128,0,0,0,0,1,36380000
nn_kernel_gpu_mem,61779,1,1,284219,128,291040000,145520000,145520000,291040000,1,36380000
nn_kernel_cpu,30725,0,1,1,64,0,0,0,0,1,36390000
nn_kernel_gpu,2188,1,1,284297,128,0,0,0,0,1,36390000
nn_kernel_gpu_mem,42724,1,1,284297,128,291120000,145560000,145560000,291120000,1,36390000
nn_kernel_cpu,14564,0,1,1,64,0,0,0,0,1,36400000
nn_kernel_gpu,2169,1,1,284375,128,0,0,0,0,1,36400000
nn_kernel_gpu_mem,58088,1,1,284375,128,291200000,145600000,145600000,291200000,1,36400000
nn_kernel_cpu,13169,0,1,1,64,0,0,0,0,1,3640000
nn_kernel_gpu,269,1,1,28438,128,0,0,0,0,1,3640000
nn_kernel_gpu_mem,5583,1,1,28438,128,29120000,14560000,14560000,29120000,1,3640000
nn_kernel_cpu,20427,0,1,1,64,0,0,0,0,1,36410000
nn_kernel_gpu,2162,1,1,284454,128,0,0,0,0,1,36410000
nn_kernel_gpu_mem,44359,1,1,284454,128,291280000,145640000,145640000,291280000,1,36410000
nn_kernel_cpu,15484,0,1,1,64,0,0,0,0,1,36420000
nn_kernel_gpu,2168,1,1,284532,128,0,0,0,0,1,36420000
nn_kernel_gpu_mem,54526,1,1,284532,128,291360000,145680000,145680000,291360000,1,36420000
nn_kernel_cpu,38310,0,1,1,64,0,0,0,0,1,36430000
nn_kernel_gpu,2166,1,1,284610,128,0,0,0,0,1,36430000
nn_kernel_gpu_mem,54766,1,1,284610,128,291440000,145720000,145720000,291440000,1,36430000
nn_kernel_cpu,23604,0,1,1,64,0,0,0,0,1,36440000
nn_kernel_gpu,2159,1,1,284688,128,0,0,0,0,1,36440000
nn_kernel_gpu_mem,45107,1,1,284688,128,291520000,145760000,145760000,291520000,1,36440000
nn_kernel_cpu,14806,0,1,1,64,0,0,0,0,1,36450000
nn_kernel_gpu,2151,1,1,284766,128,0,0,0,0,1,36450000
nn_kernel_gpu_mem,44167,1,1,284766,128,291600000,145800000,145800000,291600000,1,36450000
nn_kernel_cpu,14472,0,1,1,64,0,0,0,0,1,36460000
nn_kernel_gpu,2168,1,1,284844,128,0,0,0,0,1,36460000
nn_kernel_gpu_mem,54938,1,1,284844,128,291680000,145840000,145840000,291680000,1,36460000
nn_kernel_cpu,25654,0,1,1,64,0,0,0,0,1,36470000
nn_kernel_gpu,2161,1,1,284922,128,0,0,0,0,1,36470000
nn_kernel_gpu_mem,46410,1,1,284922,128,291760000,145880000,145880000,291760000,1,36470000
nn_kernel_cpu,25720,0,1,1,64,0,0,0,0,1,36480000
nn_kernel_gpu,2172,1,1,285000,128,0,0,0,0,1,36480000
nn_kernel_gpu_mem,52499,1,1,285000,128,291840000,145920000,145920000,291840000,1,36480000
nn_kernel_cpu,29164,0,1,1,64,0,0,0,0,1,36490000
nn_kernel_gpu,2166,1,1,285079,128,0,0,0,0,1,36490000
nn_kernel_gpu_mem,56549,1,1,285079,128,291920000,145960000,145960000,291920000,1,36490000
nn_kernel_cpu,20100,0,1,1,64,0,0,0,0,1,36500000
nn_kernel_gpu,2162,1,1,285157,128,0,0,0,0,1,36500000
nn_kernel_gpu_mem,45128,1,1,285157,128,292000000,146000000,146000000,292000000,1,36500000
nn_kernel_cpu,5958,0,1,1,64,0,0,0,0,1,3650000
nn_kernel_gpu,281,1,1,28516,128,0,0,0,0,1,3650000
nn_kernel_gpu_mem,5708,1,1,28516,128,29200000,14600000,14600000,29200000,1,3650000
nn_kernel_cpu,15270,0,1,1,64,0,0,0,0,1,36510000
nn_kernel_gpu,2179,1,1,285235,128,0,0,0,0,1,36510000
nn_kernel_gpu_mem,53084,1,1,285235,128,292080000,146040000,146040000,292080000,1,36510000
nn_kernel_cpu,20089,0,1,1,64,0,0,0,0,1,36520000
nn_kernel_gpu,2183,1,1,285313,128,0,0,0,0,1,36520000
nn_kernel_gpu_mem,54713,1,1,285313,128,292160000,146080000,146080000,292160000,1,36520000
nn_kernel_cpu,21234,0,1,1,64,0,0,0,0,1,36530000
nn_kernel_gpu,2176,1,1,285391,128,0,0,0,0,1,36530000
nn_kernel_gpu_mem,54457,1,1,285391,128,292240000,146120000,146120000,292240000,1,36530000
nn_kernel_cpu,35629,0,1,1,64,0,0,0,0,1,36540000
nn_kernel_gpu,2187,1,1,285469,128,0,0,0,0,1,36540000
nn_kernel_gpu_mem,48009,1,1,285469,128,292320000,146160000,146160000,292320000,1,36540000
nn_kernel_cpu,29095,0,1,1,64,0,0,0,0,1,36550000
nn_kernel_gpu,2182,1,1,285547,128,0,0,0,0,1,36550000
nn_kernel_gpu_mem,44643,1,1,285547,128,292400000,146200000,146200000,292400000,1,36550000
nn_kernel_cpu,22701,0,1,1,64,0,0,0,0,1,36560000
nn_kernel_gpu,2147,1,1,285625,128,0,0,0,0,1,36560000
nn_kernel_gpu_mem,47350,1,1,285625,128,292480000,146240000,146240000,292480000,1,36560000
nn_kernel_cpu,17398,0,1,1,64,0,0,0,0,1,36570000
nn_kernel_gpu,2200,1,1,285704,128,0,0,0,0,1,36570000
nn_kernel_gpu_mem,53205,1,1,285704,128,292560000,146280000,146280000,292560000,1,36570000
nn_kernel_cpu,13410,0,1,1,64,0,0,0,0,1,36580000
nn_kernel_gpu,2172,1,1,285782,128,0,0,0,0,1,36580000
nn_kernel_gpu_mem,54164,1,1,285782,128,292640000,146320000,146320000,292640000,1,36580000
nn_kernel_cpu,26125,0,1,1,64,0,0,0,0,1,36590000
nn_kernel_gpu,2184,1,1,285860,128,0,0,0,0,1,36590000
nn_kernel_gpu_mem,54435,1,1,285860,128,292720000,146360000,146360000,292720000,1,36590000
nn_kernel_cpu,8718,0,1,1,64,0,0,0,0,1,36600000
nn_kernel_gpu,2184,1,1,285938,128,0,0,0,0,1,36600000
nn_kernel_gpu_mem,47854,1,1,285938,128,292800000,146400000,146400000,292800000,1,36600000
nn_kernel_cpu,28439,0,1,1,64,0,0,0,0,1,3660000
nn_kernel_gpu,268,1,1,28594,128,0,0,0,0,1,3660000
nn_kernel_gpu_mem,6164,1,1,28594,128,29280000,14640000,14640000,29280000,1,3660000
nn_kernel_cpu,30409,0,1,1,64,0,0,0,0,1,36610000
nn_kernel_gpu,2163,1,1,286016,128,0,0,0,0,1,36610000
nn_kernel_gpu_mem,55122,1,1,286016,128,292880000,146440000,146440000,292880000,1,36610000
nn_kernel_cpu,16382,0,1,1,64,0,0,0,0,1,36620000
nn_kernel_gpu,2175,1,1,286094,128,0,0,0,0,1,36620000
nn_kernel_gpu_mem,54665,1,1,286094,128,292960000,146480000,146480000,292960000,1,36620000
nn_kernel_cpu,14682,0,1,1,64,0,0,0,0,1,36630000
nn_kernel_gpu,2170,1,1,286172,128,0,0,0,0,1,36630000
nn_kernel_gpu_mem,47313,1,1,286172,128,293040000,146520000,146520000,293040000,1,36630000
nn_kernel_cpu,16573,0,1,1,64,0,0,0,0,1,36640000
nn_kernel_gpu,2183,1,1,286250,128,0,0,0,0,1,36640000
nn_kernel_gpu_mem,55282,1,1,286250,128,293120000,146560000,146560000,293120000,1,36640000
nn_kernel_cpu,44140,0,1,1,64,0,0,0,0,1,36650000
nn_kernel_gpu,2191,1,1,286329,128,0,0,0,0,1,36650000
nn_kernel_gpu_mem,54362,1,1,286329,128,293200000,146600000,146600000,293200000,1,36650000
nn_kernel_cpu,21374,0,1,1,64,0,0,0,0,1,36660000
nn_kernel_gpu,2201,1,1,286407,128,0,0,0,0,1,36660000
nn_kernel_gpu_mem,54734,1,1,286407,128,293280000,146640000,146640000,293280000,1,36660000
nn_kernel_cpu,20332,0,1,1,64,0,0,0,0,1,36670000
nn_kernel_gpu,2181,1,1,286485,128,0,0,0,0,1,36670000
nn_kernel_gpu_mem,42560,1,1,286485,128,293360000,146680000,146680000,293360000,1,36670000
nn_kernel_cpu,14353,0,1,1,64,0,0,0,0,1,36680000
nn_kernel_gpu,2184,1,1,286563,128,0,0,0,0,1,36680000
nn_kernel_gpu_mem,52967,1,1,286563,128,293440000,146720000,146720000,293440000,1,36680000
nn_kernel_cpu,13792,0,1,1,64,0,0,0,0,1,36690000
nn_kernel_gpu,2178,1,1,286641,128,0,0,0,0,1,36690000
nn_kernel_gpu_mem,49239,1,1,286641,128,293520000,146760000,146760000,293520000,1,36690000
nn_kernel_cpu,31562,0,1,1,64,0,0,0,0,1,36700000
nn_kernel_gpu,2163,1,1,286719,128,0,0,0,0,1,36700000
nn_kernel_gpu_mem,44323,1,1,286719,128,293600000,146800000,146800000,293600000,1,36700000
nn_kernel_cpu,5964,0,1,1,64,0,0,0,0,1,3670000
nn_kernel_gpu,258,1,1,28672,128,0,0,0,0,1,3670000
nn_kernel_gpu_mem,5590,1,1,28672,128,29360000,14680000,14680000,29360000,1,3670000
nn_kernel_cpu,28494,0,1,1,64,0,0,0,0,1,36710000
nn_kernel_gpu,2167,1,1,286797,128,0,0,0,0,1,36710000
nn_kernel_gpu_mem,46640,1,1,286797,128,293680000,146840000,146840000,293680000,1,36710000
nn_kernel_cpu,21391,0,1,1,64,0,0,0,0,1,36720000
nn_kernel_gpu,2188,1,1,286875,128,0,0,0,0,1,36720000
nn_kernel_gpu_mem,55892,1,1,286875,128,293760000,146880000,146880000,293760000,1,36720000
nn_kernel_cpu,27572,0,1,1,64,0,0,0,0,1,36730000
nn_kernel_gpu,2178,1,1,286954,128,0,0,0,0,1,36730000
nn_kernel_gpu_mem,48119,1,1,286954,128,293840000,146920000,146920000,293840000,1,36730000
nn_kernel_cpu,12868,0,1,1,64,0,0,0,0,1,36740000
nn_kernel_gpu,2181,1,1,287032,128,0,0,0,0,1,36740000
nn_kernel_gpu_mem,55260,1,1,287032,128,293920000,146960000,146960000,293920000,1,36740000
nn_kernel_cpu,28068,0,1,1,64,0,0,0,0,1,36750000
nn_kernel_gpu,2169,1,1,287110,128,0,0,0,0,1,36750000
nn_kernel_gpu_mem,49424,1,1,287110,128,294000000,147000000,147000000,294000000,1,36750000
nn_kernel_cpu,14812,0,1,1,64,0,0,0,0,1,36760000
nn_kernel_gpu,2192,1,1,287188,128,0,0,0,0,1,36760000
nn_kernel_gpu_mem,49599,1,1,287188,128,294080000,147040000,147040000,294080000,1,36760000
nn_kernel_cpu,18676,0,1,1,64,0,0,0,0,1,36770000
nn_kernel_gpu,2173,1,1,287266,128,0,0,0,0,1,36770000
nn_kernel_gpu_mem,55226,1,1,287266,128,294160000,147080000,147080000,294160000,1,36770000
nn_kernel_cpu,22692,0,1,1,64,0,0,0,0,1,36780000
nn_kernel_gpu,2180,1,1,287344,128,0,0,0,0,1,36780000
nn_kernel_gpu_mem,45730,1,1,287344,128,294240000,147120000,147120000,294240000,1,36780000
nn_kernel_cpu,23878,0,1,1,64,0,0,0,0,1,36790000
nn_kernel_gpu,2174,1,1,287422,128,0,0,0,0,1,36790000
nn_kernel_gpu_mem,44921,1,1,287422,128,294320000,147160000,147160000,294320000,1,36790000
nn_kernel_cpu,14266,0,1,1,64,0,0,0,0,1,36800000
nn_kernel_gpu,2196,1,1,287500,128,0,0,0,0,1,36800000
nn_kernel_gpu_mem,62722,1,1,287500,128,294400000,147200000,147200000,294400000,1,36800000
nn_kernel_cpu,23343,0,1,1,64,0,0,0,0,1,3680000
nn_kernel_gpu,280,1,1,28750,128,0,0,0,0,1,3680000
nn_kernel_gpu_mem,5539,1,1,28750,128,29440000,14720000,14720000,29440000,1,3680000
nn_kernel_cpu,13910,0,1,1,64,0,0,0,0,1,36810000
nn_kernel_gpu,2192,1,1,287579,128,0,0,0,0,1,36810000
nn_kernel_gpu_mem,55124,1,1,287579,128,294480000,147240000,147240000,294480000,1,36810000
nn_kernel_cpu,16793,0,1,1,64,0,0,0,0,1,36820000
nn_kernel_gpu,2203,1,1,287657,128,0,0,0,0,1,36820000
nn_kernel_gpu_mem,55130,1,1,287657,128,294560000,147280000,147280000,294560000,1,36820000
nn_kernel_cpu,26035,0,1,1,64,0,0,0,0,1,36830000
nn_kernel_gpu,2180,1,1,287735,128,0,0,0,0,1,36830000
nn_kernel_gpu_mem,56991,1,1,287735,128,294640000,147320000,147320000,294640000,1,36830000
nn_kernel_cpu,29866,0,1,1,64,0,0,0,0,1,36840000
nn_kernel_gpu,2240,1,1,287813,128,0,0,0,0,1,36840000
nn_kernel_gpu_mem,44160,1,1,287813,128,294720000,147360000,147360000,294720000,1,36840000
nn_kernel_cpu,15733,0,1,1,64,0,0,0,0,1,36850000
nn_kernel_gpu,2176,1,1,287891,128,0,0,0,0,1,36850000
nn_kernel_gpu_mem,54475,1,1,287891,128,294800000,147400000,147400000,294800000,1,36850000
nn_kernel_cpu,20309,0,1,1,64,0,0,0,0,1,36860000
nn_kernel_gpu,2167,1,1,287969,128,0,0,0,0,1,36860000
nn_kernel_gpu_mem,49728,1,1,287969,128,294880000,147440000,147440000,294880000,1,36860000
nn_kernel_cpu,23078,0,1,1,64,0,0,0,0,1,36870000
nn_kernel_gpu,2191,1,1,288047,128,0,0,0,0,1,36870000
nn_kernel_gpu_mem,42424,1,1,288047,128,294960000,147480000,147480000,294960000,1,36870000
nn_kernel_cpu,27565,0,1,1,64,0,0,0,0,1,36880000
nn_kernel_gpu,2246,1,1,288125,128,0,0,0,0,1,36880000
nn_kernel_gpu_mem,52347,1,1,288125,128,295040000,147520000,147520000,295040000,1,36880000
nn_kernel_cpu,18400,0,1,1,64,0,0,0,0,1,36890000
nn_kernel_gpu,2203,1,1,288204,128,0,0,0,0,1,36890000
nn_kernel_gpu_mem,56225,1,1,288204,128,295120000,147560000,147560000,295120000,1,36890000
nn_kernel_cpu,33301,0,1,1,64,0,0,0,0,1,36900000
nn_kernel_gpu,2192,1,1,288282,128,0,0,0,0,1,36900000
nn_kernel_gpu_mem,47827,1,1,288282,128,295200000,147600000,147600000,295200000,1,36900000
nn_kernel_cpu,19387,0,1,1,64,0,0,0,0,1,3690000
nn_kernel_gpu,275,1,1,28829,128,0,0,0,0,1,3690000
nn_kernel_gpu_mem,4886,1,1,28829,128,29520000,14760000,14760000,29520000,1,3690000
nn_kernel_cpu,16621,0,1,1,64,0,0,0,0,1,36910000
nn_kernel_gpu,2195,1,1,288360,128,0,0,0,0,1,36910000
nn_kernel_gpu_mem,46911,1,1,288360,128,295280000,147640000,147640000,295280000,1,36910000
nn_kernel_cpu,38739,0,1,1,64,0,0,0,0,1,36920000
nn_kernel_gpu,2216,1,1,288438,128,0,0,0,0,1,36920000
nn_kernel_gpu_mem,55198,1,1,288438,128,295360000,147680000,147680000,295360000,1,36920000
nn_kernel_cpu,25613,0,1,1,64,0,0,0,0,1,36930000
nn_kernel_gpu,2206,1,1,288516,128,0,0,0,0,1,36930000
nn_kernel_gpu_mem,54052,1,1,288516,128,295440000,147720000,147720000,295440000,1,36930000
nn_kernel_cpu,25495,0,1,1,64,0,0,0,0,1,36940000
nn_kernel_gpu,2193,1,1,288594,128,0,0,0,0,1,36940000
nn_kernel_gpu_mem,54303,1,1,288594,128,295520000,147760000,147760000,295520000,1,36940000
nn_kernel_cpu,15177,0,1,1,64,0,0,0,0,1,36950000
nn_kernel_gpu,2198,1,1,288672,128,0,0,0,0,1,36950000
nn_kernel_gpu_mem,45503,1,1,288672,128,295600000,147800000,147800000,295600000,1,36950000
nn_kernel_cpu,26738,0,1,1,64,0,0,0,0,1,36960000
nn_kernel_gpu,2202,1,1,288750,128,0,0,0,0,1,36960000
nn_kernel_gpu_mem,55204,1,1,288750,128,295680000,147840000,147840000,295680000,1,36960000
nn_kernel_cpu,23058,0,1,1,64,0,0,0,0,1,36970000
nn_kernel_gpu,2212,1,1,288829,128,0,0,0,0,1,36970000
nn_kernel_gpu_mem,54451,1,1,288829,128,295760000,147880000,147880000,295760000,1,36970000
nn_kernel_cpu,32160,0,1,1,64,0,0,0,0,1,36980000
nn_kernel_gpu,2205,1,1,288907,128,0,0,0,0,1,36980000
nn_kernel_gpu_mem,47686,1,1,288907,128,295840000,147920000,147920000,295840000,1,36980000
nn_kernel_cpu,14128,0,1,1,64,0,0,0,0,1,36990000
nn_kernel_gpu,2213,1,1,288985,128,0,0,0,0,1,36990000
nn_kernel_gpu_mem,55726,1,1,288985,128,295920000,147960000,147960000,295920000,1,36990000
nn_kernel_cpu,30738,0,1,1,64,0,0,0,0,1,37000000
nn_kernel_gpu,2219,1,1,289063,128,0,0,0,0,1,37000000
nn_kernel_gpu_mem,55787,1,1,289063,128,296000000,148000000,148000000,296000000,1,37000000
nn_kernel_cpu,4310,0,1,1,64,0,0,0,0,1,3700000
nn_kernel_gpu,269,1,1,28907,128,0,0,0,0,1,3700000
nn_kernel_gpu_mem,6463,1,1,28907,128,29600000,14800000,14800000,29600000,1,3700000
nn_kernel_cpu,713,0,1,1,64,0,0,0,0,1,370000
nn_kernel_gpu,72,1,1,2891,128,0,0,0,0,1,370000
nn_kernel_gpu_mem,1391,1,1,2891,128,2960000,1480000,1480000,2960000,1,370000
nn_kernel_cpu,32677,0,1,1,64,0,0,0,0,1,37010000
nn_kernel_gpu,2213,1,1,289141,128,0,0,0,0,1,37010000
nn_kernel_gpu_mem,56857,1,1,289141,128,296080000,148040000,148040000,296080000,1,37010000
nn_kernel_cpu,41743,0,1,1,64,0,0,0,0,1,37020000
nn_kernel_gpu,2212,1,1,289219,128,0,0,0,0,1,37020000
nn_kernel_gpu_mem,59522,1,1,289219,128,296160000,148080000,148080000,296160000,1,37020000
nn_kernel_cpu,25500,0,1,1,64,0,0,0,0,1,37030000
nn_kernel_gpu,2211,1,1,289297,128,0,0,0,0,1,37030000
nn_kernel_gpu_mem,56429,1,1,289297,128,296240000,148120000,148120000,296240000,1,37030000
nn_kernel_cpu,13573,0,1,1,64,0,0,0,0,1,37040000
nn_kernel_gpu,2199,1,1,289375,128,0,0,0,0,1,37040000
nn_kernel_gpu_mem,55126,1,1,289375,128,296320000,148160000,148160000,296320000,1,37040000
nn_kernel_cpu,24644,0,1,1,64,0,0,0,0,1,37050000
nn_kernel_gpu,2203,1,1,289454,128,0,0,0,0,1,37050000
nn_kernel_gpu_mem,55607,1,1,289454,128,296400000,148200000,148200000,296400000,1,37050000
nn_kernel_cpu,16058,0,1,1,64,0,0,0,0,1,37060000
nn_kernel_gpu,2215,1,1,289532,128,0,0,0,0,1,37060000
nn_kernel_gpu_mem,55611,1,1,289532,128,296480000,148240000,148240000,296480000,1,37060000
nn_kernel_cpu,28501,0,1,1,64,0,0,0,0,1,37070000
nn_kernel_gpu,2214,1,1,289610,128,0,0,0,0,1,37070000
nn_kernel_gpu_mem,47656,1,1,289610,128,296560000,148280000,148280000,296560000,1,37070000
nn_kernel_cpu,15687,0,1,1,64,0,0,0,0,1,37080000
nn_kernel_gpu,2207,1,1,289688,128,0,0,0,0,1,37080000
nn_kernel_gpu_mem,55573,1,1,289688,128,296640000,148320000,148320000,296640000,1,37080000
nn_kernel_cpu,22811,0,1,1,64,0,0,0,0,1,37090000
nn_kernel_gpu,2224,1,1,289766,128,0,0,0,0,1,37090000
nn_kernel_gpu_mem,55694,1,1,289766,128,296720000,148360000,148360000,296720000,1,37090000
nn_kernel_cpu,15772,0,1,1,64,0,0,0,0,1,37100000
nn_kernel_gpu,2201,1,1,289844,128,0,0,0,0,1,37100000
nn_kernel_gpu_mem,47602,1,1,289844,128,296800000,148400000,148400000,296800000,1,37100000
nn_kernel_cpu,8173,0,1,1,64,0,0,0,0,1,3710000
nn_kernel_gpu,257,1,1,28985,128,0,0,0,0,1,3710000
nn_kernel_gpu_mem,8794,1,1,28985,128,29680000,14840000,14840000,29680000,1,3710000
nn_kernel_cpu,38142,0,1,1,64,0,0,0,0,1,37110000
nn_kernel_gpu,2221,1,1,289922,128,0,0,0,0,1,37110000
nn_kernel_gpu_mem,54730,1,1,289922,128,296880000,148440000,148440000,296880000,1,37110000
nn_kernel_cpu,16777,0,1,1,64,0,0,0,0,1,37120000
nn_kernel_gpu,2217,1,1,290000,128,0,0,0,0,1,37120000
nn_kernel_gpu_mem,55297,1,1,290000,128,296960000,148480000,148480000,296960000,1,37120000
nn_kernel_cpu,32718,0,1,1,64,0,0,0,0,1,37130000
nn_kernel_gpu,2220,1,1,290079,128,0,0,0,0,1,37130000
nn_kernel_gpu_mem,49510,1,1,290079,128,297040000,148520000,148520000,297040000,1,37130000
nn_kernel_cpu,22007,0,1,1,64,0,0,0,0,1,37140000
nn_kernel_gpu,2193,1,1,290157,128,0,0,0,0,1,37140000
nn_kernel_gpu_mem,46059,1,1,290157,128,297120000,148560000,148560000,297120000,1,37140000
nn_kernel_cpu,19279,0,1,1,64,0,0,0,0,1,37150000
nn_kernel_gpu,2223,1,1,290235,128,0,0,0,0,1,37150000
nn_kernel_gpu_mem,50341,1,1,290235,128,297200000,148600000,148600000,297200000,1,37150000
nn_kernel_cpu,16235,0,1,1,64,0,0,0,0,1,37160000
nn_kernel_gpu,2264,1,1,290313,128,0,0,0,0,1,37160000
nn_kernel_gpu_mem,46579,1,1,290313,128,297280000,148640000,148640000,297280000,1,37160000
nn_kernel_cpu,22775,0,1,1,64,0,0,0,0,1,37170000
nn_kernel_gpu,2221,1,1,290391,128,0,0,0,0,1,37170000
nn_kernel_gpu_mem,49983,1,1,290391,128,297360000,148680000,148680000,297360000,1,37170000
nn_kernel_cpu,24358,0,1,1,64,0,0,0,0,1,37180000
nn_kernel_gpu,2213,1,1,290469,128,0,0,0,0,1,37180000
nn_kernel_gpu_mem,56646,1,1,290469,128,297440000,148720000,148720000,297440000,1,37180000
nn_kernel_cpu,15937,0,1,1,64,0,0,0,0,1,37190000
nn_kernel_gpu,2215,1,1,290547,128,0,0,0,0,1,37190000
nn_kernel_gpu_mem,48422,1,1,290547,128,297520000,148760000,148760000,297520000,1,37190000
nn_kernel_cpu,22026,0,1,1,64,0,0,0,0,1,37200000
nn_kernel_gpu,2220,1,1,290625,128,0,0,0,0,1,37200000
nn_kernel_gpu_mem,56448,1,1,290625,128,297600000,148800000,148800000,297600000,1,37200000
nn_kernel_cpu,17638,0,1,1,64,0,0,0,0,1,3720000
nn_kernel_gpu,270,1,1,29063,128,0,0,0,0,1,3720000
nn_kernel_gpu_mem,6159,1,1,29063,128,29760000,14880000,14880000,29760000,1,3720000
nn_kernel_cpu,27622,0,1,1,64,0,0,0,0,1,37210000
nn_kernel_gpu,2254,1,1,290704,128,0,0,0,0,1,37210000
nn_kernel_gpu_mem,49593,1,1,290704,128,297680000,148840000,148840000,297680000,1,37210000
nn_kernel_cpu,23181,0,1,1,64,0,0,0,0,1,37220000
nn_kernel_gpu,2247,1,1,290782,128,0,0,0,0,1,37220000
nn_kernel_gpu_mem,45542,1,1,290782,128,297760000,148880000,148880000,297760000,1,37220000
nn_kernel_cpu,32307,0,1,1,64,0,0,0,0,1,37230000
nn_kernel_gpu,2193,1,1,290860,128,0,0,0,0,1,37230000
nn_kernel_gpu_mem,48531,1,1,290860,128,297840000,148920000,148920000,297840000,1,37230000
nn_kernel_cpu,29943,0,1,1,64,0,0,0,0,1,37240000
nn_kernel_gpu,2221,1,1,290938,128,0,0,0,0,1,37240000
nn_kernel_gpu_mem,49181,1,1,290938,128,297920000,148960000,148960000,297920000,1,37240000
nn_kernel_cpu,56728,0,1,1,64,0,0,0,0,1,37250000
nn_kernel_gpu,2208,1,1,291016,128,0,0,0,0,1,37250000
nn_kernel_gpu_mem,46126,1,1,291016,128,298000000,149000000,149000000,298000000,1,37250000
nn_kernel_cpu,10943,0,1,1,64,0,0,0,0,1,37260000
nn_kernel_gpu,2219,1,1,291094,128,0,0,0,0,1,37260000
nn_kernel_gpu_mem,49630,1,1,291094,128,298080000,149040000,149040000,298080000,1,37260000
nn_kernel_cpu,27519,0,1,1,64,0,0,0,0,1,37270000
nn_kernel_gpu,2209,1,1,291172,128,0,0,0,0,1,37270000
nn_kernel_gpu_mem,56493,1,1,291172,128,298160000,149080000,149080000,298160000,1,37270000
nn_kernel_cpu,23801,0,1,1,64,0,0,0,0,1,37280000
nn_kernel_gpu,2218,1,1,291250,128,0,0,0,0,1,37280000
nn_kernel_gpu_mem,58506,1,1,291250,128,298240000,149120000,149120000,298240000,1,37280000
nn_kernel_cpu,17771,0,1,1,64,0,0,0,0,1,37290000
nn_kernel_gpu,2210,1,1,291329,128,0,0,0,0,1,37290000
nn_kernel_gpu_mem,49427,1,1,291329,128,298320000,149160000,149160000,298320000,1,37290000
nn_kernel_cpu,21964,0,1,1,64,0,0,0,0,1,37300000
nn_kernel_gpu,2216,1,1,291407,128,0,0,0,0,1,37300000
nn_kernel_gpu_mem,55519,1,1,291407,128,298400000,149200000,149200000,298400000,1,37300000
nn_kernel_cpu,7085,0,1,1,64,0,0,0,0,1,3730000
nn_kernel_gpu,288,1,1,29141,128,0,0,0,0,1,3730000
nn_kernel_gpu_mem,5563,1,1,29141,128,29840000,14920000,14920000,29840000,1,3730000
nn_kernel_cpu,12356,0,1,1,64,0,0,0,0,1,37310000
nn_kernel_gpu,2223,1,1,291485,128,0,0,0,0,1,37310000
nn_kernel_gpu_mem,55545,1,1,291485,128,298480000,149240000,149240000,298480000,1,37310000
nn_kernel_cpu,26878,0,1,1,64,0,0,0,0,1,37320000
nn_kernel_gpu,2231,1,1,291563,128,0,0,0,0,1,37320000
nn_kernel_gpu_mem,56551,1,1,291563,128,298560000,149280000,149280000,298560000,1,37320000
nn_kernel_cpu,17241,0,1,1,64,0,0,0,0,1,37330000
nn_kernel_gpu,2216,1,1,291641,128,0,0,0,0,1,37330000
nn_kernel_gpu_mem,55591,1,1,291641,128,298640000,149320000,149320000,298640000,1,37330000
nn_kernel_cpu,23904,0,1,1,64,0,0,0,0,1,37340000
nn_kernel_gpu,2212,1,1,291719,128,0,0,0,0,1,37340000
nn_kernel_gpu_mem,47327,1,1,291719,128,298720000,149360000,149360000,298720000,1,37340000
nn_kernel_cpu,25437,0,1,1,64,0,0,0,0,1,37350000
nn_kernel_gpu,2213,1,1,291797,128,0,0,0,0,1,37350000
nn_kernel_gpu_mem,61043,1,1,291797,128,298800000,149400000,149400000,298800000,1,37350000
nn_kernel_cpu,25031,0,1,1,64,0,0,0,0,1,37360000
nn_kernel_gpu,2212,1,1,291875,128,0,0,0,0,1,37360000
nn_kernel_gpu_mem,56104,1,1,291875,128,298880000,149440000,149440000,298880000,1,37360000
nn_kernel_cpu,10969,0,1,1,64,0,0,0,0,1,37370000
nn_kernel_gpu,2203,1,1,291954,128,0,0,0,0,1,37370000
nn_kernel_gpu_mem,52753,1,1,291954,128,298960000,149480000,149480000,298960000,1,37370000
nn_kernel_cpu,31253,0,1,1,64,0,0,0,0,1,37380000
nn_kernel_gpu,2216,1,1,292032,128,0,0,0,0,1,37380000
nn_kernel_gpu_mem,54523,1,1,292032,128,299040000,149520000,149520000,299040000,1,37380000
nn_kernel_cpu,25861,0,1,1,64,0,0,0,0,1,37390000
nn_kernel_gpu,2233,1,1,292110,128,0,0,0,0,1,37390000
nn_kernel_gpu_mem,55879,1,1,292110,128,299120000,149560000,149560000,299120000,1,37390000
nn_kernel_cpu,19506,0,1,1,64,0,0,0,0,1,37400000
nn_kernel_gpu,2208,1,1,292188,128,0,0,0,0,1,37400000
nn_kernel_gpu_mem,50373,1,1,292188,128,299200000,149600000,149600000,299200000,1,37400000
nn_kernel_cpu,4432,0,1,1,64,0,0,0,0,1,3740000
nn_kernel_gpu,325,1,1,29219,128,0,0,0,0,1,3740000
nn_kernel_gpu_mem,8743,1,1,29219,128,29920000,14960000,14960000,29920000,1,3740000
nn_kernel_cpu,14496,0,1,1,64,0,0,0,0,1,37410000
nn_kernel_gpu,2218,1,1,292266,128,0,0,0,0,1,37410000
nn_kernel_gpu_mem,48888,1,1,292266,128,299280000,149640000,149640000,299280000,1,37410000
nn_kernel_cpu,19350,0,1,1,64,0,0,0,0,1,37420000
nn_kernel_gpu,2224,1,1,292344,128,0,0,0,0,1,37420000
nn_kernel_gpu_mem,54556,1,1,292344,128,299360000,149680000,149680000,299360000,1,37420000
nn_kernel_cpu,31981,0,1,1,64,0,0,0,0,1,37430000
nn_kernel_gpu,2214,1,1,292422,128,0,0,0,0,1,37430000
nn_kernel_gpu_mem,56176,1,1,292422,128,299440000,149720000,149720000,299440000,1,37430000
nn_kernel_cpu,12966,0,1,1,64,0,0,0,0,1,37440000
nn_kernel_gpu,2215,1,1,292500,128,0,0,0,0,1,37440000
nn_kernel_gpu_mem,49038,1,1,292500,128,299520000,149760000,149760000,299520000,1,37440000
nn_kernel_cpu,19559,0,1,1,64,0,0,0,0,1,37450000
nn_kernel_gpu,2219,1,1,292579,128,0,0,0,0,1,37450000
nn_kernel_gpu_mem,55908,1,1,292579,128,299600000,149800000,149800000,299600000,1,37450000
nn_kernel_cpu,21822,0,1,1,64,0,0,0,0,1,37460000
nn_kernel_gpu,2206,1,1,292657,128,0,0,0,0,1,37460000
nn_kernel_gpu_mem,48445,1,1,292657,128,299680000,149840000,149840000,299680000,1,37460000
nn_kernel_cpu,25895,0,1,1,64,0,0,0,0,1,37470000
nn_kernel_gpu,2229,1,1,292735,128,0,0,0,0,1,37470000
nn_kernel_gpu_mem,58975,1,1,292735,128,299760000,149880000,149880000,299760000,1,37470000
nn_kernel_cpu,28744,0,1,1,64,0,0,0,0,1,37480000
nn_kernel_gpu,2235,1,1,292813,128,0,0,0,0,1,37480000
nn_kernel_gpu_mem,56868,1,1,292813,128,299840000,149920000,149920000,299840000,1,37480000
nn_kernel_cpu,17266,0,1,1,64,0,0,0,0,1,37490000
nn_kernel_gpu,2238,1,1,292891,128,0,0,0,0,1,37490000
nn_kernel_gpu_mem,55551,1,1,292891,128,299920000,149960000,149960000,299920000,1,37490000
nn_kernel_cpu,17765,0,1,1,64,0,0,0,0,1,37500000
nn_kernel_gpu,2236,1,1,292969,128,0,0,0,0,1,37500000
nn_kernel_gpu_mem,47451,1,1,292969,128,300000000,150000000,150000000,300000000,1,37500000
nn_kernel_cpu,7397,0,1,1,64,0,0,0,0,1,3750000
nn_kernel_gpu,281,1,1,29297,128,0,0,0,0,1,3750000
nn_kernel_gpu_mem,5601,1,1,29297,128,30000000,15000000,15000000,30000000,1,3750000
nn_kernel_cpu,9122,0,1,1,64,0,0,0,0,1,37510000
nn_kernel_gpu,2229,1,1,293047,128,0,0,0,0,1,37510000
nn_kernel_gpu_mem,47550,1,1,293047,128,300080000,150040000,150040000,300080000,1,37510000
nn_kernel_cpu,25072,0,1,1,64,0,0,0,0,1,37520000
nn_kernel_gpu,2227,1,1,293125,128,0,0,0,0,1,37520000
nn_kernel_gpu_mem,55780,1,1,293125,128,300160000,150080000,150080000,300160000,1,37520000
nn_kernel_cpu,22051,0,1,1,64,0,0,0,0,1,37530000
nn_kernel_gpu,2230,1,1,293204,128,0,0,0,0,1,37530000
nn_kernel_gpu_mem,55986,1,1,293204,128,300240000,150120000,150120000,300240000,1,37530000
nn_kernel_cpu,25367,0,1,1,64,0,0,0,0,1,37540000
nn_kernel_gpu,2246,1,1,293282,128,0,0,0,0,1,37540000
nn_kernel_gpu_mem,57895,1,1,293282,128,300320000,150160000,150160000,300320000,1,37540000
nn_kernel_cpu,30002,0,1,1,64,0,0,0,0,1,37550000
nn_kernel_gpu,2248,1,1,293360,128,0,0,0,0,1,37550000
nn_kernel_gpu_mem,58186,1,1,293360,128,300400000,150200000,150200000,300400000,1,37550000
nn_kernel_cpu,17938,0,1,1,64,0,0,0,0,1,37560000
nn_kernel_gpu,2212,1,1,293438,128,0,0,0,0,1,37560000
nn_kernel_gpu_mem,48900,1,1,293438,128,300480000,150240000,150240000,300480000,1,37560000
nn_kernel_cpu,13602,0,1,1,64,0,0,0,0,1,37570000
nn_kernel_gpu,2233,1,1,293516,128,0,0,0,0,1,37570000
nn_kernel_gpu_mem,47046,1,1,293516,128,300560000,150280000,150280000,300560000,1,37570000
nn_kernel_cpu,23846,0,1,1,64,0,0,0,0,1,37580000
nn_kernel_gpu,2234,1,1,293594,128,0,0,0,0,1,37580000
nn_kernel_gpu_mem,44384,1,1,293594,128,300640000,150320000,150320000,300640000,1,37580000
nn_kernel_cpu,17122,0,1,1,64,0,0,0,0,1,37590000
nn_kernel_gpu,2225,1,1,293672,128,0,0,0,0,1,37590000
nn_kernel_gpu_mem,49084,1,1,293672,128,300720000,150360000,150360000,300720000,1,37590000
nn_kernel_cpu,17790,0,1,1,64,0,0,0,0,1,37600000
nn_kernel_gpu,2247,1,1,293750,128,0,0,0,0,1,37600000
nn_kernel_gpu_mem,54863,1,1,293750,128,300800000,150400000,150400000,300800000,1,37600000
nn_kernel_cpu,8132,0,1,1,64,0,0,0,0,1,3760000
nn_kernel_gpu,269,1,1,29375,128,0,0,0,0,1,3760000
nn_kernel_gpu_mem,5733,1,1,29375,128,30080000,15040000,15040000,30080000,1,3760000
nn_kernel_cpu,11942,0,1,1,64,0,0,0,0,1,37610000
nn_kernel_gpu,2228,1,1,293829,128,0,0,0,0,1,37610000
nn_kernel_gpu_mem,56549,1,1,293829,128,300880000,150440000,150440000,300880000,1,37610000
nn_kernel_cpu,25463,0,1,1,64,0,0,0,0,1,37620000
nn_kernel_gpu,2240,1,1,293907,128,0,0,0,0,1,37620000
nn_kernel_gpu_mem,44249,1,1,293907,128,300960000,150480000,150480000,300960000,1,37620000
nn_kernel_cpu,20719,0,1,1,64,0,0,0,0,1,37630000
nn_kernel_gpu,2246,1,1,293985,128,0,0,0,0,1,37630000
nn_kernel_gpu_mem,49320,1,1,293985,128,301040000,150520000,150520000,301040000,1,37630000
nn_kernel_cpu,21016,0,1,1,64,0,0,0,0,1,37640000
nn_kernel_gpu,2245,1,1,294063,128,0,0,0,0,1,37640000
nn_kernel_gpu_mem,58423,1,1,294063,128,301120000,150560000,150560000,301120000,1,37640000
nn_kernel_cpu,24903,0,1,1,64,0,0,0,0,1,37650000
nn_kernel_gpu,2235,1,1,294141,128,0,0,0,0,1,37650000
nn_kernel_gpu_mem,56290,1,1,294141,128,301200000,150600000,150600000,301200000,1,37650000
nn_kernel_cpu,23507,0,1,1,64,0,0,0,0,1,37660000
nn_kernel_gpu,2242,1,1,294219,128,0,0,0,0,1,37660000
nn_kernel_gpu_mem,54695,1,1,294219,128,301280000,150640000,150640000,301280000,1,37660000
nn_kernel_cpu,15356,0,1,1,64,0,0,0,0,1,37670000
nn_kernel_gpu,2240,1,1,294297,128,0,0,0,0,1,37670000
nn_kernel_gpu_mem,57457,1,1,294297,128,301360000,150680000,150680000,301360000,1,37670000
nn_kernel_cpu,18375,0,1,1,64,0,0,0,0,1,37680000
nn_kernel_gpu,2242,1,1,294375,128,0,0,0,0,1,37680000
nn_kernel_gpu_mem,55617,1,1,294375,128,301440000,150720000,150720000,301440000,1,37680000
nn_kernel_cpu,11441,0,1,1,64,0,0,0,0,1,37690000
nn_kernel_gpu,2254,1,1,294454,128,0,0,0,0,1,37690000
nn_kernel_gpu_mem,55703,1,1,294454,128,301520000,150760000,150760000,301520000,1,37690000
nn_kernel_cpu,21325,0,1,1,64,0,0,0,0,1,37700000
nn_kernel_gpu,2243,1,1,294532,128,0,0,0,0,1,37700000
nn_kernel_gpu_mem,49069,1,1,294532,128,301600000,150800000,150800000,301600000,1,37700000
nn_kernel_cpu,23550,0,1,1,64,0,0,0,0,1,3770000
nn_kernel_gpu,280,1,1,29454,128,0,0,0,0,1,3770000
nn_kernel_gpu_mem,5625,1,1,29454,128,30160000,15080000,15080000,30160000,1,3770000
nn_kernel_cpu,25477,0,1,1,64,0,0,0,0,1,37710000
nn_kernel_gpu,2247,1,1,294610,128,0,0,0,0,1,37710000
nn_kernel_gpu_mem,56749,1,1,294610,128,301680000,150840000,150840000,301680000,1,37710000
nn_kernel_cpu,18446,0,1,1,64,0,0,0,0,1,37720000
nn_kernel_gpu,2245,1,1,294688,128,0,0,0,0,1,37720000
nn_kernel_gpu_mem,50369,1,1,294688,128,301760000,150880000,150880000,301760000,1,37720000
nn_kernel_cpu,8531,0,1,1,64,0,0,0,0,1,37730000
nn_kernel_gpu,2237,1,1,294766,128,0,0,0,0,1,37730000
nn_kernel_gpu_mem,50461,1,1,294766,128,301840000,150920000,150920000,301840000,1,37730000
nn_kernel_cpu,20738,0,1,1,64,0,0,0,0,1,37740000
nn_kernel_gpu,2254,1,1,294844,128,0,0,0,0,1,37740000
nn_kernel_gpu_mem,56414,1,1,294844,128,301920000,150960000,150960000,301920000,1,37740000
nn_kernel_cpu,27351,0,1,1,64,0,0,0,0,1,37750000
nn_kernel_gpu,2264,1,1,294922,128,0,0,0,0,1,37750000
nn_kernel_gpu_mem,57471,1,1,294922,128,302000000,151000000,151000000,302000000,1,37750000
nn_kernel_cpu,25265,0,1,1,64,0,0,0,0,1,37760000
nn_kernel_gpu,2262,1,1,295000,128,0,0,0,0,1,37760000
nn_kernel_gpu_mem,56051,1,1,295000,128,302080000,151040000,151040000,302080000,1,37760000
nn_kernel_cpu,23833,0,1,1,64,0,0,0,0,1,37770000
nn_kernel_gpu,2272,1,1,295079,128,0,0,0,0,1,37770000
nn_kernel_gpu_mem,57252,1,1,295079,128,302160000,151080000,151080000,302160000,1,37770000
nn_kernel_cpu,41811,0,1,1,64,0,0,0,0,1,37780000
nn_kernel_gpu,2304,1,1,295157,128,0,0,0,0,1,37780000
nn_kernel_gpu_mem,55980,1,1,295157,128,302240000,151120000,151120000,302240000,1,37780000
nn_kernel_cpu,32312,0,1,1,64,0,0,0,0,1,37790000
nn_kernel_gpu,2263,1,1,295235,128,0,0,0,0,1,37790000
nn_kernel_gpu_mem,57297,1,1,295235,128,302320000,151160000,151160000,302320000,1,37790000
nn_kernel_cpu,27587,0,1,1,64,0,0,0,0,1,37800000
nn_kernel_gpu,2272,1,1,295313,128,0,0,0,0,1,37800000
nn_kernel_gpu_mem,56148,1,1,295313,128,302400000,151200000,151200000,302400000,1,37800000
nn_kernel_cpu,31453,0,1,1,64,0,0,0,0,1,3780000
nn_kernel_gpu,274,1,1,29532,128,0,0,0,0,1,3780000
nn_kernel_gpu_mem,6063,1,1,29532,128,30240000,15120000,15120000,30240000,1,3780000
nn_kernel_cpu,20512,0,1,1,64,0,0,0,0,1,37810000
nn_kernel_gpu,2250,1,1,295391,128,0,0,0,0,1,37810000
nn_kernel_gpu_mem,54868,1,1,295391,128,302480000,151240000,151240000,302480000,1,37810000
nn_kernel_cpu,24238,0,1,1,64,0,0,0,0,1,37820000
nn_kernel_gpu,2271,1,1,295469,128,0,0,0,0,1,37820000
nn_kernel_gpu_mem,49053,1,1,295469,128,302560000,151280000,151280000,302560000,1,37820000
nn_kernel_cpu,39625,0,1,1,64,0,0,0,0,1,37830000
nn_kernel_gpu,2267,1,1,295547,128,0,0,0,0,1,37830000
nn_kernel_gpu_mem,60900,1,1,295547,128,302640000,151320000,151320000,302640000,1,37830000
nn_kernel_cpu,29455,0,1,1,64,0,0,0,0,1,37840000
nn_kernel_gpu,2264,1,1,295625,128,0,0,0,0,1,37840000
nn_kernel_gpu_mem,48643,1,1,295625,128,302720000,151360000,151360000,302720000,1,37840000
nn_kernel_cpu,24111,0,1,1,64,0,0,0,0,1,37850000
nn_kernel_gpu,2269,1,1,295704,128,0,0,0,0,1,37850000
nn_kernel_gpu_mem,56946,1,1,295704,128,302800000,151400000,151400000,302800000,1,37850000
nn_kernel_cpu,11918,0,1,1,64,0,0,0,0,1,37860000
nn_kernel_gpu,2257,1,1,295782,128,0,0,0,0,1,37860000
nn_kernel_gpu_mem,44455,1,1,295782,128,302880000,151440000,151440000,302880000,1,37860000
nn_kernel_cpu,33886,0,1,1,64,0,0,0,0,1,37870000
nn_kernel_gpu,2277,1,1,295860,128,0,0,0,0,1,37870000
nn_kernel_gpu_mem,48986,1,1,295860,128,302960000,151480000,151480000,302960000,1,37870000
nn_kernel_cpu,15953,0,1,1,64,0,0,0,0,1,37880000
nn_kernel_gpu,2276,1,1,295938,128,0,0,0,0,1,37880000
nn_kernel_gpu_mem,50425,1,1,295938,128,303040000,151520000,151520000,303040000,1,37880000
nn_kernel_cpu,19674,0,1,1,64,0,0,0,0,1,37890000
nn_kernel_gpu,2272,1,1,296016,128,0,0,0,0,1,37890000
nn_kernel_gpu_mem,56221,1,1,296016,128,303120000,151560000,151560000,303120000,1,37890000
nn_kernel_cpu,20400,0,1,1,64,0,0,0,0,1,37900000
nn_kernel_gpu,2256,1,1,296094,128,0,0,0,0,1,37900000
nn_kernel_gpu_mem,48658,1,1,296094,128,303200000,151600000,151600000,303200000,1,37900000
nn_kernel_cpu,5454,0,1,1,64,0,0,0,0,1,3790000
nn_kernel_gpu,281,1,1,29610,128,0,0,0,0,1,3790000
nn_kernel_gpu_mem,5658,1,1,29610,128,30320000,15160000,15160000,30320000,1,3790000
nn_kernel_cpu,27432,0,1,1,64,0,0,0,0,1,37910000
nn_kernel_gpu,2260,1,1,296172,128,0,0,0,0,1,37910000
nn_kernel_gpu_mem,55523,1,1,296172,128,303280000,151640000,151640000,303280000,1,37910000
nn_kernel_cpu,20810,0,1,1,64,0,0,0,0,1,37920000
nn_kernel_gpu,2303,1,1,296250,128,0,0,0,0,1,37920000
nn_kernel_gpu_mem,56258,1,1,296250,128,303360000,151680000,151680000,303360000,1,37920000
nn_kernel_cpu,13727,0,1,1,64,0,0,0,0,1,37930000
nn_kernel_gpu,2264,1,1,296329,128,0,0,0,0,1,37930000
nn_kernel_gpu_mem,54241,1,1,296329,128,303440000,151720000,151720000,303440000,1,37930000
nn_kernel_cpu,39174,0,1,1,64,0,0,0,0,1,37940000
nn_kernel_gpu,2278,1,1,296407,128,0,0,0,0,1,37940000
nn_kernel_gpu_mem,56735,1,1,296407,128,303520000,151760000,151760000,303520000,1,37940000
nn_kernel_cpu,21591,0,1,1,64,0,0,0,0,1,37950000
nn_kernel_gpu,2271,1,1,296485,128,0,0,0,0,1,37950000
nn_kernel_gpu_mem,56155,1,1,296485,128,303600000,151800000,151800000,303600000,1,37950000
nn_kernel_cpu,13176,0,1,1,64,0,0,0,0,1,37960000
nn_kernel_gpu,2258,1,1,296563,128,0,0,0,0,1,37960000
nn_kernel_gpu_mem,47117,1,1,296563,128,303680000,151840000,151840000,303680000,1,37960000
nn_kernel_cpu,13674,0,1,1,64,0,0,0,0,1,37970000
nn_kernel_gpu,2247,1,1,296641,128,0,0,0,0,1,37970000
nn_kernel_gpu_mem,45928,1,1,296641,128,303760000,151880000,151880000,303760000,1,37970000
nn_kernel_cpu,30761,0,1,1,64,0,0,0,0,1,37980000
nn_kernel_gpu,2283,1,1,296719,128,0,0,0,0,1,37980000
nn_kernel_gpu_mem,49020,1,1,296719,128,303840000,151920000,151920000,303840000,1,37980000
nn_kernel_cpu,26768,0,1,1,64,0,0,0,0,1,37990000
nn_kernel_gpu,2278,1,1,296797,128,0,0,0,0,1,37990000
nn_kernel_gpu_mem,57231,1,1,296797,128,303920000,151960000,151960000,303920000,1,37990000
nn_kernel_cpu,29069,0,1,1,64,0,0,0,0,1,38000000
nn_kernel_gpu,2268,1,1,296875,128,0,0,0,0,1,38000000
nn_kernel_gpu_mem,57406,1,1,296875,128,304000000,152000000,152000000,304000000,1,38000000
nn_kernel_cpu,8529,0,1,1,64,0,0,0,0,1,3800000
nn_kernel_gpu,289,1,1,29688,128,0,0,0,0,1,3800000
nn_kernel_gpu_mem,5808,1,1,29688,128,30400000,15200000,15200000,30400000,1,3800000
nn_kernel_cpu,24211,0,1,1,64,0,0,0,0,1,380000
nn_kernel_gpu,72,1,1,2969,128,0,0,0,0,1,380000
nn_kernel_gpu_mem,945,1,1,2969,128,3040000,1520000,1520000,3040000,1,380000
nn_kernel_cpu,25199,0,1,1,64,0,0,0,0,1,38010000
nn_kernel_gpu,2280,1,1,296954,128,0,0,0,0,1,38010000
nn_kernel_gpu_mem,56365,1,1,296954,128,304080000,152040000,152040000,304080000,1,38010000
nn_kernel_cpu,26970,0,1,1,64,0,0,0,0,1,38020000
nn_kernel_gpu,2276,1,1,297032,128,0,0,0,0,1,38020000
nn_kernel_gpu_mem,49159,1,1,297032,128,304160000,152080000,152080000,304160000,1,38020000
nn_kernel_cpu,18378,0,1,1,64,0,0,0,0,1,38030000
nn_kernel_gpu,2286,1,1,297110,128,0,0,0,0,1,38030000
nn_kernel_gpu_mem,57959,1,1,297110,128,304240000,152120000,152120000,304240000,1,38030000
nn_kernel_cpu,21243,0,1,1,64,0,0,0,0,1,38040000
nn_kernel_gpu,2277,1,1,297188,128,0,0,0,0,1,38040000
nn_kernel_gpu_mem,56059,1,1,297188,128,304320000,152160000,152160000,304320000,1,38040000
nn_kernel_cpu,25797,0,1,1,64,0,0,0,0,1,38050000
nn_kernel_gpu,2283,1,1,297266,128,0,0,0,0,1,38050000
nn_kernel_gpu_mem,56853,1,1,297266,128,304400000,152200000,152200000,304400000,1,38050000
nn_kernel_cpu,16283,0,1,1,64,0,0,0,0,1,38060000
nn_kernel_gpu,2265,1,1,297344,128,0,0,0,0,1,38060000
nn_kernel_gpu_mem,56028,1,1,297344,128,304480000,152240000,152240000,304480000,1,38060000
nn_kernel_cpu,20034,0,1,1,64,0,0,0,0,1,38070000
nn_kernel_gpu,2285,1,1,297422,128,0,0,0,0,1,38070000
nn_kernel_gpu_mem,57519,1,1,297422,128,304560000,152280000,152280000,304560000,1,38070000
nn_kernel_cpu,35102,0,1,1,64,0,0,0,0,1,38080000
nn_kernel_gpu,2276,1,1,297500,128,0,0,0,0,1,38080000
nn_kernel_gpu_mem,57035,1,1,297500,128,304640000,152320000,152320000,304640000,1,38080000
nn_kernel_cpu,27888,0,1,1,64,0,0,0,0,1,38090000
nn_kernel_gpu,2309,1,1,297579,128,0,0,0,0,1,38090000
nn_kernel_gpu_mem,50489,1,1,297579,128,304720000,152360000,152360000,304720000,1,38090000
nn_kernel_cpu,28171,0,1,1,64,0,0,0,0,1,38100000
nn_kernel_gpu,2287,1,1,297657,128,0,0,0,0,1,38100000
nn_kernel_gpu_mem,55850,1,1,297657,128,304800000,152400000,152400000,304800000,1,38100000
nn_kernel_cpu,3597,0,1,1,64,0,0,0,0,1,3810000
nn_kernel_gpu,275,1,1,29766,128,0,0,0,0,1,3810000
nn_kernel_gpu_mem,5705,1,1,29766,128,30480000,15240000,15240000,30480000,1,3810000
nn_kernel_cpu,25801,0,1,1,64,0,0,0,0,1,38110000
nn_kernel_gpu,2283,1,1,297735,128,0,0,0,0,1,38110000
nn_kernel_gpu_mem,56982,1,1,297735,128,304880000,152440000,152440000,304880000,1,38110000
nn_kernel_cpu,18510,0,1,1,64,0,0,0,0,1,38120000
nn_kernel_gpu,2290,1,1,297813,128,0,0,0,0,1,38120000
nn_kernel_gpu_mem,56533,1,1,297813,128,304960000,152480000,152480000,304960000,1,38120000
nn_kernel_cpu,24771,0,1,1,64,0,0,0,0,1,38130000
nn_kernel_gpu,2284,1,1,297891,128,0,0,0,0,1,38130000
nn_kernel_gpu_mem,63582,1,1,297891,128,305040000,152520000,152520000,305040000,1,38130000
nn_kernel_cpu,25785,0,1,1,64,0,0,0,0,1,38140000
nn_kernel_gpu,2283,1,1,297969,128,0,0,0,0,1,38140000
nn_kernel_gpu_mem,55366,1,1,297969,128,305120000,152560000,152560000,305120000,1,38140000
nn_kernel_cpu,30136,0,1,1,64,0,0,0,0,1,38150000
nn_kernel_gpu,2279,1,1,298047,128,0,0,0,0,1,38150000
nn_kernel_gpu_mem,47236,1,1,298047,128,305200000,152600000,152600000,305200000,1,38150000
nn_kernel_cpu,24189,0,1,1,64,0,0,0,0,1,38160000
nn_kernel_gpu,2291,1,1,298125,128,0,0,0,0,1,38160000
nn_kernel_gpu_mem,50313,1,1,298125,128,305280000,152640000,152640000,305280000,1,38160000
nn_kernel_cpu,25914,0,1,1,64,0,0,0,0,1,38170000
nn_kernel_gpu,2278,1,1,298204,128,0,0,0,0,1,38170000
nn_kernel_gpu_mem,49127,1,1,298204,128,305360000,152680000,152680000,305360000,1,38170000
nn_kernel_cpu,24765,0,1,1,64,0,0,0,0,1,38180000
nn_kernel_gpu,2289,1,1,298282,128,0,0,0,0,1,38180000
nn_kernel_gpu_mem,45718,1,1,298282,128,305440000,152720000,152720000,305440000,1,38180000
nn_kernel_cpu,36050,0,1,1,64,0,0,0,0,1,38190000
nn_kernel_gpu,2290,1,1,298360,128,0,0,0,0,1,38190000
nn_kernel_gpu_mem,45048,1,1,298360,128,305520000,152760000,152760000,305520000,1,38190000
nn_kernel_cpu,25806,0,1,1,64,0,0,0,0,1,38200000
nn_kernel_gpu,2292,1,1,298438,128,0,0,0,0,1,38200000
nn_kernel_gpu_mem,58659,1,1,298438,128,305600000,152800000,152800000,305600000,1,38200000
nn_kernel_cpu,35689,0,1,1,64,0,0,0,0,1,3820000
nn_kernel_gpu,303,1,1,29844,128,0,0,0,0,1,3820000
nn_kernel_gpu_mem,5919,1,1,29844,128,30560000,15280000,15280000,30560000,1,3820000
nn_kernel_cpu,26715,0,1,1,64,0,0,0,0,1,38210000
nn_kernel_gpu,2317,1,1,298516,128,0,0,0,0,1,38210000
nn_kernel_gpu_mem,58247,1,1,298516,128,305680000,152840000,152840000,305680000,1,38210000
nn_kernel_cpu,25241,0,1,1,64,0,0,0,0,1,38220000
nn_kernel_gpu,2278,1,1,298594,128,0,0,0,0,1,38220000
nn_kernel_gpu_mem,57276,1,1,298594,128,305760000,152880000,152880000,305760000,1,38220000
nn_kernel_cpu,17626,0,1,1,64,0,0,0,0,1,38230000
nn_kernel_gpu,2289,1,1,298672,128,0,0,0,0,1,38230000
nn_kernel_gpu_mem,50051,1,1,298672,128,305840000,152920000,152920000,305840000,1,38230000
nn_kernel_cpu,20499,0,1,1,64,0,0,0,0,1,38240000
nn_kernel_gpu,2291,1,1,298750,128,0,0,0,0,1,38240000
nn_kernel_gpu_mem,43333,1,1,298750,128,305920000,152960000,152960000,305920000,1,38240000
nn_kernel_cpu,31278,0,1,1,64,0,0,0,0,1,38250000
nn_kernel_gpu,2279,1,1,298829,128,0,0,0,0,1,38250000
nn_kernel_gpu_mem,57625,1,1,298829,128,306000000,153000000,153000000,306000000,1,38250000
nn_kernel_cpu,30913,0,1,1,64,0,0,0,0,1,38260000
nn_kernel_gpu,2276,1,1,298907,128,0,0,0,0,1,38260000
nn_kernel_gpu_mem,47830,1,1,298907,128,306080000,153040000,153040000,306080000,1,38260000
nn_kernel_cpu,24856,0,1,1,64,0,0,0,0,1,38270000
nn_kernel_gpu,2279,1,1,298985,128,0,0,0,0,1,38270000
nn_kernel_gpu_mem,57100,1,1,298985,128,306160000,153080000,153080000,306160000,1,38270000
nn_kernel_cpu,17583,0,1,1,64,0,0,0,0,1,38280000
nn_kernel_gpu,2287,1,1,299063,128,0,0,0,0,1,38280000
nn_kernel_gpu_mem,56769,1,1,299063,128,306240000,153120000,153120000,306240000,1,38280000
nn_kernel_cpu,26480,0,1,1,64,0,0,0,0,1,38290000
nn_kernel_gpu,2285,1,1,299141,128,0,0,0,0,1,38290000
nn_kernel_gpu_mem,59034,1,1,299141,128,306320000,153160000,153160000,306320000,1,38290000
nn_kernel_cpu,24617,0,1,1,64,0,0,0,0,1,38300000
nn_kernel_gpu,2283,1,1,299219,128,0,0,0,0,1,38300000
nn_kernel_gpu_mem,46452,1,1,299219,128,306400000,153200000,153200000,306400000,1,38300000
nn_kernel_cpu,60141,0,1,1,64,0,0,0,0,1,3830000
nn_kernel_gpu,280,1,1,29922,128,0,0,0,0,1,3830000
nn_kernel_gpu_mem,4931,1,1,29922,128,30640000,15320000,15320000,30640000,1,3830000
nn_kernel_cpu,25043,0,1,1,64,0,0,0,0,1,38310000
nn_kernel_gpu,2282,1,1,299297,128,0,0,0,0,1,38310000
nn_kernel_gpu_mem,52433,1,1,299297,128,306480000,153240000,153240000,306480000,1,38310000
nn_kernel_cpu,25303,0,1,1,64,0,0,0,0,1,38320000
nn_kernel_gpu,2293,1,1,299375,128,0,0,0,0,1,38320000
nn_kernel_gpu_mem,49899,1,1,299375,128,306560000,153280000,153280000,306560000,1,38320000
nn_kernel_cpu,32329,0,1,1,64,0,0,0,0,1,38330000
nn_kernel_gpu,2295,1,1,299454,128,0,0,0,0,1,38330000
nn_kernel_gpu_mem,45392,1,1,299454,128,306640000,153320000,153320000,306640000,1,38330000
nn_kernel_cpu,23266,0,1,1,64,0,0,0,0,1,38340000
nn_kernel_gpu,2285,1,1,299532,128,0,0,0,0,1,38340000
nn_kernel_gpu_mem,52624,1,1,299532,128,306720000,153360000,153360000,306720000,1,38340000
nn_kernel_cpu,27189,0,1,1,64,0,0,0,0,1,38350000
nn_kernel_gpu,2277,1,1,299610,128,0,0,0,0,1,38350000
nn_kernel_gpu_mem,53420,1,1,299610,128,306800000,153400000,153400000,306800000,1,38350000
nn_kernel_cpu,23237,0,1,1,64,0,0,0,0,1,38360000
nn_kernel_gpu,2295,1,1,299688,128,0,0,0,0,1,38360000
nn_kernel_gpu_mem,58015,1,1,299688,128,306880000,153440000,153440000,306880000,1,38360000
nn_kernel_cpu,24393,0,1,1,64,0,0,0,0,1,38370000
nn_kernel_gpu,2280,1,1,299766,128,0,0,0,0,1,38370000
nn_kernel_gpu_mem,55118,1,1,299766,128,306960000,153480000,153480000,306960000,1,38370000
nn_kernel_cpu,24419,0,1,1,64,0,0,0,0,1,38380000
nn_kernel_gpu,2295,1,1,299844,128,0,0,0,0,1,38380000
nn_kernel_gpu_mem,56840,1,1,299844,128,307040000,153520000,153520000,307040000,1,38380000
nn_kernel_cpu,23437,0,1,1,64,0,0,0,0,1,38390000
nn_kernel_gpu,2276,1,1,299922,128,0,0,0,0,1,38390000
nn_kernel_gpu_mem,47667,1,1,299922,128,307120000,153560000,153560000,307120000,1,38390000
nn_kernel_cpu,7924,0,1,1,64,0,0,0,0,1,38400000
nn_kernel_gpu,2290,1,1,300000,128,0,0,0,0,1,38400000
nn_kernel_gpu_mem,57310,1,1,300000,128,307200000,153600000,153600000,307200000,1,38400000
nn_kernel_cpu,6484,0,1,1,64,0,0,0,0,1,3840000
nn_kernel_gpu,281,1,1,30000,128,0,0,0,0,1,3840000
nn_kernel_gpu_mem,5538,1,1,30000,128,30720000,15360000,15360000,30720000,1,3840000
nn_kernel_cpu,8901,0,1,1,64,0,0,0,0,1,38410000
nn_kernel_gpu,2287,1,1,300079,128,0,0,0,0,1,38410000
nn_kernel_gpu_mem,43270,1,1,300079,128,307280000,153640000,153640000,307280000,1,38410000
nn_kernel_cpu,28263,0,1,1,64,0,0,0,0,1,38420000
nn_kernel_gpu,2300,1,1,300157,128,0,0,0,0,1,38420000
nn_kernel_gpu_mem,49749,1,1,300157,128,307360000,153680000,153680000,307360000,1,38420000
nn_kernel_cpu,27941,0,1,1,64,0,0,0,0,1,38430000
nn_kernel_gpu,2292,1,1,300235,128,0,0,0,0,1,38430000
nn_kernel_gpu_mem,46927,1,1,300235,128,307440000,153720000,153720000,307440000,1,38430000
nn_kernel_cpu,18356,0,1,1,64,0,0,0,0,1,38440000
nn_kernel_gpu,2330,1,1,300313,128,0,0,0,0,1,38440000
nn_kernel_gpu_mem,43180,1,1,300313,128,307520000,153760000,153760000,307520000,1,38440000
nn_kernel_cpu,24313,0,1,1,64,0,0,0,0,1,38450000
nn_kernel_gpu,2298,1,1,300391,128,0,0,0,0,1,38450000
nn_kernel_gpu_mem,57016,1,1,300391,128,307600000,153800000,153800000,307600000,1,38450000
nn_kernel_cpu,16975,0,1,1,64,0,0,0,0,1,38460000
nn_kernel_gpu,2300,1,1,300469,128,0,0,0,0,1,38460000
nn_kernel_gpu_mem,60381,1,1,300469,128,307680000,153840000,153840000,307680000,1,38460000
nn_kernel_cpu,14356,0,1,1,64,0,0,0,0,1,38470000
nn_kernel_gpu,2303,1,1,300547,128,0,0,0,0,1,38470000
nn_kernel_gpu_mem,54560,1,1,300547,128,307760000,153880000,153880000,307760000,1,38470000
nn_kernel_cpu,17788,0,1,1,64,0,0,0,0,1,38480000
nn_kernel_gpu,2345,1,1,300625,128,0,0,0,0,1,38480000
nn_kernel_gpu_mem,56581,1,1,300625,128,307840000,153920000,153920000,307840000,1,38480000
nn_kernel_cpu,21768,0,1,1,64,0,0,0,0,1,38490000
nn_kernel_gpu,2330,1,1,300704,128,0,0,0,0,1,38490000
nn_kernel_gpu_mem,53372,1,1,300704,128,307920000,153960000,153960000,307920000,1,38490000
nn_kernel_cpu,18951,0,1,1,64,0,0,0,0,1,38500000
nn_kernel_gpu,2302,1,1,300782,128,0,0,0,0,1,38500000
nn_kernel_gpu_mem,56728,1,1,300782,128,308000000,154000000,154000000,308000000,1,38500000
nn_kernel_cpu,22678,0,1,1,64,0,0,0,0,1,3850000
nn_kernel_gpu,279,1,1,30079,128,0,0,0,0,1,3850000
nn_kernel_gpu_mem,6221,1,1,30079,128,30800000,15400000,15400000,30800000,1,3850000
nn_kernel_cpu,26848,0,1,1,64,0,0,0,0,1,38510000
nn_kernel_gpu,2331,1,1,300860,128,0,0,0,0,1,38510000
nn_kernel_gpu_mem,51578,1,1,300860,128,308080000,154040000,154040000,308080000,1,38510000
nn_kernel_cpu,21385,0,1,1,64,0,0,0,0,1,38520000
nn_kernel_gpu,2302,1,1,300938,128,0,0,0,0,1,38520000
nn_kernel_gpu_mem,56926,1,1,300938,128,308160000,154080000,154080000,308160000,1,38520000
nn_kernel_cpu,27535,0,1,1,64,0,0,0,0,1,38530000
nn_kernel_gpu,2301,1,1,301016,128,0,0,0,0,1,38530000
nn_kernel_gpu_mem,58170,1,1,301016,128,308240000,154120000,154120000,308240000,1,38530000
nn_kernel_cpu,38440,0,1,1,64,0,0,0,0,1,38540000
nn_kernel_gpu,2305,1,1,301094,128,0,0,0,0,1,38540000
nn_kernel_gpu_mem,53833,1,1,301094,128,308320000,154160000,154160000,308320000,1,38540000
nn_kernel_cpu,27026,0,1,1,64,0,0,0,0,1,38550000
nn_kernel_gpu,2282,1,1,301172,128,0,0,0,0,1,38550000
nn_kernel_gpu_mem,55612,1,1,301172,128,308400000,154200000,154200000,308400000,1,38550000
nn_kernel_cpu,26792,0,1,1,64,0,0,0,0,1,38560000
nn_kernel_gpu,2289,1,1,301250,128,0,0,0,0,1,38560000
nn_kernel_gpu_mem,63894,1,1,301250,128,308480000,154240000,154240000,308480000,1,38560000
nn_kernel_cpu,27854,0,1,1,64,0,0,0,0,1,38570000
nn_kernel_gpu,2308,1,1,301329,128,0,0,0,0,1,38570000
nn_kernel_gpu_mem,56528,1,1,301329,128,308560000,154280000,154280000,308560000,1,38570000
nn_kernel_cpu,16080,0,1,1,64,0,0,0,0,1,38580000
nn_kernel_gpu,2316,1,1,301407,128,0,0,0,0,1,38580000
nn_kernel_gpu_mem,57525,1,1,301407,128,308640000,154320000,154320000,308640000,1,38580000
nn_kernel_cpu,14375,0,1,1,64,0,0,0,0,1,38590000
nn_kernel_gpu,2306,1,1,301485,128,0,0,0,0,1,38590000
nn_kernel_gpu_mem,57351,1,1,301485,128,308720000,154360000,154360000,308720000,1,38590000
nn_kernel_cpu,25037,0,1,1,64,0,0,0,0,1,38600000
nn_kernel_gpu,2345,1,1,301563,128,0,0,0,0,1,38600000
nn_kernel_gpu_mem,50313,1,1,301563,128,308800000,154400000,154400000,308800000,1,38600000
nn_kernel_cpu,6139,0,1,1,64,0,0,0,0,1,3860000
nn_kernel_gpu,281,1,1,30157,128,0,0,0,0,1,3860000
nn_kernel_gpu_mem,5874,1,1,30157,128,30880000,15440000,15440000,30880000,1,3860000
nn_kernel_cpu,11340,0,1,1,64,0,0,0,0,1,38610000
nn_kernel_gpu,2333,1,1,301641,128,0,0,0,0,1,38610000
nn_kernel_gpu_mem,49668,1,1,301641,128,308880000,154440000,154440000,308880000,1,38610000
nn_kernel_cpu,12323,0,1,1,64,0,0,0,0,1,38620000
nn_kernel_gpu,2334,1,1,301719,128,0,0,0,0,1,38620000
nn_kernel_gpu_mem,47986,1,1,301719,128,308960000,154480000,154480000,308960000,1,38620000
nn_kernel_cpu,13103,0,1,1,64,0,0,0,0,1,38630000
nn_kernel_gpu,2307,1,1,301797,128,0,0,0,0,1,38630000
nn_kernel_gpu_mem,57921,1,1,301797,128,309040000,154520000,154520000,309040000,1,38630000
nn_kernel_cpu,9747,0,1,1,64,0,0,0,0,1,38640000
nn_kernel_gpu,2304,1,1,301875,128,0,0,0,0,1,38640000
nn_kernel_gpu_mem,57858,1,1,301875,128,309120000,154560000,154560000,309120000,1,38640000
nn_kernel_cpu,25636,0,1,1,64,0,0,0,0,1,38650000
nn_kernel_gpu,2300,1,1,301954,128,0,0,0,0,1,38650000
nn_kernel_gpu_mem,43662,1,1,301954,128,309200000,154600000,154600000,309200000,1,38650000
nn_kernel_cpu,15581,0,1,1,64,0,0,0,0,1,38660000
nn_kernel_gpu,2298,1,1,302032,128,0,0,0,0,1,38660000
nn_kernel_gpu_mem,55519,1,1,302032,128,309280000,154640000,154640000,309280000,1,38660000
nn_kernel_cpu,25441,0,1,1,64,0,0,0,0,1,38670000
nn_kernel_gpu,2312,1,1,302110,128,0,0,0,0,1,38670000
nn_kernel_gpu_mem,57377,1,1,302110,128,309360000,154680000,154680000,309360000,1,38670000
nn_kernel_cpu,26465,0,1,1,64,0,0,0,0,1,38680000
nn_kernel_gpu,2315,1,1,302188,128,0,0,0,0,1,38680000
nn_kernel_gpu_mem,58433,1,1,302188,128,309440000,154720000,154720000,309440000,1,38680000
nn_kernel_cpu,22974,0,1,1,64,0,0,0,0,1,38690000
nn_kernel_gpu,2314,1,1,302266,128,0,0,0,0,1,38690000
nn_kernel_gpu_mem,57371,1,1,302266,128,309520000,154760000,154760000,309520000,1,38690000
nn_kernel_cpu,31759,0,1,1,64,0,0,0,0,1,38700000
nn_kernel_gpu,2316,1,1,302344,128,0,0,0,0,1,38700000
nn_kernel_gpu_mem,56875,1,1,302344,128,309600000,154800000,154800000,309600000,1,38700000
nn_kernel_cpu,6810,0,1,1,64,0,0,0,0,1,3870000
nn_kernel_gpu,281,1,1,30235,128,0,0,0,0,1,3870000
nn_kernel_gpu_mem,5934,1,1,30235,128,30960000,15480000,15480000,30960000,1,3870000
nn_kernel_cpu,28165,0,1,1,64,0,0,0,0,1,38710000
nn_kernel_gpu,2308,1,1,302422,128,0,0,0,0,1,38710000
nn_kernel_gpu_mem,58092,1,1,302422,128,309680000,154840000,154840000,309680000,1,38710000
nn_kernel_cpu,27107,0,1,1,64,0,0,0,0,1,38720000
nn_kernel_gpu,2314,1,1,302500,128,0,0,0,0,1,38720000
nn_kernel_gpu_mem,58306,1,1,302500,128,309760000,154880000,154880000,309760000,1,38720000
nn_kernel_cpu,50207,0,1,1,64,0,0,0,0,1,38730000
nn_kernel_gpu,2313,1,1,302579,128,0,0,0,0,1,38730000
nn_kernel_gpu_mem,57101,1,1,302579,128,309840000,154920000,154920000,309840000,1,38730000
nn_kernel_cpu,28355,0,1,1,64,0,0,0,0,1,38740000
nn_kernel_gpu,2322,1,1,302657,128,0,0,0,0,1,38740000
nn_kernel_gpu_mem,58380,1,1,302657,128,309920000,154960000,154960000,309920000,1,38740000
nn_kernel_cpu,19924,0,1,1,64,0,0,0,0,1,38750000
nn_kernel_gpu,2303,1,1,302735,128,0,0,0,0,1,38750000
nn_kernel_gpu_mem,57530,1,1,302735,128,310000000,155000000,155000000,310000000,1,38750000
nn_kernel_cpu,8066,0,1,1,64,0,0,0,0,1,38760000
nn_kernel_gpu,2307,1,1,302813,128,0,0,0,0,1,38760000
nn_kernel_gpu_mem,57177,1,1,302813,128,310080000,155040000,155040000,310080000,1,38760000
nn_kernel_cpu,15652,0,1,1,64,0,0,0,0,1,38770000
nn_kernel_gpu,2320,1,1,302891,128,0,0,0,0,1,38770000
nn_kernel_gpu_mem,57423,1,1,302891,128,310160000,155080000,155080000,310160000,1,38770000
nn_kernel_cpu,25261,0,1,1,64,0,0,0,0,1,38780000
nn_kernel_gpu,2311,1,1,302969,128,0,0,0,0,1,38780000
nn_kernel_gpu_mem,48305,1,1,302969,128,310240000,155120000,155120000,310240000,1,38780000
nn_kernel_cpu,18600,0,1,1,64,0,0,0,0,1,38790000
nn_kernel_gpu,2311,1,1,303047,128,0,0,0,0,1,38790000
nn_kernel_gpu_mem,57197,1,1,303047,128,310320000,155160000,155160000,310320000,1,38790000
nn_kernel_cpu,20285,0,1,1,64,0,0,0,0,1,38800000
nn_kernel_gpu,2325,1,1,303125,128,0,0,0,0,1,38800000
nn_kernel_gpu_mem,57872,1,1,303125,128,310400000,155200000,155200000,310400000,1,38800000
nn_kernel_cpu,7354,0,1,1,64,0,0,0,0,1,3880000
nn_kernel_gpu,281,1,1,30313,128,0,0,0,0,1,3880000
nn_kernel_gpu_mem,6267,1,1,30313,128,31040000,15520000,15520000,31040000,1,3880000
nn_kernel_cpu,17464,0,1,1,64,0,0,0,0,1,38810000
nn_kernel_gpu,2339,1,1,303204,128,0,0,0,0,1,38810000
nn_kernel_gpu_mem,50069,1,1,303204,128,310480000,155240000,155240000,310480000,1,38810000
nn_kernel_cpu,17180,0,1,1,64,0,0,0,0,1,38820000
nn_kernel_gpu,2324,1,1,303282,128,0,0,0,0,1,38820000
nn_kernel_gpu_mem,57993,1,1,303282,128,310560000,155280000,155280000,310560000,1,38820000
nn_kernel_cpu,9159,0,1,1,64,0,0,0,0,1,38830000
nn_kernel_gpu,2283,1,1,303360,128,0,0,0,0,1,38830000
nn_kernel_gpu_mem,48752,1,1,303360,128,310640000,155320000,155320000,310640000,1,38830000
nn_kernel_cpu,23389,0,1,1,64,0,0,0,0,1,38840000
nn_kernel_gpu,2350,1,1,303438,128,0,0,0,0,1,38840000
nn_kernel_gpu_mem,58012,1,1,303438,128,310720000,155360000,155360000,310720000,1,38840000
nn_kernel_cpu,25655,0,1,1,64,0,0,0,0,1,38850000
nn_kernel_gpu,2328,1,1,303516,128,0,0,0,0,1,38850000
nn_kernel_gpu_mem,56775,1,1,303516,128,310800000,155400000,155400000,310800000,1,38850000
nn_kernel_cpu,25931,0,1,1,64,0,0,0,0,1,38860000
nn_kernel_gpu,2302,1,1,303594,128,0,0,0,0,1,38860000
nn_kernel_gpu_mem,48689,1,1,303594,128,310880000,155440000,155440000,310880000,1,38860000
nn_kernel_cpu,22701,0,1,1,64,0,0,0,0,1,38870000
nn_kernel_gpu,2344,1,1,303672,128,0,0,0,0,1,38870000
nn_kernel_gpu_mem,48052,1,1,303672,128,310960000,155480000,155480000,310960000,1,38870000
nn_kernel_cpu,26826,0,1,1,64,0,0,0,0,1,38880000
nn_kernel_gpu,2326,1,1,303750,128,0,0,0,0,1,38880000
nn_kernel_gpu_mem,50067,1,1,303750,128,311040000,155520000,155520000,311040000,1,38880000
nn_kernel_cpu,13024,0,1,1,64,0,0,0,0,1,38890000
nn_kernel_gpu,2308,1,1,303829,128,0,0,0,0,1,38890000
nn_kernel_gpu_mem,51330,1,1,303829,128,311120000,155560000,155560000,311120000,1,38890000
nn_kernel_cpu,26559,0,1,1,64,0,0,0,0,1,38900000
nn_kernel_gpu,2320,1,1,303907,128,0,0,0,0,1,38900000
nn_kernel_gpu_mem,57597,1,1,303907,128,311200000,155600000,155600000,311200000,1,38900000
nn_kernel_cpu,33703,0,1,1,64,0,0,0,0,1,3890000
nn_kernel_gpu,265,1,1,30391,128,0,0,0,0,1,3890000
nn_kernel_gpu_mem,6151,1,1,30391,128,31120000,15560000,15560000,31120000,1,3890000
nn_kernel_cpu,18135,0,1,1,64,0,0,0,0,1,38910000
nn_kernel_gpu,2324,1,1,303985,128,0,0,0,0,1,38910000
nn_kernel_gpu_mem,56971,1,1,303985,128,311280000,155640000,155640000,311280000,1,38910000
nn_kernel_cpu,18829,0,1,1,64,0,0,0,0,1,38920000
nn_kernel_gpu,2330,1,1,304063,128,0,0,0,0,1,38920000
nn_kernel_gpu_mem,56966,1,1,304063,128,311360000,155680000,155680000,311360000,1,38920000
nn_kernel_cpu,16236,0,1,1,64,0,0,0,0,1,38930000
nn_kernel_gpu,2318,1,1,304141,128,0,0,0,0,1,38930000
nn_kernel_gpu_mem,44526,1,1,304141,128,311440000,155720000,155720000,311440000,1,38930000
nn_kernel_cpu,9345,0,1,1,64,0,0,0,0,1,38940000
nn_kernel_gpu,2317,1,1,304219,128,0,0,0,0,1,38940000
nn_kernel_gpu_mem,49365,1,1,304219,128,311520000,155760000,155760000,311520000,1,38940000
nn_kernel_cpu,28979,0,1,1,64,0,0,0,0,1,38950000
nn_kernel_gpu,2318,1,1,304297,128,0,0,0,0,1,38950000
nn_kernel_gpu_mem,58727,1,1,304297,128,311600000,155800000,155800000,311600000,1,38950000
nn_kernel_cpu,13773,0,1,1,64,0,0,0,0,1,38960000
nn_kernel_gpu,2327,1,1,304375,128,0,0,0,0,1,38960000
nn_kernel_gpu_mem,58161,1,1,304375,128,311680000,155840000,155840000,311680000,1,38960000
nn_kernel_cpu,20643,0,1,1,64,0,0,0,0,1,38970000
nn_kernel_gpu,2312,1,1,304454,128,0,0,0,0,1,38970000
nn_kernel_gpu_mem,52446,1,1,304454,128,311760000,155880000,155880000,311760000,1,38970000
nn_kernel_cpu,35126,0,1,1,64,0,0,0,0,1,38980000
nn_kernel_gpu,2333,1,1,304532,128,0,0,0,0,1,38980000
nn_kernel_gpu_mem,58646,1,1,304532,128,311840000,155920000,155920000,311840000,1,38980000
nn_kernel_cpu,37983,0,1,1,64,0,0,0,0,1,38990000
nn_kernel_gpu,2356,1,1,304610,128,0,0,0,0,1,38990000
nn_kernel_gpu_mem,45516,1,1,304610,128,311920000,155960000,155960000,311920000,1,38990000
nn_kernel_cpu,24575,0,1,1,64,0,0,0,0,1,39000000
nn_kernel_gpu,2318,1,1,304688,128,0,0,0,0,1,39000000
nn_kernel_gpu_mem,47851,1,1,304688,128,312000000,156000000,156000000,312000000,1,39000000
nn_kernel_cpu,25252,0,1,1,64,0,0,0,0,1,3900000
nn_kernel_gpu,291,1,1,30469,128,0,0,0,0,1,3900000
nn_kernel_gpu_mem,13950,1,1,30469,128,31200000,15600000,15600000,31200000,1,3900000
nn_kernel_cpu,19867,0,1,1,64,0,0,0,0,1,390000
nn_kernel_gpu,73,1,1,3047,128,0,0,0,0,1,390000
nn_kernel_gpu_mem,860,1,1,3047,128,3120000,1560000,1560000,3120000,1,390000
nn_kernel_cpu,18505,0,1,1,64,0,0,0,0,1,39010000
nn_kernel_gpu,2340,1,1,304766,128,0,0,0,0,1,39010000
nn_kernel_gpu_mem,50112,1,1,304766,128,312080000,156040000,156040000,312080000,1,39010000
nn_kernel_cpu,9112,0,1,1,64,0,0,0,0,1,39020000
nn_kernel_gpu,2335,1,1,304844,128,0,0,0,0,1,39020000
nn_kernel_gpu_mem,57243,1,1,304844,128,312160000,156080000,156080000,312160000,1,39020000
nn_kernel_cpu,23370,0,1,1,64,0,0,0,0,1,39030000
nn_kernel_gpu,2324,1,1,304922,128,0,0,0,0,1,39030000
nn_kernel_gpu_mem,58386,1,1,304922,128,312240000,156120000,156120000,312240000,1,39030000
nn_kernel_cpu,13036,0,1,1,64,0,0,0,0,1,39040000
nn_kernel_gpu,2306,1,1,305000,128,0,0,0,0,1,39040000
nn_kernel_gpu_mem,44613,1,1,305000,128,312320000,156160000,156160000,312320000,1,39040000
nn_kernel_cpu,41732,0,1,1,64,0,0,0,0,1,39050000
nn_kernel_gpu,2393,1,1,305079,128,0,0,0,0,1,39050000
nn_kernel_gpu_mem,56552,1,1,305079,128,312400000,156200000,156200000,312400000,1,39050000
nn_kernel_cpu,20351,0,1,1,64,0,0,0,0,1,39060000
nn_kernel_gpu,2328,1,1,305157,128,0,0,0,0,1,39060000
nn_kernel_gpu_mem,56502,1,1,305157,128,312480000,156240000,156240000,312480000,1,39060000
nn_kernel_cpu,17903,0,1,1,64,0,0,0,0,1,39070000
nn_kernel_gpu,2339,1,1,305235,128,0,0,0,0,1,39070000
nn_kernel_gpu_mem,58789,1,1,305235,128,312560000,156280000,156280000,312560000,1,39070000
nn_kernel_cpu,25456,0,1,1,64,0,0,0,0,1,39080000
nn_kernel_gpu,2330,1,1,305313,128,0,0,0,0,1,39080000
nn_kernel_gpu_mem,50315,1,1,305313,128,312640000,156320000,156320000,312640000,1,39080000
nn_kernel_cpu,31236,0,1,1,64,0,0,0,0,1,39090000
nn_kernel_gpu,2339,1,1,305391,128,0,0,0,0,1,39090000
nn_kernel_gpu_mem,56675,1,1,305391,128,312720000,156360000,156360000,312720000,1,39090000
nn_kernel_cpu,9652,0,1,1,64,0,0,0,0,1,39100000
nn_kernel_gpu,2342,1,1,305469,128,0,0,0,0,1,39100000
nn_kernel_gpu_mem,57376,1,1,305469,128,312800000,156400000,156400000,312800000,1,39100000
nn_kernel_cpu,3572,0,1,1,64,0,0,0,0,1,3910000
nn_kernel_gpu,294,1,1,30547,128,0,0,0,0,1,3910000
nn_kernel_gpu_mem,5809,1,1,30547,128,31280000,15640000,15640000,31280000,1,3910000
nn_kernel_cpu,28073,0,1,1,64,0,0,0,0,1,39110000
nn_kernel_gpu,2340,1,1,305547,128,0,0,0,0,1,39110000
nn_kernel_gpu_mem,58387,1,1,305547,128,312880000,156440000,156440000,312880000,1,39110000
nn_kernel_cpu,24306,0,1,1,64,0,0,0,0,1,39120000
nn_kernel_gpu,2335,1,1,305625,128,0,0,0,0,1,39120000
nn_kernel_gpu_mem,45410,1,1,305625,128,312960000,156480000,156480000,312960000,1,39120000
nn_kernel_cpu,29387,0,1,1,64,0,0,0,0,1,39130000
nn_kernel_gpu,2329,1,1,305704,128,0,0,0,0,1,39130000
nn_kernel_gpu_mem,59812,1,1,305704,128,313040000,156520000,156520000,313040000,1,39130000
nn_kernel_cpu,20174,0,1,1,64,0,0,0,0,1,39140000
nn_kernel_gpu,2330,1,1,305782,128,0,0,0,0,1,39140000
nn_kernel_gpu_mem,58777,1,1,305782,128,313120000,156560000,156560000,313120000,1,39140000
nn_kernel_cpu,24276,0,1,1,64,0,0,0,0,1,39150000
nn_kernel_gpu,2338,1,1,305860,128,0,0,0,0,1,39150000
nn_kernel_gpu_mem,49074,1,1,305860,128,313200000,156600000,156600000,313200000,1,39150000
nn_kernel_cpu,20063,0,1,1,64,0,0,0,0,1,39160000
nn_kernel_gpu,2343,1,1,305938,128,0,0,0,0,1,39160000
nn_kernel_gpu_mem,57701,1,1,305938,128,313280000,156640000,156640000,313280000,1,39160000
nn_kernel_cpu,19030,0,1,1,64,0,0,0,0,1,39170000
nn_kernel_gpu,2338,1,1,306016,128,0,0,0,0,1,39170000
nn_kernel_gpu_mem,47761,1,1,306016,128,313360000,156680000,156680000,313360000,1,39170000
nn_kernel_cpu,15269,0,1,1,64,0,0,0,0,1,39180000
nn_kernel_gpu,2352,1,1,306094,128,0,0,0,0,1,39180000
nn_kernel_gpu_mem,45522,1,1,306094,128,313440000,156720000,156720000,313440000,1,39180000
nn_kernel_cpu,29744,0,1,1,64,0,0,0,0,1,39190000
nn_kernel_gpu,2333,1,1,306172,128,0,0,0,0,1,39190000
nn_kernel_gpu_mem,58487,1,1,306172,128,313520000,156760000,156760000,313520000,1,39190000
nn_kernel_cpu,18140,0,1,1,64,0,0,0,0,1,39200000
nn_kernel_gpu,2362,1,1,306250,128,0,0,0,0,1,39200000
nn_kernel_gpu_mem,51617,1,1,306250,128,313600000,156800000,156800000,313600000,1,39200000
nn_kernel_cpu,23715,0,1,1,64,0,0,0,0,1,3920000
nn_kernel_gpu,284,1,1,30625,128,0,0,0,0,1,3920000
nn_kernel_gpu_mem,6267,1,1,30625,128,31360000,15680000,15680000,31360000,1,3920000
nn_kernel_cpu,31781,0,1,1,64,0,0,0,0,1,39210000
nn_kernel_gpu,2354,1,1,306329,128,0,0,0,0,1,39210000
nn_kernel_gpu_mem,58464,1,1,306329,128,313680000,156840000,156840000,313680000,1,39210000
nn_kernel_cpu,11520,0,1,1,64,0,0,0,0,1,39220000
nn_kernel_gpu,2341,1,1,306407,128,0,0,0,0,1,39220000
nn_kernel_gpu_mem,45631,1,1,306407,128,313760000,156880000,156880000,313760000,1,39220000
nn_kernel_cpu,27596,0,1,1,64,0,0,0,0,1,39230000
nn_kernel_gpu,2342,1,1,306485,128,0,0,0,0,1,39230000
nn_kernel_gpu_mem,56319,1,1,306485,128,313840000,156920000,156920000,313840000,1,39230000
nn_kernel_cpu,20355,0,1,1,64,0,0,0,0,1,39240000
nn_kernel_gpu,2346,1,1,306563,128,0,0,0,0,1,39240000
nn_kernel_gpu_mem,52980,1,1,306563,128,313920000,156960000,156960000,313920000,1,39240000
nn_kernel_cpu,17416,0,1,1,64,0,0,0,0,1,39250000
nn_kernel_gpu,2330,1,1,306641,128,0,0,0,0,1,39250000
nn_kernel_gpu_mem,56046,1,1,306641,128,314000000,157000000,157000000,314000000,1,39250000
nn_kernel_cpu,28032,0,1,1,64,0,0,0,0,1,39260000
nn_kernel_gpu,2348,1,1,306719,128,0,0,0,0,1,39260000
nn_kernel_gpu_mem,52975,1,1,306719,128,314080000,157040000,157040000,314080000,1,39260000
nn_kernel_cpu,13085,0,1,1,64,0,0,0,0,1,39270000
nn_kernel_gpu,2330,1,1,306797,128,0,0,0,0,1,39270000
nn_kernel_gpu_mem,48668,1,1,306797,128,314160000,157080000,157080000,314160000,1,39270000
nn_kernel_cpu,48507,0,1,1,64,0,0,0,0,1,39280000
nn_kernel_gpu,2361,1,1,306875,128,0,0,0,0,1,39280000
nn_kernel_gpu_mem,59093,1,1,306875,128,314240000,157120000,157120000,314240000,1,39280000
nn_kernel_cpu,36771,0,1,1,64,0,0,0,0,1,39290000
nn_kernel_gpu,2371,1,1,306954,128,0,0,0,0,1,39290000
nn_kernel_gpu_mem,47569,1,1,306954,128,314320000,157160000,157160000,314320000,1,39290000
nn_kernel_cpu,18740,0,1,1,64,0,0,0,0,1,39300000
nn_kernel_gpu,2345,1,1,307032,128,0,0,0,0,1,39300000
nn_kernel_gpu_mem,58652,1,1,307032,128,314400000,157200000,157200000,314400000,1,39300000
nn_kernel_cpu,22266,0,1,1,64,0,0,0,0,1,3930000
nn_kernel_gpu,281,1,1,30704,128,0,0,0,0,1,3930000
nn_kernel_gpu_mem,6215,1,1,30704,128,31440000,15720000,15720000,31440000,1,3930000
nn_kernel_cpu,27140,0,1,1,64,0,0,0,0,1,39310000
nn_kernel_gpu,2351,1,1,307110,128,0,0,0,0,1,39310000
nn_kernel_gpu_mem,59173,1,1,307110,128,314480000,157240000,157240000,314480000,1,39310000
nn_kernel_cpu,23347,0,1,1,64,0,0,0,0,1,39320000
nn_kernel_gpu,2353,1,1,307188,128,0,0,0,0,1,39320000
nn_kernel_gpu_mem,59895,1,1,307188,128,314560000,157280000,157280000,314560000,1,39320000
nn_kernel_cpu,32006,0,1,1,64,0,0,0,0,1,39330000
nn_kernel_gpu,2330,1,1,307266,128,0,0,0,0,1,39330000
nn_kernel_gpu_mem,58137,1,1,307266,128,314640000,157320000,157320000,314640000,1,39330000
nn_kernel_cpu,20267,0,1,1,64,0,0,0,0,1,39340000
nn_kernel_gpu,2334,1,1,307344,128,0,0,0,0,1,39340000
nn_kernel_gpu_mem,59427,1,1,307344,128,314720000,157360000,157360000,314720000,1,39340000
nn_kernel_cpu,15747,0,1,1,64,0,0,0,0,1,39350000
nn_kernel_gpu,2378,1,1,307422,128,0,0,0,0,1,39350000
nn_kernel_gpu_mem,55391,1,1,307422,128,314800000,157400000,157400000,314800000,1,39350000
nn_kernel_cpu,13426,0,1,1,64,0,0,0,0,1,39360000
nn_kernel_gpu,2332,1,1,307500,128,0,0,0,0,1,39360000
nn_kernel_gpu_mem,50584,1,1,307500,128,314880000,157440000,157440000,314880000,1,39360000
nn_kernel_cpu,13270,0,1,1,64,0,0,0,0,1,39370000
nn_kernel_gpu,2331,1,1,307579,128,0,0,0,0,1,39370000
nn_kernel_gpu_mem,49856,1,1,307579,128,314960000,157480000,157480000,314960000,1,39370000
nn_kernel_cpu,16320,0,1,1,64,0,0,0,0,1,39380000
nn_kernel_gpu,2354,1,1,307657,128,0,0,0,0,1,39380000
nn_kernel_gpu_mem,59486,1,1,307657,128,315040000,157520000,157520000,315040000,1,39380000
nn_kernel_cpu,18101,0,1,1,64,0,0,0,0,1,39390000
nn_kernel_gpu,2353,1,1,307735,128,0,0,0,0,1,39390000
nn_kernel_gpu_mem,58404,1,1,307735,128,315120000,157560000,157560000,315120000,1,39390000
nn_kernel_cpu,18750,0,1,1,64,0,0,0,0,1,39400000
nn_kernel_gpu,2341,1,1,307813,128,0,0,0,0,1,39400000
nn_kernel_gpu_mem,51307,1,1,307813,128,315200000,157600000,157600000,315200000,1,39400000
nn_kernel_cpu,7901,0,1,1,64,0,0,0,0,1,3940000
nn_kernel_gpu,289,1,1,30782,128,0,0,0,0,1,3940000
nn_kernel_gpu_mem,6360,1,1,30782,128,31520000,15760000,15760000,31520000,1,3940000
nn_kernel_cpu,18770,0,1,1,64,0,0,0,0,1,39410000
nn_kernel_gpu,2350,1,1,307891,128,0,0,0,0,1,39410000
nn_kernel_gpu_mem,58105,1,1,307891,128,315280000,157640000,157640000,315280000,1,39410000
nn_kernel_cpu,25498,0,1,1,64,0,0,0,0,1,39420000
nn_kernel_gpu,2372,1,1,307969,128,0,0,0,0,1,39420000
nn_kernel_gpu_mem,59035,1,1,307969,128,315360000,157680000,157680000,315360000,1,39420000
nn_kernel_cpu,9214,0,1,1,64,0,0,0,0,1,39430000
nn_kernel_gpu,2334,1,1,308047,128,0,0,0,0,1,39430000
nn_kernel_gpu_mem,47206,1,1,308047,128,315440000,157720000,157720000,315440000,1,39430000
nn_kernel_cpu,18904,0,1,1,64,0,0,0,0,1,39440000
nn_kernel_gpu,2356,1,1,308125,128,0,0,0,0,1,39440000
nn_kernel_gpu_mem,58793,1,1,308125,128,315520000,157760000,157760000,315520000,1,39440000
nn_kernel_cpu,13080,0,1,1,64,0,0,0,0,1,39450000
nn_kernel_gpu,2345,1,1,308204,128,0,0,0,0,1,39450000
nn_kernel_gpu_mem,58625,1,1,308204,128,315600000,157800000,157800000,315600000,1,39450000
nn_kernel_cpu,18509,0,1,1,64,0,0,0,0,1,39460000
nn_kernel_gpu,2351,1,1,308282,128,0,0,0,0,1,39460000
nn_kernel_gpu_mem,59351,1,1,308282,128,315680000,157840000,157840000,315680000,1,39460000
nn_kernel_cpu,16850,0,1,1,64,0,0,0,0,1,39470000
nn_kernel_gpu,2343,1,1,308360,128,0,0,0,0,1,39470000
nn_kernel_gpu_mem,52456,1,1,308360,128,315760000,157880000,157880000,315760000,1,39470000
nn_kernel_cpu,40379,0,1,1,64,0,0,0,0,1,39480000
nn_kernel_gpu,2343,1,1,308438,128,0,0,0,0,1,39480000
nn_kernel_gpu_mem,46854,1,1,308438,128,315840000,157920000,157920000,315840000,1,39480000
nn_kernel_cpu,28972,0,1,1,64,0,0,0,0,1,39490000
nn_kernel_gpu,2338,1,1,308516,128,0,0,0,0,1,39490000
nn_kernel_gpu_mem,59419,1,1,308516,128,315920000,157960000,157960000,315920000,1,39490000
nn_kernel_cpu,15884,0,1,1,64,0,0,0,0,1,39500000
nn_kernel_gpu,2349,1,1,308594,128,0,0,0,0,1,39500000
nn_kernel_gpu_mem,59360,1,1,308594,128,316000000,158000000,158000000,316000000,1,39500000
nn_kernel_cpu,19601,0,1,1,64,0,0,0,0,1,3950000
nn_kernel_gpu,286,1,1,30860,128,0,0,0,0,1,3950000
nn_kernel_gpu_mem,6011,1,1,30860,128,31600000,15800000,15800000,31600000,1,3950000
nn_kernel_cpu,17899,0,1,1,64,0,0,0,0,1,39510000
nn_kernel_gpu,2347,1,1,308672,128,0,0,0,0,1,39510000
nn_kernel_gpu_mem,60501,1,1,308672,128,316080000,158040000,158040000,316080000,1,39510000
nn_kernel_cpu,9250,0,1,1,64,0,0,0,0,1,39520000
nn_kernel_gpu,2358,1,1,308750,128,0,0,0,0,1,39520000
nn_kernel_gpu_mem,60726,1,1,308750,128,316160000,158080000,158080000,316160000,1,39520000
nn_kernel_cpu,15282,0,1,1,64,0,0,0,0,1,39530000
nn_kernel_gpu,2390,1,1,308829,128,0,0,0,0,1,39530000
nn_kernel_gpu_mem,57293,1,1,308829,128,316240000,158120000,158120000,316240000,1,39530000
nn_kernel_cpu,12028,0,1,1,64,0,0,0,0,1,39540000
nn_kernel_gpu,2344,1,1,308907,128,0,0,0,0,1,39540000
nn_kernel_gpu_mem,58648,1,1,308907,128,316320000,158160000,158160000,316320000,1,39540000
nn_kernel_cpu,24167,0,1,1,64,0,0,0,0,1,39550000
nn_kernel_gpu,2350,1,1,308985,128,0,0,0,0,1,39550000
nn_kernel_gpu_mem,59737,1,1,308985,128,316400000,158200000,158200000,316400000,1,39550000
nn_kernel_cpu,15574,0,1,1,64,0,0,0,0,1,39560000
nn_kernel_gpu,2381,1,1,309063,128,0,0,0,0,1,39560000
nn_kernel_gpu_mem,50232,1,1,309063,128,316480000,158240000,158240000,316480000,1,39560000
nn_kernel_cpu,35584,0,1,1,64,0,0,0,0,1,39570000
nn_kernel_gpu,2393,1,1,309141,128,0,0,0,0,1,39570000
nn_kernel_gpu_mem,48387,1,1,309141,128,316560000,158280000,158280000,316560000,1,39570000
nn_kernel_cpu,22588,0,1,1,64,0,0,0,0,1,39580000
nn_kernel_gpu,2351,1,1,309219,128,0,0,0,0,1,39580000
nn_kernel_gpu_mem,45922,1,1,309219,128,316640000,158320000,158320000,316640000,1,39580000
nn_kernel_cpu,19531,0,1,1,64,0,0,0,0,1,39590000
nn_kernel_gpu,2348,1,1,309297,128,0,0,0,0,1,39590000
nn_kernel_gpu_mem,58690,1,1,309297,128,316720000,158360000,158360000,316720000,1,39590000
nn_kernel_cpu,28197,0,1,1,64,0,0,0,0,1,39600000
nn_kernel_gpu,2359,1,1,309375,128,0,0,0,0,1,39600000
nn_kernel_gpu_mem,50910,1,1,309375,128,316800000,158400000,158400000,316800000,1,39600000
nn_kernel_cpu,8034,0,1,1,64,0,0,0,0,1,3960000
nn_kernel_gpu,290,1,1,30938,128,0,0,0,0,1,3960000
nn_kernel_gpu_mem,6323,1,1,30938,128,31680000,15840000,15840000,31680000,1,3960000
nn_kernel_cpu,25959,0,1,1,64,0,0,0,0,1,39610000
nn_kernel_gpu,2362,1,1,309454,128,0,0,0,0,1,39610000
nn_kernel_gpu_mem,59396,1,1,309454,128,316880000,158440000,158440000,316880000,1,39610000
nn_kernel_cpu,9906,0,1,1,64,0,0,0,0,1,39620000
nn_kernel_gpu,2350,1,1,309532,128,0,0,0,0,1,39620000
nn_kernel_gpu_mem,58751,1,1,309532,128,316960000,158480000,158480000,316960000,1,39620000
nn_kernel_cpu,27096,0,1,1,64,0,0,0,0,1,39630000
nn_kernel_gpu,2360,1,1,309610,128,0,0,0,0,1,39630000
nn_kernel_gpu_mem,61856,1,1,309610,128,317040000,158520000,158520000,317040000,1,39630000
nn_kernel_cpu,12716,0,1,1,64,0,0,0,0,1,39640000
nn_kernel_gpu,2371,1,1,309688,128,0,0,0,0,1,39640000
nn_kernel_gpu_mem,59799,1,1,309688,128,317120000,158560000,158560000,317120000,1,39640000
nn_kernel_cpu,32062,0,1,1,64,0,0,0,0,1,39650000
nn_kernel_gpu,2358,1,1,309766,128,0,0,0,0,1,39650000
nn_kernel_gpu_mem,57914,1,1,309766,128,317200000,158600000,158600000,317200000,1,39650000
nn_kernel_cpu,34920,0,1,1,64,0,0,0,0,1,39660000
nn_kernel_gpu,2351,1,1,309844,128,0,0,0,0,1,39660000
nn_kernel_gpu_mem,58450,1,1,309844,128,317280000,158640000,158640000,317280000,1,39660000
nn_kernel_cpu,48511,0,1,1,64,0,0,0,0,1,39670000
nn_kernel_gpu,2347,1,1,309922,128,0,0,0,0,1,39670000
nn_kernel_gpu_mem,60071,1,1,309922,128,317360000,158680000,158680000,317360000,1,39670000
nn_kernel_cpu,12859,0,1,1,64,0,0,0,0,1,39680000
nn_kernel_gpu,2404,1,1,310000,128,0,0,0,0,1,39680000
nn_kernel_gpu_mem,57578,1,1,310000,128,317440000,158720000,158720000,317440000,1,39680000
nn_kernel_cpu,27001,0,1,1,64,0,0,0,0,1,39690000
nn_kernel_gpu,2346,1,1,310079,128,0,0,0,0,1,39690000
nn_kernel_gpu_mem,51573,1,1,310079,128,317520000,158760000,158760000,317520000,1,39690000
nn_kernel_cpu,27944,0,1,1,64,0,0,0,0,1,39700000
nn_kernel_gpu,2366,1,1,310157,128,0,0,0,0,1,39700000
nn_kernel_gpu_mem,58613,1,1,310157,128,317600000,158800000,158800000,317600000,1,39700000
nn_kernel_cpu,15869,0,1,1,64,0,0,0,0,1,3970000
nn_kernel_gpu,293,1,1,31016,128,0,0,0,0,1,3970000
nn_kernel_gpu_mem,5895,1,1,31016,128,31760000,15880000,15880000,31760000,1,3970000
nn_kernel_cpu,33900,0,1,1,64,0,0,0,0,1,39710000
nn_kernel_gpu,2357,1,1,310235,128,0,0,0,0,1,39710000
nn_kernel_gpu_mem,57878,1,1,310235,128,317680000,158840000,158840000,317680000,1,39710000
nn_kernel_cpu,6355,0,1,1,64,0,0,0,0,1,39720000
nn_kernel_gpu,2346,1,1,310313,128,0,0,0,0,1,39720000
nn_kernel_gpu_mem,58619,1,1,310313,128,317760000,158880000,158880000,317760000,1,39720000
nn_kernel_cpu,31540,0,1,1,64,0,0,0,0,1,39730000
nn_kernel_gpu,2346,1,1,310391,128,0,0,0,0,1,39730000
nn_kernel_gpu_mem,51023,1,1,310391,128,317840000,158920000,158920000,317840000,1,39730000
nn_kernel_cpu,33727,0,1,1,64,0,0,0,0,1,39740000
nn_kernel_gpu,2365,1,1,310469,128,0,0,0,0,1,39740000
nn_kernel_gpu_mem,50086,1,1,310469,128,317920000,158960000,158960000,317920000,1,39740000
nn_kernel_cpu,27985,0,1,1,64,0,0,0,0,1,39750000
nn_kernel_gpu,2361,1,1,310547,128,0,0,0,0,1,39750000
nn_kernel_gpu_mem,55730,1,1,310547,128,318000000,159000000,159000000,318000000,1,39750000
nn_kernel_cpu,21630,0,1,1,64,0,0,0,0,1,39760000
nn_kernel_gpu,2361,1,1,310625,128,0,0,0,0,1,39760000
nn_kernel_gpu_mem,59854,1,1,310625,128,318080000,159040000,159040000,318080000,1,39760000
nn_kernel_cpu,37718,0,1,1,64,0,0,0,0,1,39770000
nn_kernel_gpu,2392,1,1,310704,128,0,0,0,0,1,39770000
nn_kernel_gpu_mem,59591,1,1,310704,128,318160000,159080000,159080000,318160000,1,39770000
nn_kernel_cpu,16093,0,1,1,64,0,0,0,0,1,39780000
nn_kernel_gpu,2350,1,1,310782,128,0,0,0,0,1,39780000
nn_kernel_gpu_mem,59873,1,1,310782,128,318240000,159120000,159120000,318240000,1,39780000
nn_kernel_cpu,12145,0,1,1,64,0,0,0,0,1,39790000
nn_kernel_gpu,2358,1,1,310860,128,0,0,0,0,1,39790000
nn_kernel_gpu_mem,60304,1,1,310860,128,318320000,159160000,159160000,318320000,1,39790000
nn_kernel_cpu,40993,0,1,1,64,0,0,0,0,1,39800000
nn_kernel_gpu,2365,1,1,310938,128,0,0,0,0,1,39800000
nn_kernel_gpu_mem,54950,1,1,310938,128,318400000,159200000,159200000,318400000,1,39800000
nn_kernel_cpu,34509,0,1,1,64,0,0,0,0,1,3980000
nn_kernel_gpu,300,1,1,31094,128,0,0,0,0,1,3980000
nn_kernel_gpu_mem,5952,1,1,31094,128,31840000,15920000,15920000,31840000,1,3980000
nn_kernel_cpu,25554,0,1,1,64,0,0,0,0,1,39810000
nn_kernel_gpu,2370,1,1,311016,128,0,0,0,0,1,39810000
nn_kernel_gpu_mem,55892,1,1,311016,128,318480000,159240000,159240000,318480000,1,39810000
nn_kernel_cpu,21209,0,1,1,64,0,0,0,0,1,39820000
nn_kernel_gpu,2364,1,1,311094,128,0,0,0,0,1,39820000
nn_kernel_gpu_mem,55046,1,1,311094,128,318560000,159280000,159280000,318560000,1,39820000
nn_kernel_cpu,20196,0,1,1,64,0,0,0,0,1,39830000
nn_kernel_gpu,2361,1,1,311172,128,0,0,0,0,1,39830000
nn_kernel_gpu_mem,42543,1,1,311172,128,318640000,159320000,159320000,318640000,1,39830000
nn_kernel_cpu,25356,0,1,1,64,0,0,0,0,1,39840000
nn_kernel_gpu,2362,1,1,311250,128,0,0,0,0,1,39840000
nn_kernel_gpu_mem,51135,1,1,311250,128,318720000,159360000,159360000,318720000,1,39840000
nn_kernel_cpu,35871,0,1,1,64,0,0,0,0,1,39850000
nn_kernel_gpu,2354,1,1,311329,128,0,0,0,0,1,39850000
nn_kernel_gpu_mem,60881,1,1,311329,128,318800000,159400000,159400000,318800000,1,39850000
nn_kernel_cpu,18288,0,1,1,64,0,0,0,0,1,39860000
nn_kernel_gpu,2369,1,1,311407,128,0,0,0,0,1,39860000
nn_kernel_gpu_mem,58620,1,1,311407,128,318880000,159440000,159440000,318880000,1,39860000
nn_kernel_cpu,27982,0,1,1,64,0,0,0,0,1,39870000
nn_kernel_gpu,2349,1,1,311485,128,0,0,0,0,1,39870000
nn_kernel_gpu_mem,65165,1,1,311485,128,318960000,159480000,159480000,318960000,1,39870000
nn_kernel_cpu,13575,0,1,1,64,0,0,0,0,1,39880000
nn_kernel_gpu,2367,1,1,311563,128,0,0,0,0,1,39880000
nn_kernel_gpu_mem,59675,1,1,311563,128,319040000,159520000,159520000,319040000,1,39880000
nn_kernel_cpu,34820,0,1,1,64,0,0,0,0,1,39890000
nn_kernel_gpu,2373,1,1,311641,128,0,0,0,0,1,39890000
nn_kernel_gpu_mem,57309,1,1,311641,128,319120000,159560000,159560000,319120000,1,39890000
nn_kernel_cpu,17830,0,1,1,64,0,0,0,0,1,39900000
nn_kernel_gpu,2374,1,1,311719,128,0,0,0,0,1,39900000
nn_kernel_gpu_mem,54105,1,1,311719,128,319200000,159600000,159600000,319200000,1,39900000
nn_kernel_cpu,10909,0,1,1,64,0,0,0,0,1,3990000
nn_kernel_gpu,291,1,1,31172,128,0,0,0,0,1,3990000
nn_kernel_gpu_mem,6897,1,1,31172,128,31920000,15960000,15960000,31920000,1,3990000
nn_kernel_cpu,32315,0,1,1,64,0,0,0,0,1,39910000
nn_kernel_gpu,2378,1,1,311797,128,0,0,0,0,1,39910000
nn_kernel_gpu_mem,55621,1,1,311797,128,319280000,159640000,159640000,319280000,1,39910000
nn_kernel_cpu,25999,0,1,1,64,0,0,0,0,1,39920000
nn_kernel_gpu,2363,1,1,311875,128,0,0,0,0,1,39920000
nn_kernel_gpu_mem,51680,1,1,311875,128,319360000,159680000,159680000,319360000,1,39920000
nn_kernel_cpu,27081,0,1,1,64,0,0,0,0,1,39930000
nn_kernel_gpu,2389,1,1,311954,128,0,0,0,0,1,39930000
nn_kernel_gpu_mem,53376,1,1,311954,128,319440000,159720000,159720000,319440000,1,39930000
nn_kernel_cpu,9989,0,1,1,64,0,0,0,0,1,39940000
nn_kernel_gpu,2433,1,1,312032,128,0,0,0,0,1,39940000
nn_kernel_gpu_mem,48733,1,1,312032,128,319520000,159760000,159760000,319520000,1,39940000
nn_kernel_cpu,28501,0,1,1,64,0,0,0,0,1,39950000
nn_kernel_gpu,2381,1,1,312110,128,0,0,0,0,1,39950000
nn_kernel_gpu_mem,49823,1,1,312110,128,319600000,159800000,159800000,319600000,1,39950000
nn_kernel_cpu,26260,0,1,1,64,0,0,0,0,1,39960000
nn_kernel_gpu,2372,1,1,312188,128,0,0,0,0,1,39960000
nn_kernel_gpu_mem,66126,1,1,312188,128,319680000,159840000,159840000,319680000,1,39960000
nn_kernel_cpu,31707,0,1,1,64,0,0,0,0,1,39970000
nn_kernel_gpu,2389,1,1,312266,128,0,0,0,0,1,39970000
nn_kernel_gpu_mem,51804,1,1,312266,128,319760000,159880000,159880000,319760000,1,39970000
nn_kernel_cpu,21116,0,1,1,64,0,0,0,0,1,39980000
nn_kernel_gpu,2376,1,1,312344,128,0,0,0,0,1,39980000
nn_kernel_gpu_mem,62531,1,1,312344,128,319840000,159920000,159920000,319840000,1,39980000
nn_kernel_cpu,27652,0,1,1,64,0,0,0,0,1,39990000
nn_kernel_gpu,2385,1,1,312422,128,0,0,0,0,1,39990000
nn_kernel_gpu_mem,55050,1,1,312422,128,319920000,159960000,159960000,319920000,1,39990000
nn_kernel_cpu,25172,0,1,1,64,0,0,0,0,1,40000000
nn_kernel_gpu,2385,1,1,312500,128,0,0,0,0,1,40000000
nn_kernel_gpu_mem,52244,1,1,312500,128,320000000,160000000,160000000,320000000,1,40000000
nn_kernel_cpu,32742,0,1,1,64,0,0,0,0,1,4000000
nn_kernel_gpu,290,1,1,31250,128,0,0,0,0,1,4000000
nn_kernel_gpu_mem,5332,1,1,31250,128,32000000,16000000,16000000,32000000,1,4000000
nn_kernel_cpu,3661,0,1,1,64,0,0,0,0,1,400000
nn_kernel_gpu,91,1,1,3125,128,0,0,0,0,1,400000
nn_kernel_gpu_mem,1188,1,1,3125,128,3200000,1600000,1600000,3200000,1,400000
nn_kernel_cpu,28132,0,1,1,64,0,0,0,0,1,40000
nn_kernel_gpu,35,1,1,313,128,0,0,0,0,1,40000
nn_kernel_gpu_mem,104,1,1,313,128,320000,160000,160000,320000,1,40000
nn_kernel_cpu,35772,0,1,1,64,0,0,0,0,1,40010000
nn_kernel_gpu,2385,1,1,312579,128,0,0,0,0,1,40010000
nn_kernel_gpu_mem,55523,1,1,312579,128,320080000,160040000,160040000,320080000,1,40010000
nn_kernel_cpu,14882,0,1,1,64,0,0,0,0,1,40020000
nn_kernel_gpu,2387,1,1,312657,128,0,0,0,0,1,40020000
nn_kernel_gpu_mem,65927,1,1,312657,128,320160000,160080000,160080000,320160000,1,40020000
nn_kernel_cpu,34543,0,1,1,64,0,0,0,0,1,40030000
nn_kernel_gpu,2382,1,1,312735,128,0,0,0,0,1,40030000
nn_kernel_gpu_mem,55924,1,1,312735,128,320240000,160120000,160120000,320240000,1,40030000
nn_kernel_cpu,27544,0,1,1,64,0,0,0,0,1,40040000
nn_kernel_gpu,2390,1,1,312813,128,0,0,0,0,1,40040000
nn_kernel_gpu_mem,54980,1,1,312813,128,320320000,160160000,160160000,320320000,1,40040000
nn_kernel_cpu,28233,0,1,1,64,0,0,0,0,1,40050000
nn_kernel_gpu,2378,1,1,312891,128,0,0,0,0,1,40050000
nn_kernel_gpu_mem,52163,1,1,312891,128,320400000,160200000,160200000,320400000,1,40050000
nn_kernel_cpu,34954,0,1,1,64,0,0,0,0,1,40060000
nn_kernel_gpu,2391,1,1,312969,128,0,0,0,0,1,40060000
nn_kernel_gpu_mem,50970,1,1,312969,128,320480000,160240000,160240000,320480000,1,40060000
nn_kernel_cpu,25364,0,1,1,64,0,0,0,0,1,40070000
nn_kernel_gpu,2371,1,1,313047,128,0,0,0,0,1,40070000
nn_kernel_gpu_mem,55988,1,1,313047,128,320560000,160280000,160280000,320560000,1,40070000
nn_kernel_cpu,26220,0,1,1,64,0,0,0,0,1,40080000
nn_kernel_gpu,2393,1,1,313125,128,0,0,0,0,1,40080000
nn_kernel_gpu_mem,58282,1,1,313125,128,320640000,160320000,160320000,320640000,1,40080000
nn_kernel_cpu,9217,0,1,1,64,0,0,0,0,1,40090000
nn_kernel_gpu,2455,1,1,313204,128,0,0,0,0,1,40090000
nn_kernel_gpu_mem,53834,1,1,313204,128,320720000,160360000,160360000,320720000,1,40090000
nn_kernel_cpu,20819,0,1,1,64,0,0,0,0,1,40100000
nn_kernel_gpu,2438,1,1,313282,128,0,0,0,0,1,40100000
nn_kernel_gpu_mem,58735,1,1,313282,128,320800000,160400000,160400000,320800000,1,40100000
nn_kernel_cpu,23098,0,1,1,64,0,0,0,0,1,4010000
nn_kernel_gpu,289,1,1,31329,128,0,0,0,0,1,4010000
nn_kernel_gpu_mem,6144,1,1,31329,128,32080000,16040000,16040000,32080000,1,4010000
nn_kernel_cpu,29397,0,1,1,64,0,0,0,0,1,40110000
nn_kernel_gpu,2397,1,1,313360,128,0,0,0,0,1,40110000
nn_kernel_gpu_mem,54459,1,1,313360,128,320880000,160440000,160440000,320880000,1,40110000
nn_kernel_cpu,17647,0,1,1,64,0,0,0,0,1,40120000
nn_kernel_gpu,2366,1,1,313438,128,0,0,0,0,1,40120000
nn_kernel_gpu_mem,64203,1,1,313438,128,320960000,160480000,160480000,320960000,1,40120000
nn_kernel_cpu,40079,0,1,1,64,0,0,0,0,1,40130000
nn_kernel_gpu,2386,1,1,313516,128,0,0,0,0,1,40130000
nn_kernel_gpu_mem,52628,1,1,313516,128,321040000,160520000,160520000,321040000,1,40130000
nn_kernel_cpu,35385,0,1,1,64,0,0,0,0,1,40140000
nn_kernel_gpu,2395,1,1,313594,128,0,0,0,0,1,40140000
nn_kernel_gpu_mem,51931,1,1,313594,128,321120000,160560000,160560000,321120000,1,40140000
nn_kernel_cpu,26616,0,1,1,64,0,0,0,0,1,40150000
nn_kernel_gpu,2395,1,1,313672,128,0,0,0,0,1,40150000
nn_kernel_gpu_mem,55071,1,1,313672,128,321200000,160600000,160600000,321200000,1,40150000
nn_kernel_cpu,26570,0,1,1,64,0,0,0,0,1,40160000
nn_kernel_gpu,2396,1,1,313750,128,0,0,0,0,1,40160000
nn_kernel_gpu_mem,48093,1,1,313750,128,321280000,160640000,160640000,321280000,1,40160000
nn_kernel_cpu,15182,0,1,1,64,0,0,0,0,1,40170000
nn_kernel_gpu,2387,1,1,313829,128,0,0,0,0,1,40170000
nn_kernel_gpu_mem,50838,1,1,313829,128,321360000,160680000,160680000,321360000,1,40170000
nn_kernel_cpu,22598,0,1,1,64,0,0,0,0,1,40180000
nn_kernel_gpu,2394,1,1,313907,128,0,0,0,0,1,40180000
nn_kernel_gpu_mem,51288,1,1,313907,128,321440000,160720000,160720000,321440000,1,40180000
nn_kernel_cpu,25517,0,1,1,64,0,0,0,0,1,40190000
nn_kernel_gpu,2422,1,1,313985,128,0,0,0,0,1,40190000
nn_kernel_gpu_mem,54668,1,1,313985,128,321520000,160760000,160760000,321520000,1,40190000
nn_kernel_cpu,25892,0,1,1,64,0,0,0,0,1,40200000
nn_kernel_gpu,2406,1,1,314063,128,0,0,0,0,1,40200000
nn_kernel_gpu_mem,49685,1,1,314063,128,321600000,160800000,160800000,321600000,1,40200000
nn_kernel_cpu,27476,0,1,1,64,0,0,0,0,1,4020000
nn_kernel_gpu,295,1,1,31407,128,0,0,0,0,1,4020000
nn_kernel_gpu_mem,6231,1,1,31407,128,32160000,16080000,16080000,32160000,1,4020000
nn_kernel_cpu,27885,0,1,1,64,0,0,0,0,1,40210000
nn_kernel_gpu,2384,1,1,314141,128,0,0,0,0,1,40210000
nn_kernel_gpu_mem,56196,1,1,314141,128,321680000,160840000,160840000,321680000,1,40210000
nn_kernel_cpu,28222,0,1,1,64,0,0,0,0,1,40220000
nn_kernel_gpu,2391,1,1,314219,128,0,0,0,0,1,40220000
nn_kernel_gpu_mem,49410,1,1,314219,128,321760000,160880000,160880000,321760000,1,40220000
nn_kernel_cpu,25639,0,1,1,64,0,0,0,0,1,40230000
nn_kernel_gpu,2388,1,1,314297,128,0,0,0,0,1,40230000
nn_kernel_gpu_mem,56924,1,1,314297,128,321840000,160920000,160920000,321840000,1,40230000
nn_kernel_cpu,25648,0,1,1,64,0,0,0,0,1,40240000
nn_kernel_gpu,2394,1,1,314375,128,0,0,0,0,1,40240000
nn_kernel_gpu_mem,54031,1,1,314375,128,321920000,160960000,160960000,321920000,1,40240000
nn_kernel_cpu,25349,0,1,1,64,0,0,0,0,1,40250000
nn_kernel_gpu,2395,1,1,314454,128,0,0,0,0,1,40250000
nn_kernel_gpu_mem,55412,1,1,314454,128,322000000,161000000,161000000,322000000,1,40250000
nn_kernel_cpu,28459,0,1,1,64,0,0,0,0,1,40260000
nn_kernel_gpu,2387,1,1,314532,128,0,0,0,0,1,40260000
nn_kernel_gpu_mem,53067,1,1,314532,128,322080000,161040000,161040000,322080000,1,40260000
nn_kernel_cpu,41821,0,1,1,64,0,0,0,0,1,40270000
nn_kernel_gpu,2398,1,1,314610,128,0,0,0,0,1,40270000
nn_kernel_gpu_mem,55610,1,1,314610,128,322160000,161080000,161080000,322160000,1,40270000
nn_kernel_cpu,24466,0,1,1,64,0,0,0,0,1,40280000
nn_kernel_gpu,2388,1,1,314688,128,0,0,0,0,1,40280000
nn_kernel_gpu_mem,66751,1,1,314688,128,322240000,161120000,161120000,322240000,1,40280000
nn_kernel_cpu,27885,0,1,1,64,0,0,0,0,1,40290000
nn_kernel_gpu,2407,1,1,314766,128,0,0,0,0,1,40290000
nn_kernel_gpu_mem,51484,1,1,314766,128,322320000,161160000,161160000,322320000,1,40290000
nn_kernel_cpu,13328,0,1,1,64,0,0,0,0,1,40300000
nn_kernel_gpu,2437,1,1,314844,128,0,0,0,0,1,40300000
nn_kernel_gpu_mem,58961,1,1,314844,128,322400000,161200000,161200000,322400000,1,40300000
nn_kernel_cpu,28244,0,1,1,64,0,0,0,0,1,4030000
nn_kernel_gpu,290,1,1,31485,128,0,0,0,0,1,4030000
nn_kernel_gpu_mem,4921,1,1,31485,128,32240000,16120000,16120000,32240000,1,4030000
nn_kernel_cpu,41443,0,1,1,64,0,0,0,0,1,40310000
nn_kernel_gpu,2394,1,1,314922,128,0,0,0,0,1,40310000
nn_kernel_gpu_mem,55116,1,1,314922,128,322480000,161240000,161240000,322480000,1,40310000
nn_kernel_cpu,23573,0,1,1,64,0,0,0,0,1,40320000
nn_kernel_gpu,2444,1,1,315000,128,0,0,0,0,1,40320000
nn_kernel_gpu_mem,53846,1,1,315000,128,322560000,161280000,161280000,322560000,1,40320000
nn_kernel_cpu,23165,0,1,1,64,0,0,0,0,1,40330000
nn_kernel_gpu,2388,1,1,315079,128,0,0,0,0,1,40330000
nn_kernel_gpu_mem,50602,1,1,315079,128,322640000,161320000,161320000,322640000,1,40330000
nn_kernel_cpu,26061,0,1,1,64,0,0,0,0,1,40340000
nn_kernel_gpu,2388,1,1,315157,128,0,0,0,0,1,40340000
nn_kernel_gpu_mem,51336,1,1,315157,128,322720000,161360000,161360000,322720000,1,40340000
nn_kernel_cpu,24960,0,1,1,64,0,0,0,0,1,40350000
nn_kernel_gpu,2434,1,1,315235,128,0,0,0,0,1,40350000
nn_kernel_gpu_mem,51878,1,1,315235,128,322800000,161400000,161400000,322800000,1,40350000
nn_kernel_cpu,28722,0,1,1,64,0,0,0,0,1,40360000
nn_kernel_gpu,2392,1,1,315313,128,0,0,0,0,1,40360000
nn_kernel_gpu_mem,49796,1,1,315313,128,322880000,161440000,161440000,322880000,1,40360000
nn_kernel_cpu,23758,0,1,1,64,0,0,0,0,1,40370000
nn_kernel_gpu,2402,1,1,315391,128,0,0,0,0,1,40370000
nn_kernel_gpu_mem,56770,1,1,315391,128,322960000,161480000,161480000,322960000,1,40370000
nn_kernel_cpu,36865,0,1,1,64,0,0,0,0,1,40380000
nn_kernel_gpu,2431,1,1,315469,128,0,0,0,0,1,40380000
nn_kernel_gpu_mem,57556,1,1,315469,128,323040000,161520000,161520000,323040000,1,40380000
nn_kernel_cpu,28984,0,1,1,64,0,0,0,0,1,40390000
nn_kernel_gpu,2408,1,1,315547,128,0,0,0,0,1,40390000
nn_kernel_gpu_mem,48617,1,1,315547,128,323120000,161560000,161560000,323120000,1,40390000
nn_kernel_cpu,18330,0,1,1,64,0,0,0,0,1,40400000
nn_kernel_gpu,2418,1,1,315625,128,0,0,0,0,1,40400000
nn_kernel_gpu_mem,57931,1,1,315625,128,323200000,161600000,161600000,323200000,1,40400000
nn_kernel_cpu,8237,0,1,1,64,0,0,0,0,1,4040000
nn_kernel_gpu,274,1,1,31563,128,0,0,0,0,1,4040000
nn_kernel_gpu_mem,6385,1,1,31563,128,32320000,16160000,16160000,32320000,1,4040000
nn_kernel_cpu,11309,0,1,1,64,0,0,0,0,1,40410000
nn_kernel_gpu,2426,1,1,315704,128,0,0,0,0,1,40410000
nn_kernel_gpu_mem,51680,1,1,315704,128,323280000,161640000,161640000,323280000,1,40410000
nn_kernel_cpu,25882,0,1,1,64,0,0,0,0,1,40420000
nn_kernel_gpu,2424,1,1,315782,128,0,0,0,0,1,40420000
nn_kernel_gpu_mem,60354,1,1,315782,128,323360000,161680000,161680000,323360000,1,40420000
nn_kernel_cpu,27882,0,1,1,64,0,0,0,0,1,40430000
nn_kernel_gpu,2450,1,1,315860,128,0,0,0,0,1,40430000
nn_kernel_gpu_mem,49944,1,1,315860,128,323440000,161720000,161720000,323440000,1,40430000
nn_kernel_cpu,25426,0,1,1,64,0,0,0,0,1,40440000
nn_kernel_gpu,2420,1,1,315938,128,0,0,0,0,1,40440000
nn_kernel_gpu_mem,50415,1,1,315938,128,323520000,161760000,161760000,323520000,1,40440000
nn_kernel_cpu,22079,0,1,1,64,0,0,0,0,1,40450000
nn_kernel_gpu,2429,1,1,316016,128,0,0,0,0,1,40450000
nn_kernel_gpu_mem,51764,1,1,316016,128,323600000,161800000,161800000,323600000,1,40450000
nn_kernel_cpu,11551,0,1,1,64,0,0,0,0,1,40460000
nn_kernel_gpu,2413,1,1,316094,128,0,0,0,0,1,40460000
nn_kernel_gpu_mem,48127,1,1,316094,128,323680000,161840000,161840000,323680000,1,40460000
nn_kernel_cpu,22684,0,1,1,64,0,0,0,0,1,40470000
nn_kernel_gpu,2426,1,1,316172,128,0,0,0,0,1,40470000
nn_kernel_gpu_mem,60907,1,1,316172,128,323760000,161880000,161880000,323760000,1,40470000
nn_kernel_cpu,29375,0,1,1,64,0,0,0,0,1,40480000
nn_kernel_gpu,2440,1,1,316250,128,0,0,0,0,1,40480000
nn_kernel_gpu_mem,61674,1,1,316250,128,323840000,161920000,161920000,323840000,1,40480000
nn_kernel_cpu,18817,0,1,1,64,0,0,0,0,1,40490000
nn_kernel_gpu,2420,1,1,316329,128,0,0,0,0,1,40490000
nn_kernel_gpu_mem,60079,1,1,316329,128,323920000,161960000,161960000,323920000,1,40490000
nn_kernel_cpu,16520,0,1,1,64,0,0,0,0,1,40500000
nn_kernel_gpu,2429,1,1,316407,128,0,0,0,0,1,40500000
nn_kernel_gpu_mem,60089,1,1,316407,128,324000000,162000000,162000000,324000000,1,40500000
nn_kernel_cpu,15281,0,1,1,64,0,0,0,0,1,4050000
nn_kernel_gpu,296,1,1,31641,128,0,0,0,0,1,4050000
nn_kernel_gpu_mem,6102,1,1,31641,128,32400000,16200000,16200000,32400000,1,4050000
nn_kernel_cpu,25395,0,1,1,64,0,0,0,0,1,40510000
nn_kernel_gpu,2428,1,1,316485,128,0,0,0,0,1,40510000
nn_kernel_gpu_mem,52493,1,1,316485,128,324080000,162040000,162040000,324080000,1,40510000
nn_kernel_cpu,26645,0,1,1,64,0,0,0,0,1,40520000
nn_kernel_gpu,2432,1,1,316563,128,0,0,0,0,1,40520000
nn_kernel_gpu_mem,52424,1,1,316563,128,324160000,162080000,162080000,324160000,1,40520000
nn_kernel_cpu,20695,0,1,1,64,0,0,0,0,1,40530000
nn_kernel_gpu,2460,1,1,316641,128,0,0,0,0,1,40530000
nn_kernel_gpu_mem,50560,1,1,316641,128,324240000,162120000,162120000,324240000,1,40530000
nn_kernel_cpu,30841,0,1,1,64,0,0,0,0,1,40540000
nn_kernel_gpu,2433,1,1,316719,128,0,0,0,0,1,40540000
nn_kernel_gpu_mem,58908,1,1,316719,128,324320000,162160000,162160000,324320000,1,40540000
nn_kernel_cpu,13264,0,1,1,64,0,0,0,0,1,40550000
nn_kernel_gpu,2432,1,1,316797,128,0,0,0,0,1,40550000
nn_kernel_gpu_mem,60279,1,1,316797,128,324400000,162200000,162200000,324400000,1,40550000
nn_kernel_cpu,34263,0,1,1,64,0,0,0,0,1,40560000
nn_kernel_gpu,2430,1,1,316875,128,0,0,0,0,1,40560000
nn_kernel_gpu_mem,62479,1,1,316875,128,324480000,162240000,162240000,324480000,1,40560000
nn_kernel_cpu,21466,0,1,1,64,0,0,0,0,1,40570000
nn_kernel_gpu,2490,1,1,316954,128,0,0,0,0,1,40570000
nn_kernel_gpu_mem,59501,1,1,316954,128,324560000,162280000,162280000,324560000,1,40570000
nn_kernel_cpu,24661,0,1,1,64,0,0,0,0,1,40580000
nn_kernel_gpu,2412,1,1,317032,128,0,0,0,0,1,40580000
nn_kernel_gpu_mem,60544,1,1,317032,128,324640000,162320000,162320000,324640000,1,40580000
nn_kernel_cpu,26046,0,1,1,64,0,0,0,0,1,40590000
nn_kernel_gpu,2443,1,1,317110,128,0,0,0,0,1,40590000
nn_kernel_gpu_mem,55369,1,1,317110,128,324720000,162360000,162360000,324720000,1,40590000
nn_kernel_cpu,22539,0,1,1,64,0,0,0,0,1,40600000
nn_kernel_gpu,2417,1,1,317188,128,0,0,0,0,1,40600000
nn_kernel_gpu_mem,56737,1,1,317188,128,324800000,162400000,162400000,324800000,1,40600000
nn_kernel_cpu,27603,0,1,1,64,0,0,0,0,1,4060000
nn_kernel_gpu,294,1,1,31719,128,0,0,0,0,1,4060000
nn_kernel_gpu_mem,5415,1,1,31719,128,32480000,16240000,16240000,32480000,1,4060000
nn_kernel_cpu,39947,0,1,1,64,0,0,0,0,1,40610000
nn_kernel_gpu,2441,1,1,317266,128,0,0,0,0,1,40610000
nn_kernel_gpu_mem,57275,1,1,317266,128,324880000,162440000,162440000,324880000,1,40610000
nn_kernel_cpu,17803,0,1,1,64,0,0,0,0,1,40620000
nn_kernel_gpu,2433,1,1,317344,128,0,0,0,0,1,40620000
nn_kernel_gpu_mem,52004,1,1,317344,128,324960000,162480000,162480000,324960000,1,40620000
nn_kernel_cpu,20972,0,1,1,64,0,0,0,0,1,40630000
nn_kernel_gpu,2436,1,1,317422,128,0,0,0,0,1,40630000
nn_kernel_gpu_mem,52176,1,1,317422,128,325040000,162520000,162520000,325040000,1,40630000
nn_kernel_cpu,33489,0,1,1,64,0,0,0,0,1,40640000
nn_kernel_gpu,2434,1,1,317500,128,0,0,0,0,1,40640000
nn_kernel_gpu_mem,54195,1,1,317500,128,325120000,162560000,162560000,325120000,1,40640000
nn_kernel_cpu,24828,0,1,1,64,0,0,0,0,1,40650000
nn_kernel_gpu,2437,1,1,317579,128,0,0,0,0,1,40650000
nn_kernel_gpu_mem,52412,1,1,317579,128,325200000,162600000,162600000,325200000,1,40650000
nn_kernel_cpu,35807,0,1,1,64,0,0,0,0,1,40660000
nn_kernel_gpu,2446,1,1,317657,128,0,0,0,0,1,40660000
nn_kernel_gpu_mem,54053,1,1,317657,128,325280000,162640000,162640000,325280000,1,40660000
nn_kernel_cpu,25409,0,1,1,64,0,0,0,0,1,40670000
nn_kernel_gpu,2426,1,1,317735,128,0,0,0,0,1,40670000
nn_kernel_gpu_mem,58319,1,1,317735,128,325360000,162680000,162680000,325360000,1,40670000
nn_kernel_cpu,29706,0,1,1,64,0,0,0,0,1,40680000
nn_kernel_gpu,2422,1,1,317813,128,0,0,0,0,1,40680000
nn_kernel_gpu_mem,50673,1,1,317813,128,325440000,162720000,162720000,325440000,1,40680000
nn_kernel_cpu,30941,0,1,1,64,0,0,0,0,1,40690000
nn_kernel_gpu,2426,1,1,317891,128,0,0,0,0,1,40690000
nn_kernel_gpu_mem,51977,1,1,317891,128,325520000,162760000,162760000,325520000,1,40690000
nn_kernel_cpu,27916,0,1,1,64,0,0,0,0,1,40700000
nn_kernel_gpu,2453,1,1,317969,128,0,0,0,0,1,40700000
nn_kernel_gpu_mem,49776,1,1,317969,128,325600000,162800000,162800000,325600000,1,40700000
nn_kernel_cpu,18256,0,1,1,64,0,0,0,0,1,4070000
nn_kernel_gpu,295,1,1,31797,128,0,0,0,0,1,4070000
nn_kernel_gpu_mem,7133,1,1,31797,128,32560000,16280000,16280000,32560000,1,4070000
nn_kernel_cpu,29788,0,1,1,64,0,0,0,0,1,40710000
nn_kernel_gpu,2437,1,1,318047,128,0,0,0,0,1,40710000
nn_kernel_gpu_mem,63276,1,1,318047,128,325680000,162840000,162840000,325680000,1,40710000
nn_kernel_cpu,28228,0,1,1,64,0,0,0,0,1,40720000
nn_kernel_gpu,2434,1,1,318125,128,0,0,0,0,1,40720000
nn_kernel_gpu_mem,52166,1,1,318125,128,325760000,162880000,162880000,325760000,1,40720000
nn_kernel_cpu,23989,0,1,1,64,0,0,0,0,1,40730000
nn_kernel_gpu,2422,1,1,318204,128,0,0,0,0,1,40730000
nn_kernel_gpu_mem,49404,1,1,318204,128,325840000,162920000,162920000,325840000,1,40730000
nn_kernel_cpu,22413,0,1,1,64,0,0,0,0,1,40740000
nn_kernel_gpu,2432,1,1,318282,128,0,0,0,0,1,40740000
nn_kernel_gpu_mem,58678,1,1,318282,128,325920000,162960000,162960000,325920000,1,40740000
nn_kernel_cpu,28233,0,1,1,64,0,0,0,0,1,40750000
nn_kernel_gpu,2437,1,1,318360,128,0,0,0,0,1,40750000
nn_kernel_gpu_mem,55622,1,1,318360,128,326000000,163000000,163000000,326000000,1,40750000
nn_kernel_cpu,28242,0,1,1,64,0,0,0,0,1,40760000
nn_kernel_gpu,2436,1,1,318438,128,0,0,0,0,1,40760000
nn_kernel_gpu_mem,57447,1,1,318438,128,326080000,163040000,163040000,326080000,1,40760000
nn_kernel_cpu,27620,0,1,1,64,0,0,0,0,1,40770000
nn_kernel_gpu,2450,1,1,318516,128,0,0,0,0,1,40770000
nn_kernel_gpu_mem,52806,1,1,318516,128,326160000,163080000,163080000,326160000,1,40770000
nn_kernel_cpu,25108,0,1,1,64,0,0,0,0,1,40780000
nn_kernel_gpu,2440,1,1,318594,128,0,0,0,0,1,40780000
nn_kernel_gpu_mem,57560,1,1,318594,128,326240000,163120000,163120000,326240000,1,40780000
nn_kernel_cpu,26441,0,1,1,64,0,0,0,0,1,40790000
nn_kernel_gpu,2451,1,1,318672,128,0,0,0,0,1,40790000
nn_kernel_gpu_mem,51719,1,1,318672,128,326320000,163160000,163160000,326320000,1,40790000
nn_kernel_cpu,35753,0,1,1,64,0,0,0,0,1,40800000
nn_kernel_gpu,2427,1,1,318750,128,0,0,0,0,1,40800000
nn_kernel_gpu_mem,59382,1,1,318750,128,326400000,163200000,163200000,326400000,1,40800000
nn_kernel_cpu,41918,0,1,1,64,0,0,0,0,1,4080000
nn_kernel_gpu,300,1,1,31875,128,0,0,0,0,1,4080000
nn_kernel_gpu_mem,7245,1,1,31875,128,32640000,16320000,16320000,32640000,1,4080000
nn_kernel_cpu,27512,0,1,1,64,0,0,0,0,1,40810000
nn_kernel_gpu,2444,1,1,318829,128,0,0,0,0,1,40810000
nn_kernel_gpu_mem,50624,1,1,318829,128,326480000,163240000,163240000,326480000,1,40810000
nn_kernel_cpu,29614,0,1,1,64,0,0,0,0,1,40820000
nn_kernel_gpu,2446,1,1,318907,128,0,0,0,0,1,40820000
nn_kernel_gpu_mem,54300,1,1,318907,128,326560000,163280000,163280000,326560000,1,40820000
nn_kernel_cpu,14312,0,1,1,64,0,0,0,0,1,40830000
nn_kernel_gpu,2434,1,1,318985,128,0,0,0,0,1,40830000
nn_kernel_gpu_mem,49634,1,1,318985,128,326640000,163320000,163320000,326640000,1,40830000
nn_kernel_cpu,36694,0,1,1,64,0,0,0,0,1,40840000
nn_kernel_gpu,2440,1,1,319063,128,0,0,0,0,1,40840000
nn_kernel_gpu_mem,57888,1,1,319063,128,326720000,163360000,163360000,326720000,1,40840000
nn_kernel_cpu,10332,0,1,1,64,0,0,0,0,1,40850000
nn_kernel_gpu,2438,1,1,319141,128,0,0,0,0,1,40850000
nn_kernel_gpu_mem,61678,1,1,319141,128,326800000,163400000,163400000,326800000,1,40850000
nn_kernel_cpu,18301,0,1,1,64,0,0,0,0,1,40860000
nn_kernel_gpu,2464,1,1,319219,128,0,0,0,0,1,40860000
nn_kernel_gpu_mem,50163,1,1,319219,128,326880000,163440000,163440000,326880000,1,40860000
nn_kernel_cpu,14540,0,1,1,64,0,0,0,0,1,40870000
nn_kernel_gpu,2442,1,1,319297,128,0,0,0,0,1,40870000
nn_kernel_gpu_mem,60551,1,1,319297,128,326960000,163480000,163480000,326960000,1,40870000
nn_kernel_cpu,26610,0,1,1,64,0,0,0,0,1,40880000
nn_kernel_gpu,2449,1,1,319375,128,0,0,0,0,1,40880000
nn_kernel_gpu_mem,50714,1,1,319375,128,327040000,163520000,163520000,327040000,1,40880000
nn_kernel_cpu,20177,0,1,1,64,0,0,0,0,1,40890000
nn_kernel_gpu,2430,1,1,319454,128,0,0,0,0,1,40890000
nn_kernel_gpu_mem,63282,1,1,319454,128,327120000,163560000,163560000,327120000,1,40890000
nn_kernel_cpu,18432,0,1,1,64,0,0,0,0,1,40900000
nn_kernel_gpu,2422,1,1,319532,128,0,0,0,0,1,40900000
nn_kernel_gpu_mem,50718,1,1,319532,128,327200000,163600000,163600000,327200000,1,40900000
nn_kernel_cpu,6516,0,1,1,64,0,0,0,0,1,4090000
nn_kernel_gpu,312,1,1,31954,128,0,0,0,0,1,4090000
nn_kernel_gpu_mem,6110,1,1,31954,128,32720000,16360000,16360000,32720000,1,4090000
nn_kernel_cpu,20599,0,1,1,64,0,0,0,0,1,40910000
nn_kernel_gpu,2437,1,1,319610,128,0,0,0,0,1,40910000
nn_kernel_gpu_mem,60219,1,1,319610,128,327280000,163640000,163640000,327280000,1,40910000
nn_kernel_cpu,25512,0,1,1,64,0,0,0,0,1,40920000
nn_kernel_gpu,2442,1,1,319688,128,0,0,0,0,1,40920000
nn_kernel_gpu_mem,47897,1,1,319688,128,327360000,163680000,163680000,327360000,1,40920000
nn_kernel_cpu,23928,0,1,1,64,0,0,0,0,1,40930000
nn_kernel_gpu,2429,1,1,319766,128,0,0,0,0,1,40930000
nn_kernel_gpu_mem,51371,1,1,319766,128,327440000,163720000,163720000,327440000,1,40930000
nn_kernel_cpu,14923,0,1,1,64,0,0,0,0,1,40940000
nn_kernel_gpu,2435,1,1,319844,128,0,0,0,0,1,40940000
nn_kernel_gpu_mem,61454,1,1,319844,128,327520000,163760000,163760000,327520000,1,40940000
nn_kernel_cpu,14243,0,1,1,64,0,0,0,0,1,40950000
nn_kernel_gpu,2442,1,1,319922,128,0,0,0,0,1,40950000
nn_kernel_gpu_mem,63302,1,1,319922,128,327600000,163800000,163800000,327600000,1,40950000
nn_kernel_cpu,27818,0,1,1,64,0,0,0,0,1,40960000
nn_kernel_gpu,2448,1,1,320000,128,0,0,0,0,1,40960000
nn_kernel_gpu_mem,61046,1,1,320000,128,327680000,163840000,163840000,327680000,1,40960000
nn_kernel_cpu,27637,0,1,1,64,0,0,0,0,1,40970000
nn_kernel_gpu,2424,1,1,320079,128,0,0,0,0,1,40970000
nn_kernel_gpu_mem,60282,1,1,320079,128,327760000,163880000,163880000,327760000,1,40970000
nn_kernel_cpu,21305,0,1,1,64,0,0,0,0,1,40980000
nn_kernel_gpu,2445,1,1,320157,128,0,0,0,0,1,40980000
nn_kernel_gpu_mem,60111,1,1,320157,128,327840000,163920000,163920000,327840000,1,40980000
nn_kernel_cpu,12553,0,1,1,64,0,0,0,0,1,40990000
nn_kernel_gpu,2457,1,1,320235,128,0,0,0,0,1,40990000
nn_kernel_gpu_mem,49609,1,1,320235,128,327920000,163960000,163960000,327920000,1,40990000
nn_kernel_cpu,27578,0,1,1,64,0,0,0,0,1,41000000
nn_kernel_gpu,2447,1,1,320313,128,0,0,0,0,1,41000000
nn_kernel_gpu_mem,52835,1,1,320313,128,328000000,164000000,164000000,328000000,1,41000000
nn_kernel_cpu,15879,0,1,1,64,0,0,0,0,1,4100000
nn_kernel_gpu,288,1,1,32032,128,0,0,0,0,1,4100000
nn_kernel_gpu_mem,5913,1,1,32032,128,32800000,16400000,16400000,32800000,1,4100000
nn_kernel_cpu,13082,0,1,1,64,0,0,0,0,1,410000
nn_kernel_gpu,83,1,1,3204,128,0,0,0,0,1,410000
nn_kernel_gpu_mem,858,1,1,3204,128,3280000,1640000,1640000,3280000,1,410000
nn_kernel_cpu,23992,0,1,1,64,0,0,0,0,1,41010000
nn_kernel_gpu,2435,1,1,320391,128,0,0,0,0,1,41010000
nn_kernel_gpu_mem,49043,1,1,320391,128,328080000,164040000,164040000,328080000,1,41010000
nn_kernel_cpu,24842,0,1,1,64,0,0,0,0,1,41020000
nn_kernel_gpu,2443,1,1,320469,128,0,0,0,0,1,41020000
nn_kernel_gpu_mem,63998,1,1,320469,128,328160000,164080000,164080000,328160000,1,41020000
nn_kernel_cpu,24145,0,1,1,64,0,0,0,0,1,41030000
nn_kernel_gpu,2443,1,1,320547,128,0,0,0,0,1,41030000
nn_kernel_gpu_mem,58392,1,1,320547,128,328240000,164120000,164120000,328240000,1,41030000
nn_kernel_cpu,17103,0,1,1,64,0,0,0,0,1,41040000
nn_kernel_gpu,2478,1,1,320625,128,0,0,0,0,1,41040000
nn_kernel_gpu_mem,60704,1,1,320625,128,328320000,164160000,164160000,328320000,1,41040000
nn_kernel_cpu,28898,0,1,1,64,0,0,0,0,1,41050000
nn_kernel_gpu,2449,1,1,320704,128,0,0,0,0,1,41050000
nn_kernel_gpu_mem,60222,1,1,320704,128,328400000,164200000,164200000,328400000,1,41050000
nn_kernel_cpu,26051,0,1,1,64,0,0,0,0,1,41060000
nn_kernel_gpu,2434,1,1,320782,128,0,0,0,0,1,41060000
nn_kernel_gpu_mem,51793,1,1,320782,128,328480000,164240000,164240000,328480000,1,41060000
nn_kernel_cpu,27674,0,1,1,64,0,0,0,0,1,41070000
nn_kernel_gpu,2430,1,1,320860,128,0,0,0,0,1,41070000
nn_kernel_gpu_mem,61050,1,1,320860,128,328560000,164280000,164280000,328560000,1,41070000
nn_kernel_cpu,19182,0,1,1,64,0,0,0,0,1,41080000
nn_kernel_gpu,2447,1,1,320938,128,0,0,0,0,1,41080000
nn_kernel_gpu_mem,53106,1,1,320938,128,328640000,164320000,164320000,328640000,1,41080000
nn_kernel_cpu,26290,0,1,1,64,0,0,0,0,1,41090000
nn_kernel_gpu,2435,1,1,321016,128,0,0,0,0,1,41090000
nn_kernel_gpu_mem,60748,1,1,321016,128,328720000,164360000,164360000,328720000,1,41090000
nn_kernel_cpu,16582,0,1,1,64,0,0,0,0,1,41100000
nn_kernel_gpu,2442,1,1,321094,128,0,0,0,0,1,41100000
nn_kernel_gpu_mem,48181,1,1,321094,128,328800000,164400000,164400000,328800000,1,41100000
nn_kernel_cpu,10223,0,1,1,64,0,0,0,0,1,4110000
nn_kernel_gpu,305,1,1,32110,128,0,0,0,0,1,4110000
nn_kernel_gpu_mem,6164,1,1,32110,128,32880000,16440000,16440000,32880000,1,4110000
nn_kernel_cpu,18221,0,1,1,64,0,0,0,0,1,41110000
nn_kernel_gpu,2476,1,1,321172,128,0,0,0,0,1,41110000
nn_kernel_gpu_mem,49540,1,1,321172,128,328880000,164440000,164440000,328880000,1,41110000
nn_kernel_cpu,19478,0,1,1,64,0,0,0,0,1,41120000
nn_kernel_gpu,2478,1,1,321250,128,0,0,0,0,1,41120000
nn_kernel_gpu_mem,49734,1,1,321250,128,328960000,164480000,164480000,328960000,1,41120000
nn_kernel_cpu,31472,0,1,1,64,0,0,0,0,1,41130000
nn_kernel_gpu,2450,1,1,321329,128,0,0,0,0,1,41130000
nn_kernel_gpu_mem,60759,1,1,321329,128,329040000,164520000,164520000,329040000,1,41130000
nn_kernel_cpu,25786,0,1,1,64,0,0,0,0,1,41140000
nn_kernel_gpu,2441,1,1,321407,128,0,0,0,0,1,41140000
nn_kernel_gpu_mem,63063,1,1,321407,128,329120000,164560000,164560000,329120000,1,41140000
nn_kernel_cpu,53876,0,1,1,64,0,0,0,0,1,41150000
nn_kernel_gpu,2450,1,1,321485,128,0,0,0,0,1,41150000
nn_kernel_gpu_mem,55387,1,1,321485,128,329200000,164600000,164600000,329200000,1,41150000
nn_kernel_cpu,24409,0,1,1,64,0,0,0,0,1,41160000
nn_kernel_gpu,2430,1,1,321563,128,0,0,0,0,1,41160000
nn_kernel_gpu_mem,53272,1,1,321563,128,329280000,164640000,164640000,329280000,1,41160000
nn_kernel_cpu,23382,0,1,1,64,0,0,0,0,1,41170000
nn_kernel_gpu,2451,1,1,321641,128,0,0,0,0,1,41170000
nn_kernel_gpu_mem,54485,1,1,321641,128,329360000,164680000,164680000,329360000,1,41170000
nn_kernel_cpu,18018,0,1,1,64,0,0,0,0,1,41180000
nn_kernel_gpu,2456,1,1,321719,128,0,0,0,0,1,41180000
nn_kernel_gpu_mem,62705,1,1,321719,128,329440000,164720000,164720000,329440000,1,41180000
nn_kernel_cpu,11623,0,1,1,64,0,0,0,0,1,41190000
nn_kernel_gpu,2452,1,1,321797,128,0,0,0,0,1,41190000
nn_kernel_gpu_mem,60627,1,1,321797,128,329520000,164760000,164760000,329520000,1,41190000
nn_kernel_cpu,25426,0,1,1,64,0,0,0,0,1,41200000
nn_kernel_gpu,2456,1,1,321875,128,0,0,0,0,1,41200000
nn_kernel_gpu_mem,61301,1,1,321875,128,329600000,164800000,164800000,329600000,1,41200000
nn_kernel_cpu,7126,0,1,1,64,0,0,0,0,1,4120000
nn_kernel_gpu,302,1,1,32188,128,0,0,0,0,1,4120000
nn_kernel_gpu_mem,6058,1,1,32188,128,32960000,16480000,16480000,32960000,1,4120000
nn_kernel_cpu,19270,0,1,1,64,0,0,0,0,1,41210000
nn_kernel_gpu,2427,1,1,321954,128,0,0,0,0,1,41210000
nn_kernel_gpu_mem,51087,1,1,321954,128,329680000,164840000,164840000,329680000,1,41210000
nn_kernel_cpu,19541,0,1,1,64,0,0,0,0,1,41220000
nn_kernel_gpu,2432,1,1,322032,128,0,0,0,0,1,41220000
nn_kernel_gpu_mem,58526,1,1,322032,128,329760000,164880000,164880000,329760000,1,41220000
nn_kernel_cpu,12651,0,1,1,64,0,0,0,0,1,41230000
nn_kernel_gpu,2451,1,1,322110,128,0,0,0,0,1,41230000
nn_kernel_gpu_mem,51763,1,1,322110,128,329840000,164920000,164920000,329840000,1,41230000
nn_kernel_cpu,22233,0,1,1,64,0,0,0,0,1,41240000
nn_kernel_gpu,2456,1,1,322188,128,0,0,0,0,1,41240000
nn_kernel_gpu_mem,50434,1,1,322188,128,329920000,164960000,164960000,329920000,1,41240000
nn_kernel_cpu,21726,0,1,1,64,0,0,0,0,1,41250000
nn_kernel_gpu,2449,1,1,322266,128,0,0,0,0,1,41250000
nn_kernel_gpu_mem,55568,1,1,322266,128,330000000,165000000,165000000,330000000,1,41250000
nn_kernel_cpu,25670,0,1,1,64,0,0,0,0,1,41260000
nn_kernel_gpu,2492,1,1,322344,128,0,0,0,0,1,41260000
nn_kernel_gpu_mem,62758,1,1,322344,128,330080000,165040000,165040000,330080000,1,41260000
nn_kernel_cpu,30128,0,1,1,64,0,0,0,0,1,41270000
nn_kernel_gpu,2481,1,1,322422,128,0,0,0,0,1,41270000
nn_kernel_gpu_mem,50368,1,1,322422,128,330160000,165080000,165080000,330160000,1,41270000
nn_kernel_cpu,47014,0,1,1,64,0,0,0,0,1,41280000
nn_kernel_gpu,2455,1,1,322500,128,0,0,0,0,1,41280000
nn_kernel_gpu_mem,53429,1,1,322500,128,330240000,165120000,165120000,330240000,1,41280000
nn_kernel_cpu,25545,0,1,1,64,0,0,0,0,1,41290000
nn_kernel_gpu,2503,1,1,322579,128,0,0,0,0,1,41290000
nn_kernel_gpu_mem,63804,1,1,322579,128,330320000,165160000,165160000,330320000,1,41290000
nn_kernel_cpu,28453,0,1,1,64,0,0,0,0,1,41300000
nn_kernel_gpu,2483,1,1,322657,128,0,0,0,0,1,41300000
nn_kernel_gpu_mem,48996,1,1,322657,128,330400000,165200000,165200000,330400000,1,41300000
nn_kernel_cpu,7100,0,1,1,64,0,0,0,0,1,4130000
nn_kernel_gpu,296,1,1,32266,128,0,0,0,0,1,4130000
nn_kernel_gpu_mem,6360,1,1,32266,128,33040000,16520000,16520000,33040000,1,4130000
nn_kernel_cpu,11954,0,1,1,64,0,0,0,0,1,41310000
nn_kernel_gpu,2462,1,1,322735,128,0,0,0,0,1,41310000
nn_kernel_gpu_mem,54357,1,1,322735,128,330480000,165240000,165240000,330480000,1,41310000
nn_kernel_cpu,17638,0,1,1,64,0,0,0,0,1,41320000
nn_kernel_gpu,2452,1,1,322813,128,0,0,0,0,1,41320000
nn_kernel_gpu_mem,61540,1,1,322813,128,330560000,165280000,165280000,330560000,1,41320000
nn_kernel_cpu,25309,0,1,1,64,0,0,0,0,1,41330000
nn_kernel_gpu,2776,1,1,322891,128,0,0,0,0,1,41330000
nn_kernel_gpu_mem,60706,1,1,322891,128,330640000,165320000,165320000,330640000,1,41330000
nn_kernel_cpu,20225,0,1,1,64,0,0,0,0,1,41340000
nn_kernel_gpu,2458,1,1,322969,128,0,0,0,0,1,41340000
nn_kernel_gpu_mem,62227,1,1,322969,128,330720000,165360000,165360000,330720000,1,41340000
nn_kernel_cpu,15400,0,1,1,64,0,0,0,0,1,41350000
nn_kernel_gpu,2463,1,1,323047,128,0,0,0,0,1,41350000
nn_kernel_gpu_mem,62500,1,1,323047,128,330800000,165400000,165400000,330800000,1,41350000
nn_kernel_cpu,15147,0,1,1,64,0,0,0,0,1,41360000
nn_kernel_gpu,2471,1,1,323125,128,0,0,0,0,1,41360000
nn_kernel_gpu_mem,61814,1,1,323125,128,330880000,165440000,165440000,330880000,1,41360000
nn_kernel_cpu,36155,0,1,1,64,0,0,0,0,1,41370000
nn_kernel_gpu,2470,1,1,323204,128,0,0,0,0,1,41370000
nn_kernel_gpu_mem,61008,1,1,323204,128,330960000,165480000,165480000,330960000,1,41370000
nn_kernel_cpu,16146,0,1,1,64,0,0,0,0,1,41380000
nn_kernel_gpu,2491,1,1,323282,128,0,0,0,0,1,41380000
nn_kernel_gpu_mem,56203,1,1,323282,128,331040000,165520000,165520000,331040000,1,41380000
nn_kernel_cpu,21373,0,1,1,64,0,0,0,0,1,41390000
nn_kernel_gpu,2472,1,1,323360,128,0,0,0,0,1,41390000
nn_kernel_gpu_mem,61611,1,1,323360,128,331120000,165560000,165560000,331120000,1,41390000
nn_kernel_cpu,15772,0,1,1,64,0,0,0,0,1,41400000
nn_kernel_gpu,2466,1,1,323438,128,0,0,0,0,1,41400000
nn_kernel_gpu_mem,63538,1,1,323438,128,331200000,165600000,165600000,331200000,1,41400000
nn_kernel_cpu,4267,0,1,1,64,0,0,0,0,1,4140000
nn_kernel_gpu,289,1,1,32344,128,0,0,0,0,1,4140000
nn_kernel_gpu_mem,5539,1,1,32344,128,33120000,16560000,16560000,33120000,1,4140000
nn_kernel_cpu,8991,0,1,1,64,0,0,0,0,1,41410000
nn_kernel_gpu,2475,1,1,323516,128,0,0,0,0,1,41410000
nn_kernel_gpu_mem,61637,1,1,323516,128,331280000,165640000,165640000,331280000,1,41410000
nn_kernel_cpu,24686,0,1,1,64,0,0,0,0,1,41420000
nn_kernel_gpu,2441,1,1,323594,128,0,0,0,0,1,41420000
nn_kernel_gpu_mem,48206,1,1,323594,128,331360000,165680000,165680000,331360000,1,41420000
nn_kernel_cpu,31295,0,1,1,64,0,0,0,0,1,41430000
nn_kernel_gpu,2456,1,1,323672,128,0,0,0,0,1,41430000
nn_kernel_gpu_mem,62900,1,1,323672,128,331440000,165720000,165720000,331440000,1,41430000
nn_kernel_cpu,9001,0,1,1,64,0,0,0,0,1,41440000
nn_kernel_gpu,2461,1,1,323750,128,0,0,0,0,1,41440000
nn_kernel_gpu_mem,57353,1,1,323750,128,331520000,165760000,165760000,331520000,1,41440000
nn_kernel_cpu,17447,0,1,1,64,0,0,0,0,1,41450000
nn_kernel_gpu,2474,1,1,323829,128,0,0,0,0,1,41450000
nn_kernel_gpu_mem,53201,1,1,323829,128,331600000,165800000,165800000,331600000,1,41450000
nn_kernel_cpu,17808,0,1,1,64,0,0,0,0,1,41460000
nn_kernel_gpu,2447,1,1,323907,128,0,0,0,0,1,41460000
nn_kernel_gpu_mem,49407,1,1,323907,128,331680000,165840000,165840000,331680000,1,41460000
nn_kernel_cpu,15015,0,1,1,64,0,0,0,0,1,41470000
nn_kernel_gpu,2452,1,1,323985,128,0,0,0,0,1,41470000
nn_kernel_gpu_mem,61870,1,1,323985,128,331760000,165880000,165880000,331760000,1,41470000
nn_kernel_cpu,15791,0,1,1,64,0,0,0,0,1,41480000
nn_kernel_gpu,2455,1,1,324063,128,0,0,0,0,1,41480000
nn_kernel_gpu_mem,60792,1,1,324063,128,331840000,165920000,165920000,331840000,1,41480000
nn_kernel_cpu,28534,0,1,1,64,0,0,0,0,1,41490000
nn_kernel_gpu,2455,1,1,324141,128,0,0,0,0,1,41490000
nn_kernel_gpu_mem,60601,1,1,324141,128,331920000,165960000,165960000,331920000,1,41490000
nn_kernel_cpu,18412,0,1,1,64,0,0,0,0,1,41500000
nn_kernel_gpu,2443,1,1,324219,128,0,0,0,0,1,41500000
nn_kernel_gpu_mem,52358,1,1,324219,128,332000000,166000000,166000000,332000000,1,41500000
nn_kernel_cpu,6884,0,1,1,64,0,0,0,0,1,4150000
nn_kernel_gpu,296,1,1,32422,128,0,0,0,0,1,4150000
nn_kernel_gpu_mem,6568,1,1,32422,128,33200000,16600000,16600000,33200000,1,4150000
nn_kernel_cpu,23828,0,1,1,64,0,0,0,0,1,41510000
nn_kernel_gpu,2456,1,1,324297,128,0,0,0,0,1,41510000
nn_kernel_gpu_mem,61147,1,1,324297,128,332080000,166040000,166040000,332080000,1,41510000
nn_kernel_cpu,26624,0,1,1,64,0,0,0,0,1,41520000
nn_kernel_gpu,2456,1,1,324375,128,0,0,0,0,1,41520000
nn_kernel_gpu_mem,61855,1,1,324375,128,332160000,166080000,166080000,332160000,1,41520000
nn_kernel_cpu,25496,0,1,1,64,0,0,0,0,1,41530000
nn_kernel_gpu,2451,1,1,324454,128,0,0,0,0,1,41530000
nn_kernel_gpu_mem,65208,1,1,324454,128,332240000,166120000,166120000,332240000,1,41530000
nn_kernel_cpu,16421,0,1,1,64,0,0,0,0,1,41540000
nn_kernel_gpu,2472,1,1,324532,128,0,0,0,0,1,41540000
nn_kernel_gpu_mem,60591,1,1,324532,128,332320000,166160000,166160000,332320000,1,41540000
nn_kernel_cpu,36985,0,1,1,64,0,0,0,0,1,41550000
nn_kernel_gpu,2488,1,1,324610,128,0,0,0,0,1,41550000
nn_kernel_gpu_mem,49732,1,1,324610,128,332400000,166200000,166200000,332400000,1,41550000
nn_kernel_cpu,29038,0,1,1,64,0,0,0,0,1,41560000
nn_kernel_gpu,2477,1,1,324688,128,0,0,0,0,1,41560000
nn_kernel_gpu_mem,61999,1,1,324688,128,332480000,166240000,166240000,332480000,1,41560000
nn_kernel_cpu,16395,0,1,1,64,0,0,0,0,1,41570000
nn_kernel_gpu,2468,1,1,324766,128,0,0,0,0,1,41570000
nn_kernel_gpu_mem,62395,1,1,324766,128,332560000,166280000,166280000,332560000,1,41570000
nn_kernel_cpu,17745,0,1,1,64,0,0,0,0,1,41580000
nn_kernel_gpu,2452,1,1,324844,128,0,0,0,0,1,41580000
nn_kernel_gpu_mem,61932,1,1,324844,128,332640000,166320000,166320000,332640000,1,41580000
nn_kernel_cpu,14699,0,1,1,64,0,0,0,0,1,41590000
nn_kernel_gpu,2474,1,1,324922,128,0,0,0,0,1,41590000
nn_kernel_gpu_mem,61266,1,1,324922,128,332720000,166360000,166360000,332720000,1,41590000
nn_kernel_cpu,37792,0,1,1,64,0,0,0,0,1,41600000
nn_kernel_gpu,2471,1,1,325000,128,0,0,0,0,1,41600000
nn_kernel_gpu_mem,61572,1,1,325000,128,332800000,166400000,166400000,332800000,1,41600000
nn_kernel_cpu,33541,0,1,1,64,0,0,0,0,1,4160000
nn_kernel_gpu,311,1,1,32500,128,0,0,0,0,1,4160000
nn_kernel_gpu_mem,6227,1,1,32500,128,33280000,16640000,16640000,33280000,1,4160000
nn_kernel_cpu,25328,0,1,1,64,0,0,0,0,1,41610000
nn_kernel_gpu,2472,1,1,325079,128,0,0,0,0,1,41610000
nn_kernel_gpu_mem,61010,1,1,325079,128,332880000,166440000,166440000,332880000,1,41610000
nn_kernel_cpu,14398,0,1,1,64,0,0,0,0,1,41620000
nn_kernel_gpu,2469,1,1,325157,128,0,0,0,0,1,41620000
nn_kernel_gpu_mem,60378,1,1,325157,128,332960000,166480000,166480000,332960000,1,41620000
nn_kernel_cpu,14152,0,1,1,64,0,0,0,0,1,41630000
nn_kernel_gpu,2472,1,1,325235,128,0,0,0,0,1,41630000
nn_kernel_gpu_mem,61677,1,1,325235,128,333040000,166520000,166520000,333040000,1,41630000
nn_kernel_cpu,17018,0,1,1,64,0,0,0,0,1,41640000
nn_kernel_gpu,2474,1,1,325313,128,0,0,0,0,1,41640000
nn_kernel_gpu_mem,63088,1,1,325313,128,333120000,166560000,166560000,333120000,1,41640000
nn_kernel_cpu,36617,0,1,1,64,0,0,0,0,1,41650000
nn_kernel_gpu,2457,1,1,325391,128,0,0,0,0,1,41650000
nn_kernel_gpu_mem,52869,1,1,325391,128,333200000,166600000,166600000,333200000,1,41650000
nn_kernel_cpu,13067,0,1,1,64,0,0,0,0,1,41660000
nn_kernel_gpu,2475,1,1,325469,128,0,0,0,0,1,41660000
nn_kernel_gpu_mem,63778,1,1,325469,128,333280000,166640000,166640000,333280000,1,41660000
nn_kernel_cpu,29982,0,1,1,64,0,0,0,0,1,41670000
nn_kernel_gpu,2479,1,1,325547,128,0,0,0,0,1,41670000
nn_kernel_gpu_mem,63376,1,1,325547,128,333360000,166680000,166680000,333360000,1,41670000
nn_kernel_cpu,31457,0,1,1,64,0,0,0,0,1,41680000
nn_kernel_gpu,2464,1,1,325625,128,0,0,0,0,1,41680000
nn_kernel_gpu_mem,55241,1,1,325625,128,333440000,166720000,166720000,333440000,1,41680000
nn_kernel_cpu,19037,0,1,1,64,0,0,0,0,1,41690000
nn_kernel_gpu,2475,1,1,325704,128,0,0,0,0,1,41690000
nn_kernel_gpu_mem,61473,1,1,325704,128,333520000,166760000,166760000,333520000,1,41690000
nn_kernel_cpu,11559,0,1,1,64,0,0,0,0,1,41700000
nn_kernel_gpu,2472,1,1,325782,128,0,0,0,0,1,41700000
nn_kernel_gpu_mem,62522,1,1,325782,128,333600000,166800000,166800000,333600000,1,41700000
nn_kernel_cpu,3980,0,1,1,64,0,0,0,0,1,4170000
nn_kernel_gpu,294,1,1,32579,128,0,0,0,0,1,4170000
nn_kernel_gpu_mem,6891,1,1,32579,128,33360000,16680000,16680000,33360000,1,4170000
nn_kernel_cpu,18568,0,1,1,64,0,0,0,0,1,41710000
nn_kernel_gpu,2474,1,1,325860,128,0,0,0,0,1,41710000
nn_kernel_gpu_mem,52756,1,1,325860,128,333680000,166840000,166840000,333680000,1,41710000
nn_kernel_cpu,15712,0,1,1,64,0,0,0,0,1,41720000
nn_kernel_gpu,2484,1,1,325938,128,0,0,0,0,1,41720000
nn_kernel_gpu_mem,61495,1,1,325938,128,333760000,166880000,166880000,333760000,1,41720000
nn_kernel_cpu,27349,0,1,1,64,0,0,0,0,1,41730000
nn_kernel_gpu,2502,1,1,326016,128,0,0,0,0,1,41730000
nn_kernel_gpu_mem,50963,1,1,326016,128,333840000,166920000,166920000,333840000,1,41730000
nn_kernel_cpu,14350,0,1,1,64,0,0,0,0,1,41740000
nn_kernel_gpu,2486,1,1,326094,128,0,0,0,0,1,41740000
nn_kernel_gpu_mem,61912,1,1,326094,128,333920000,166960000,166960000,333920000,1,41740000
nn_kernel_cpu,19060,0,1,1,64,0,0,0,0,1,41750000
nn_kernel_gpu,2468,1,1,326172,128,0,0,0,0,1,41750000
nn_kernel_gpu_mem,61702,1,1,326172,128,334000000,167000000,167000000,334000000,1,41750000
nn_kernel_cpu,14803,0,1,1,64,0,0,0,0,1,41760000
nn_kernel_gpu,2469,1,1,326250,128,0,0,0,0,1,41760000
nn_kernel_gpu_mem,62423,1,1,326250,128,334080000,167040000,167040000,334080000,1,41760000
nn_kernel_cpu,28009,0,1,1,64,0,0,0,0,1,41770000
nn_kernel_gpu,2461,1,1,326329,128,0,0,0,0,1,41770000
nn_kernel_gpu_mem,59230,1,1,326329,128,334160000,167080000,167080000,334160000,1,41770000
nn_kernel_cpu,16996,0,1,1,64,0,0,0,0,1,41780000
nn_kernel_gpu,2472,1,1,326407,128,0,0,0,0,1,41780000
nn_kernel_gpu_mem,61137,1,1,326407,128,334240000,167120000,167120000,334240000,1,41780000
nn_kernel_cpu,25887,0,1,1,64,0,0,0,0,1,41790000
nn_kernel_gpu,2481,1,1,326485,128,0,0,0,0,1,41790000
nn_kernel_gpu_mem,62105,1,1,326485,128,334320000,167160000,167160000,334320000,1,41790000
nn_kernel_cpu,36147,0,1,1,64,0,0,0,0,1,41800000
nn_kernel_gpu,2490,1,1,326563,128,0,0,0,0,1,41800000
nn_kernel_gpu_mem,61748,1,1,326563,128,334400000,167200000,167200000,334400000,1,41800000
nn_kernel_cpu,23518,0,1,1,64,0,0,0,0,1,4180000
nn_kernel_gpu,297,1,1,32657,128,0,0,0,0,1,4180000
nn_kernel_gpu_mem,6916,1,1,32657,128,33440000,16720000,16720000,33440000,1,4180000
nn_kernel_cpu,24713,0,1,1,64,0,0,0,0,1,41810000
nn_kernel_gpu,2471,1,1,326641,128,0,0,0,0,1,41810000
nn_kernel_gpu_mem,62202,1,1,326641,128,334480000,167240000,167240000,334480000,1,41810000
nn_kernel_cpu,20028,0,1,1,64,0,0,0,0,1,41820000
nn_kernel_gpu,2481,1,1,326719,128,0,0,0,0,1,41820000
nn_kernel_gpu_mem,60331,1,1,326719,128,334560000,167280000,167280000,334560000,1,41820000
nn_kernel_cpu,18495,0,1,1,64,0,0,0,0,1,41830000
nn_kernel_gpu,2511,1,1,326797,128,0,0,0,0,1,41830000
nn_kernel_gpu_mem,63794,1,1,326797,128,334640000,167320000,167320000,334640000,1,41830000
nn_kernel_cpu,18412,0,1,1,64,0,0,0,0,1,41840000
nn_kernel_gpu,2482,1,1,326875,128,0,0,0,0,1,41840000
nn_kernel_gpu_mem,63526,1,1,326875,128,334720000,167360000,167360000,334720000,1,41840000
nn_kernel_cpu,32094,0,1,1,64,0,0,0,0,1,41850000
nn_kernel_gpu,2526,1,1,326954,128,0,0,0,0,1,41850000
nn_kernel_gpu_mem,58281,1,1,326954,128,334800000,167400000,167400000,334800000,1,41850000
nn_kernel_cpu,24229,0,1,1,64,0,0,0,0,1,41860000
nn_kernel_gpu,2468,1,1,327032,128,0,0,0,0,1,41860000
nn_kernel_gpu_mem,62304,1,1,327032,128,334880000,167440000,167440000,334880000,1,41860000
nn_kernel_cpu,21036,0,1,1,64,0,0,0,0,1,41870000
nn_kernel_gpu,2470,1,1,327110,128,0,0,0,0,1,41870000
nn_kernel_gpu_mem,62162,1,1,327110,128,334960000,167480000,167480000,334960000,1,41870000
nn_kernel_cpu,18097,0,1,1,64,0,0,0,0,1,41880000
nn_kernel_gpu,2478,1,1,327188,128,0,0,0,0,1,41880000
nn_kernel_gpu_mem,75615,1,1,327188,128,335040000,167520000,167520000,335040000,1,41880000
nn_kernel_cpu,25128,0,1,1,64,0,0,0,0,1,41890000
nn_kernel_gpu,2513,1,1,327266,128,0,0,0,0,1,41890000
nn_kernel_gpu_mem,63770,1,1,327266,128,335120000,167560000,167560000,335120000,1,41890000
nn_kernel_cpu,18872,0,1,1,64,0,0,0,0,1,41900000
nn_kernel_gpu,2479,1,1,327344,128,0,0,0,0,1,41900000
nn_kernel_gpu_mem,63784,1,1,327344,128,335200000,167600000,167600000,335200000,1,41900000
nn_kernel_cpu,9510,0,1,1,64,0,0,0,0,1,4190000
nn_kernel_gpu,298,1,1,32735,128,0,0,0,0,1,4190000
nn_kernel_gpu_mem,7233,1,1,32735,128,33520000,16760000,16760000,33520000,1,4190000
nn_kernel_cpu,37562,0,1,1,64,0,0,0,0,1,41910000
nn_kernel_gpu,2464,1,1,327422,128,0,0,0,0,1,41910000
nn_kernel_gpu_mem,48538,1,1,327422,128,335280000,167640000,167640000,335280000,1,41910000
nn_kernel_cpu,12468,0,1,1,64,0,0,0,0,1,41920000
nn_kernel_gpu,2473,1,1,327500,128,0,0,0,0,1,41920000
nn_kernel_gpu_mem,51854,1,1,327500,128,335360000,167680000,167680000,335360000,1,41920000
nn_kernel_cpu,17650,0,1,1,64,0,0,0,0,1,41930000
nn_kernel_gpu,2478,1,1,327579,128,0,0,0,0,1,41930000
nn_kernel_gpu_mem,53449,1,1,327579,128,335440000,167720000,167720000,335440000,1,41930000
nn_kernel_cpu,19691,0,1,1,64,0,0,0,0,1,41940000
nn_kernel_gpu,2482,1,1,327657,128,0,0,0,0,1,41940000
nn_kernel_gpu_mem,63589,1,1,327657,128,335520000,167760000,167760000,335520000,1,41940000
nn_kernel_cpu,19892,0,1,1,64,0,0,0,0,1,41950000
nn_kernel_gpu,2493,1,1,327735,128,0,0,0,0,1,41950000
nn_kernel_gpu_mem,62726,1,1,327735,128,335600000,167800000,167800000,335600000,1,41950000
nn_kernel_cpu,18780,0,1,1,64,0,0,0,0,1,41960000
nn_kernel_gpu,2503,1,1,327813,128,0,0,0,0,1,41960000
nn_kernel_gpu_mem,54180,1,1,327813,128,335680000,167840000,167840000,335680000,1,41960000
nn_kernel_cpu,10150,0,1,1,64,0,0,0,0,1,41970000
nn_kernel_gpu,2498,1,1,327891,128,0,0,0,0,1,41970000
nn_kernel_gpu_mem,61969,1,1,327891,128,335760000,167880000,167880000,335760000,1,41970000
nn_kernel_cpu,15337,0,1,1,64,0,0,0,0,1,41980000
nn_kernel_gpu,2483,1,1,327969,128,0,0,0,0,1,41980000
nn_kernel_gpu_mem,62576,1,1,327969,128,335840000,167920000,167920000,335840000,1,41980000
nn_kernel_cpu,16808,0,1,1,64,0,0,0,0,1,41990000
nn_kernel_gpu,2488,1,1,328047,128,0,0,0,0,1,41990000
nn_kernel_gpu_mem,60562,1,1,328047,128,335920000,167960000,167960000,335920000,1,41990000
nn_kernel_cpu,16058,0,1,1,64,0,0,0,0,1,42000000
nn_kernel_gpu,2524,1,1,328125,128,0,0,0,0,1,42000000
nn_kernel_gpu_mem,52000,1,1,328125,128,336000000,168000000,168000000,336000000,1,42000000
nn_kernel_cpu,28773,0,1,1,64,0,0,0,0,1,4200000
nn_kernel_gpu,309,1,1,32813,128,0,0,0,0,1,4200000
nn_kernel_gpu_mem,6345,1,1,32813,128,33600000,16800000,16800000,33600000,1,4200000
nn_kernel_cpu,5402,0,1,1,64,0,0,0,0,1,420000
nn_kernel_gpu,79,1,1,3282,128,0,0,0,0,1,420000
nn_kernel_gpu_mem,1080,1,1,3282,128,3360000,1680000,1680000,3360000,1,420000
nn_kernel_cpu,15101,0,1,1,64,0,0,0,0,1,42010000
nn_kernel_gpu,2492,1,1,328204,128,0,0,0,0,1,42010000
nn_kernel_gpu_mem,62728,1,1,328204,128,336080000,168040000,168040000,336080000,1,42010000
nn_kernel_cpu,21740,0,1,1,64,0,0,0,0,1,42020000
nn_kernel_gpu,2491,1,1,328282,128,0,0,0,0,1,42020000
nn_kernel_gpu_mem,62396,1,1,328282,128,336160000,168080000,168080000,336160000,1,42020000
nn_kernel_cpu,22666,0,1,1,64,0,0,0,0,1,42030000
nn_kernel_gpu,2514,1,1,328360,128,0,0,0,0,1,42030000
nn_kernel_gpu_mem,51420,1,1,328360,128,336240000,168120000,168120000,336240000,1,42030000
nn_kernel_cpu,30751,0,1,1,64,0,0,0,0,1,42040000
nn_kernel_gpu,2487,1,1,328438,128,0,0,0,0,1,42040000
nn_kernel_gpu_mem,61932,1,1,328438,128,336320000,168160000,168160000,336320000,1,42040000
nn_kernel_cpu,15272,0,1,1,64,0,0,0,0,1,42050000
nn_kernel_gpu,2485,1,1,328516,128,0,0,0,0,1,42050000
nn_kernel_gpu_mem,49768,1,1,328516,128,336400000,168200000,168200000,336400000,1,42050000
nn_kernel_cpu,29497,0,1,1,64,0,0,0,0,1,42060000
nn_kernel_gpu,2485,1,1,328594,128,0,0,0,0,1,42060000
nn_kernel_gpu_mem,58594,1,1,328594,128,336480000,168240000,168240000,336480000,1,42060000
nn_kernel_cpu,15590,0,1,1,64,0,0,0,0,1,42070000
nn_kernel_gpu,2495,1,1,328672,128,0,0,0,0,1,42070000
nn_kernel_gpu_mem,61838,1,1,328672,128,336560000,168280000,168280000,336560000,1,42070000
nn_kernel_cpu,25291,0,1,1,64,0,0,0,0,1,42080000
nn_kernel_gpu,2483,1,1,328750,128,0,0,0,0,1,42080000
nn_kernel_gpu_mem,62802,1,1,328750,128,336640000,168320000,168320000,336640000,1,42080000
nn_kernel_cpu,10983,0,1,1,64,0,0,0,0,1,42090000
nn_kernel_gpu,2535,1,1,328829,128,0,0,0,0,1,42090000
nn_kernel_gpu_mem,64124,1,1,328829,128,336720000,168360000,168360000,336720000,1,42090000
nn_kernel_cpu,15953,0,1,1,64,0,0,0,0,1,42100000
nn_kernel_gpu,2512,1,1,328907,128,0,0,0,0,1,42100000
nn_kernel_gpu_mem,60857,1,1,328907,128,336800000,168400000,168400000,336800000,1,42100000
nn_kernel_cpu,23501,0,1,1,64,0,0,0,0,1,4210000
nn_kernel_gpu,310,1,1,32891,128,0,0,0,0,1,4210000
nn_kernel_gpu_mem,6284,1,1,32891,128,33680000,16840000,16840000,33680000,1,4210000
nn_kernel_cpu,17652,0,1,1,64,0,0,0,0,1,42110000
nn_kernel_gpu,2500,1,1,328985,128,0,0,0,0,1,42110000
nn_kernel_gpu_mem,62383,1,1,328985,128,336880000,168440000,168440000,336880000,1,42110000
nn_kernel_cpu,16642,0,1,1,64,0,0,0,0,1,42120000
nn_kernel_gpu,2505,1,1,329063,128,0,0,0,0,1,42120000
nn_kernel_gpu_mem,62131,1,1,329063,128,336960000,168480000,168480000,336960000,1,42120000
nn_kernel_cpu,26087,0,1,1,64,0,0,0,0,1,42130000
nn_kernel_gpu,2507,1,1,329141,128,0,0,0,0,1,42130000
nn_kernel_gpu_mem,62235,1,1,329141,128,337040000,168520000,168520000,337040000,1,42130000
nn_kernel_cpu,29700,0,1,1,64,0,0,0,0,1,42140000
nn_kernel_gpu,2520,1,1,329219,128,0,0,0,0,1,42140000
nn_kernel_gpu_mem,59608,1,1,329219,128,337120000,168560000,168560000,337120000,1,42140000
nn_kernel_cpu,22884,0,1,1,64,0,0,0,0,1,42150000
nn_kernel_gpu,2495,1,1,329297,128,0,0,0,0,1,42150000
nn_kernel_gpu_mem,61746,1,1,329297,128,337200000,168600000,168600000,337200000,1,42150000
nn_kernel_cpu,49094,0,1,1,64,0,0,0,0,1,42160000
nn_kernel_gpu,2491,1,1,329375,128,0,0,0,0,1,42160000
nn_kernel_gpu_mem,62952,1,1,329375,128,337280000,168640000,168640000,337280000,1,42160000
nn_kernel_cpu,30205,0,1,1,64,0,0,0,0,1,42170000
nn_kernel_gpu,2492,1,1,329454,128,0,0,0,0,1,42170000
nn_kernel_gpu_mem,54188,1,1,329454,128,337360000,168680000,168680000,337360000,1,42170000
nn_kernel_cpu,15530,0,1,1,64,0,0,0,0,1,42180000
nn_kernel_gpu,2495,1,1,329532,128,0,0,0,0,1,42180000
nn_kernel_gpu_mem,54656,1,1,329532,128,337440000,168720000,168720000,337440000,1,42180000
nn_kernel_cpu,20065,0,1,1,64,0,0,0,0,1,42190000
nn_kernel_gpu,2497,1,1,329610,128,0,0,0,0,1,42190000
nn_kernel_gpu_mem,61716,1,1,329610,128,337520000,168760000,168760000,337520000,1,42190000
nn_kernel_cpu,32463,0,1,1,64,0,0,0,0,1,42200000
nn_kernel_gpu,2495,1,1,329688,128,0,0,0,0,1,42200000
nn_kernel_gpu_mem,62271,1,1,329688,128,337600000,168800000,168800000,337600000,1,42200000
nn_kernel_cpu,8148,0,1,1,64,0,0,0,0,1,4220000
nn_kernel_gpu,284,1,1,32969,128,0,0,0,0,1,4220000
nn_kernel_gpu_mem,7290,1,1,32969,128,33760000,16880000,16880000,33760000,1,4220000
nn_kernel_cpu,21682,0,1,1,64,0,0,0,0,1,42210000
nn_kernel_gpu,2499,1,1,329766,128,0,0,0,0,1,42210000
nn_kernel_gpu_mem,54423,1,1,329766,128,337680000,168840000,168840000,337680000,1,42210000
nn_kernel_cpu,34993,0,1,1,64,0,0,0,0,1,42220000
nn_kernel_gpu,2515,1,1,329844,128,0,0,0,0,1,42220000
nn_kernel_gpu_mem,63157,1,1,329844,128,337760000,168880000,168880000,337760000,1,42220000
nn_kernel_cpu,23533,0,1,1,64,0,0,0,0,1,42230000
nn_kernel_gpu,2501,1,1,329922,128,0,0,0,0,1,42230000
nn_kernel_gpu_mem,54703,1,1,329922,128,337840000,168920000,168920000,337840000,1,42230000
nn_kernel_cpu,27002,0,1,1,64,0,0,0,0,1,42240000
nn_kernel_gpu,2499,1,1,330000,128,0,0,0,0,1,42240000
nn_kernel_gpu_mem,62615,1,1,330000,128,337920000,168960000,168960000,337920000,1,42240000
nn_kernel_cpu,20493,0,1,1,64,0,0,0,0,1,42250000
nn_kernel_gpu,2547,1,1,330079,128,0,0,0,0,1,42250000
nn_kernel_gpu_mem,59554,1,1,330079,128,338000000,169000000,169000000,338000000,1,42250000
nn_kernel_cpu,20837,0,1,1,64,0,0,0,0,1,42260000
nn_kernel_gpu,2523,1,1,330157,128,0,0,0,0,1,42260000
nn_kernel_gpu_mem,62898,1,1,330157,128,338080000,169040000,169040000,338080000,1,42260000
nn_kernel_cpu,22829,0,1,1,64,0,0,0,0,1,42270000
nn_kernel_gpu,2512,1,1,330235,128,0,0,0,0,1,42270000
nn_kernel_gpu_mem,62951,1,1,330235,128,338160000,169080000,169080000,338160000,1,42270000
nn_kernel_cpu,13947,0,1,1,64,0,0,0,0,1,42280000
nn_kernel_gpu,2503,1,1,330313,128,0,0,0,0,1,42280000
nn_kernel_gpu_mem,64056,1,1,330313,128,338240000,169120000,169120000,338240000,1,42280000
nn_kernel_cpu,27188,0,1,1,64,0,0,0,0,1,42290000
nn_kernel_gpu,2510,1,1,330391,128,0,0,0,0,1,42290000
nn_kernel_gpu_mem,53766,1,1,330391,128,338320000,169160000,169160000,338320000,1,42290000
nn_kernel_cpu,18355,0,1,1,64,0,0,0,0,1,42300000
nn_kernel_gpu,2518,1,1,330469,128,0,0,0,0,1,42300000
nn_kernel_gpu_mem,62678,1,1,330469,128,338400000,169200000,169200000,338400000,1,42300000
nn_kernel_cpu,21272,0,1,1,64,0,0,0,0,1,4230000
nn_kernel_gpu,305,1,1,33047,128,0,0,0,0,1,4230000
nn_kernel_gpu_mem,6353,1,1,33047,128,33840000,16920000,16920000,33840000,1,4230000
nn_kernel_cpu,21315,0,1,1,64,0,0,0,0,1,42310000
nn_kernel_gpu,2518,1,1,330547,128,0,0,0,0,1,42310000
nn_kernel_gpu_mem,62391,1,1,330547,128,338480000,169240000,169240000,338480000,1,42310000
nn_kernel_cpu,17845,0,1,1,64,0,0,0,0,1,42320000
nn_kernel_gpu,2518,1,1,330625,128,0,0,0,0,1,42320000
nn_kernel_gpu_mem,54241,1,1,330625,128,338560000,169280000,169280000,338560000,1,42320000
nn_kernel_cpu,14642,0,1,1,64,0,0,0,0,1,42330000
nn_kernel_gpu,2505,1,1,330704,128,0,0,0,0,1,42330000
nn_kernel_gpu_mem,52002,1,1,330704,128,338640000,169320000,169320000,338640000,1,42330000
nn_kernel_cpu,26014,0,1,1,64,0,0,0,0,1,42340000
nn_kernel_gpu,2519,1,1,330782,128,0,0,0,0,1,42340000
nn_kernel_gpu_mem,62435,1,1,330782,128,338720000,169360000,169360000,338720000,1,42340000
nn_kernel_cpu,27581,0,1,1,64,0,0,0,0,1,42350000
nn_kernel_gpu,2549,1,1,330860,128,0,0,0,0,1,42350000
nn_kernel_gpu_mem,52538,1,1,330860,128,338800000,169400000,169400000,338800000,1,42350000
nn_kernel_cpu,25748,0,1,1,64,0,0,0,0,1,42360000
nn_kernel_gpu,2509,1,1,330938,128,0,0,0,0,1,42360000
nn_kernel_gpu_mem,54534,1,1,330938,128,338880000,169440000,169440000,338880000,1,42360000
nn_kernel_cpu,21879,0,1,1,64,0,0,0,0,1,42370000
nn_kernel_gpu,2520,1,1,331016,128,0,0,0,0,1,42370000
nn_kernel_gpu_mem,62488,1,1,331016,128,338960000,169480000,169480000,338960000,1,42370000
nn_kernel_cpu,15418,0,1,1,64,0,0,0,0,1,42380000
nn_kernel_gpu,2499,1,1,331094,128,0,0,0,0,1,42380000
nn_kernel_gpu_mem,56081,1,1,331094,128,339040000,169520000,169520000,339040000,1,42380000
nn_kernel_cpu,11577,0,1,1,64,0,0,0,0,1,42390000
nn_kernel_gpu,2534,1,1,331172,128,0,0,0,0,1,42390000
nn_kernel_gpu_mem,50916,1,1,331172,128,339120000,169560000,169560000,339120000,1,42390000
nn_kernel_cpu,13723,0,1,1,64,0,0,0,0,1,42400000
nn_kernel_gpu,2513,1,1,331250,128,0,0,0,0,1,42400000
nn_kernel_gpu_mem,53253,1,1,331250,128,339200000,169600000,169600000,339200000,1,42400000
nn_kernel_cpu,36137,0,1,1,64,0,0,0,0,1,4240000
nn_kernel_gpu,307,1,1,33125,128,0,0,0,0,1,4240000
nn_kernel_gpu_mem,6276,1,1,33125,128,33920000,16960000,16960000,33920000,1,4240000
nn_kernel_cpu,17365,0,1,1,64,0,0,0,0,1,42410000
nn_kernel_gpu,2506,1,1,331329,128,0,0,0,0,1,42410000
nn_kernel_gpu_mem,62327,1,1,331329,128,339280000,169640000,169640000,339280000,1,42410000
nn_kernel_cpu,24485,0,1,1,64,0,0,0,0,1,42420000
nn_kernel_gpu,2512,1,1,331407,128,0,0,0,0,1,42420000
nn_kernel_gpu_mem,62700,1,1,331407,128,339360000,169680000,169680000,339360000,1,42420000
nn_kernel_cpu,27511,0,1,1,64,0,0,0,0,1,42430000
nn_kernel_gpu,2511,1,1,331485,128,0,0,0,0,1,42430000
nn_kernel_gpu_mem,54404,1,1,331485,128,339440000,169720000,169720000,339440000,1,42430000
nn_kernel_cpu,25286,0,1,1,64,0,0,0,0,1,42440000
nn_kernel_gpu,2511,1,1,331563,128,0,0,0,0,1,42440000
nn_kernel_gpu_mem,61947,1,1,331563,128,339520000,169760000,169760000,339520000,1,42440000
nn_kernel_cpu,16319,0,1,1,64,0,0,0,0,1,42450000
nn_kernel_gpu,2519,1,1,331641,128,0,0,0,0,1,42450000
nn_kernel_gpu_mem,61653,1,1,331641,128,339600000,169800000,169800000,339600000,1,42450000
nn_kernel_cpu,24354,0,1,1,64,0,0,0,0,1,42460000
nn_kernel_gpu,2520,1,1,331719,128,0,0,0,0,1,42460000
nn_kernel_gpu_mem,62259,1,1,331719,128,339680000,169840000,169840000,339680000,1,42460000
nn_kernel_cpu,22121,0,1,1,64,0,0,0,0,1,42470000
nn_kernel_gpu,2561,1,1,331797,128,0,0,0,0,1,42470000
nn_kernel_gpu_mem,63544,1,1,331797,128,339760000,169880000,169880000,339760000,1,42470000
nn_kernel_cpu,32525,0,1,1,64,0,0,0,0,1,42480000
nn_kernel_gpu,2535,1,1,331875,128,0,0,0,0,1,42480000
nn_kernel_gpu_mem,63829,1,1,331875,128,339840000,169920000,169920000,339840000,1,42480000
nn_kernel_cpu,13783,0,1,1,64,0,0,0,0,1,42490000
nn_kernel_gpu,2543,1,1,331954,128,0,0,0,0,1,42490000
nn_kernel_gpu_mem,65780,1,1,331954,128,339920000,169960000,169960000,339920000,1,42490000
nn_kernel_cpu,33460,0,1,1,64,0,0,0,0,1,42500000
nn_kernel_gpu,2536,1,1,332032,128,0,0,0,0,1,42500000
nn_kernel_gpu_mem,62608,1,1,332032,128,340000000,170000000,170000000,340000000,1,42500000
nn_kernel_cpu,6251,0,1,1,64,0,0,0,0,1,4250000
nn_kernel_gpu,336,1,1,33204,128,0,0,0,0,1,4250000
nn_kernel_gpu_mem,6545,1,1,33204,128,34000000,17000000,17000000,34000000,1,4250000
nn_kernel_cpu,31548,0,1,1,64,0,0,0,0,1,42510000
nn_kernel_gpu,2557,1,1,332110,128,0,0,0,0,1,42510000
nn_kernel_gpu_mem,56386,1,1,332110,128,340080000,170040000,170040000,340080000,1,42510000
nn_kernel_cpu,33411,0,1,1,64,0,0,0,0,1,42520000
nn_kernel_gpu,2541,1,1,332188,128,0,0,0,0,1,42520000
nn_kernel_gpu_mem,59885,1,1,332188,128,340160000,170080000,170080000,340160000,1,42520000
nn_kernel_cpu,26159,0,1,1,64,0,0,0,0,1,42530000
nn_kernel_gpu,2533,1,1,332266,128,0,0,0,0,1,42530000
nn_kernel_gpu_mem,63384,1,1,332266,128,340240000,170120000,170120000,340240000,1,42530000
nn_kernel_cpu,26235,0,1,1,64,0,0,0,0,1,42540000
nn_kernel_gpu,2536,1,1,332344,128,0,0,0,0,1,42540000
nn_kernel_gpu_mem,49034,1,1,332344,128,340320000,170160000,170160000,340320000,1,42540000
nn_kernel_cpu,25170,0,1,1,64,0,0,0,0,1,42550000
nn_kernel_gpu,2548,1,1,332422,128,0,0,0,0,1,42550000
nn_kernel_gpu_mem,63440,1,1,332422,128,340400000,170200000,170200000,340400000,1,42550000
nn_kernel_cpu,25234,0,1,1,64,0,0,0,0,1,42560000
nn_kernel_gpu,2538,1,1,332500,128,0,0,0,0,1,42560000
nn_kernel_gpu_mem,64510,1,1,332500,128,340480000,170240000,170240000,340480000,1,42560000
nn_kernel_cpu,46457,0,1,1,64,0,0,0,0,1,42570000
nn_kernel_gpu,2530,1,1,332579,128,0,0,0,0,1,42570000
nn_kernel_gpu_mem,51780,1,1,332579,128,340560000,170280000,170280000,340560000,1,42570000
nn_kernel_cpu,16997,0,1,1,64,0,0,0,0,1,42580000
nn_kernel_gpu,2535,1,1,332657,128,0,0,0,0,1,42580000
nn_kernel_gpu_mem,63169,1,1,332657,128,340640000,170320000,170320000,340640000,1,42580000
nn_kernel_cpu,78617,0,1,1,64,0,0,0,0,1,42590000
nn_kernel_gpu,2558,1,1,332735,128,0,0,0,0,1,42590000
nn_kernel_gpu_mem,54259,1,1,332735,128,340720000,170360000,170360000,340720000,1,42590000
nn_kernel_cpu,28461,0,1,1,64,0,0,0,0,1,42600000
nn_kernel_gpu,2538,1,1,332813,128,0,0,0,0,1,42600000
nn_kernel_gpu_mem,63483,1,1,332813,128,340800000,170400000,170400000,340800000,1,42600000
nn_kernel_cpu,48111,0,1,1,64,0,0,0,0,1,4260000
nn_kernel_gpu,293,1,1,33282,128,0,0,0,0,1,4260000
nn_kernel_gpu_mem,6450,1,1,33282,128,34080000,17040000,17040000,34080000,1,4260000
nn_kernel_cpu,12828,0,1,1,64,0,0,0,0,1,42610000
nn_kernel_gpu,2534,1,1,332891,128,0,0,0,0,1,42610000
nn_kernel_gpu_mem,62546,1,1,332891,128,340880000,170440000,170440000,340880000,1,42610000
nn_kernel_cpu,9225,0,1,1,64,0,0,0,0,1,42620000
nn_kernel_gpu,2530,1,1,332969,128,0,0,0,0,1,42620000
nn_kernel_gpu_mem,51354,1,1,332969,128,340960000,170480000,170480000,340960000,1,42620000
nn_kernel_cpu,15250,0,1,1,64,0,0,0,0,1,42630000
nn_kernel_gpu,2554,1,1,333047,128,0,0,0,0,1,42630000
nn_kernel_gpu_mem,62626,1,1,333047,128,341040000,170520000,170520000,341040000,1,42630000
nn_kernel_cpu,9235,0,1,1,64,0,0,0,0,1,42640000
nn_kernel_gpu,2561,1,1,333125,128,0,0,0,0,1,42640000
nn_kernel_gpu_mem,63103,1,1,333125,128,341120000,170560000,170560000,341120000,1,42640000
nn_kernel_cpu,30650,0,1,1,64,0,0,0,0,1,42650000
nn_kernel_gpu,2559,1,1,333204,128,0,0,0,0,1,42650000
nn_kernel_gpu_mem,62735,1,1,333204,128,341200000,170600000,170600000,341200000,1,42650000
nn_kernel_cpu,38255,0,1,1,64,0,0,0,0,1,42660000
nn_kernel_gpu,2563,1,1,333282,128,0,0,0,0,1,42660000
nn_kernel_gpu_mem,55384,1,1,333282,128,341280000,170640000,170640000,341280000,1,42660000
nn_kernel_cpu,16770,0,1,1,64,0,0,0,0,1,42670000
nn_kernel_gpu,2560,1,1,333360,128,0,0,0,0,1,42670000
nn_kernel_gpu_mem,64716,1,1,333360,128,341360000,170680000,170680000,341360000,1,42670000
nn_kernel_cpu,28202,0,1,1,64,0,0,0,0,1,42680000
nn_kernel_gpu,2595,1,1,333438,128,0,0,0,0,1,42680000
nn_kernel_gpu_mem,55696,1,1,333438,128,341440000,170720000,170720000,341440000,1,42680000
nn_kernel_cpu,42827,0,1,1,64,0,0,0,0,1,42690000
nn_kernel_gpu,2559,1,1,333516,128,0,0,0,0,1,42690000
nn_kernel_gpu_mem,63557,1,1,333516,128,341520000,170760000,170760000,341520000,1,42690000
nn_kernel_cpu,35011,0,1,1,64,0,0,0,0,1,42700000
nn_kernel_gpu,2552,1,1,333594,128,0,0,0,0,1,42700000
nn_kernel_gpu_mem,69252,1,1,333594,128,341600000,170800000,170800000,341600000,1,42700000
nn_kernel_cpu,8310,0,1,1,64,0,0,0,0,1,4270000
nn_kernel_gpu,288,1,1,33360,128,0,0,0,0,1,4270000
nn_kernel_gpu_mem,6991,1,1,33360,128,34160000,17080000,17080000,34160000,1,4270000
nn_kernel_cpu,26923,0,1,1,64,0,0,0,0,1,42710000
nn_kernel_gpu,2560,1,1,333672,128,0,0,0,0,1,42710000
nn_kernel_gpu_mem,53893,1,1,333672,128,341680000,170840000,170840000,341680000,1,42710000
nn_kernel_cpu,11420,0,1,1,64,0,0,0,0,1,42720000
nn_kernel_gpu,2550,1,1,333750,128,0,0,0,0,1,42720000
nn_kernel_gpu_mem,63437,1,1,333750,128,341760000,170880000,170880000,341760000,1,42720000
nn_kernel_cpu,29518,0,1,1,64,0,0,0,0,1,42730000
nn_kernel_gpu,2559,1,1,333829,128,0,0,0,0,1,42730000
nn_kernel_gpu_mem,63859,1,1,333829,128,341840000,170920000,170920000,341840000,1,42730000
nn_kernel_cpu,10669,0,1,1,64,0,0,0,0,1,42740000
nn_kernel_gpu,2560,1,1,333907,128,0,0,0,0,1,42740000
nn_kernel_gpu_mem,62438,1,1,333907,128,341920000,170960000,170960000,341920000,1,42740000
nn_kernel_cpu,18261,0,1,1,64,0,0,0,0,1,42750000
nn_kernel_gpu,2543,1,1,333985,128,0,0,0,0,1,42750000
nn_kernel_gpu_mem,63153,1,1,333985,128,342000000,171000000,171000000,342000000,1,42750000
nn_kernel_cpu,20319,0,1,1,64,0,0,0,0,1,42760000
nn_kernel_gpu,2550,1,1,334063,128,0,0,0,0,1,42760000
nn_kernel_gpu_mem,63965,1,1,334063,128,342080000,171040000,171040000,342080000,1,42760000
nn_kernel_cpu,38865,0,1,1,64,0,0,0,0,1,42770000
nn_kernel_gpu,2596,1,1,334141,128,0,0,0,0,1,42770000
nn_kernel_gpu_mem,53175,1,1,334141,128,342160000,171080000,171080000,342160000,1,42770000
nn_kernel_cpu,24499,0,1,1,64,0,0,0,0,1,42780000
nn_kernel_gpu,2561,1,1,334219,128,0,0,0,0,1,42780000
nn_kernel_gpu_mem,64191,1,1,334219,128,342240000,171120000,171120000,342240000,1,42780000
nn_kernel_cpu,31911,0,1,1,64,0,0,0,0,1,42790000
nn_kernel_gpu,2561,1,1,334297,128,0,0,0,0,1,42790000
nn_kernel_gpu_mem,60582,1,1,334297,128,342320000,171160000,171160000,342320000,1,42790000
nn_kernel_cpu,21049,0,1,1,64,0,0,0,0,1,42800000
nn_kernel_gpu,2555,1,1,334375,128,0,0,0,0,1,42800000
nn_kernel_gpu_mem,62220,1,1,334375,128,342400000,171200000,171200000,342400000,1,42800000
nn_kernel_cpu,16177,0,1,1,64,0,0,0,0,1,4280000
nn_kernel_gpu,297,1,1,33438,128,0,0,0,0,1,4280000
nn_kernel_gpu_mem,6693,1,1,33438,128,34240000,17120000,17120000,34240000,1,4280000
nn_kernel_cpu,14975,0,1,1,64,0,0,0,0,1,42810000
nn_kernel_gpu,2549,1,1,334454,128,0,0,0,0,1,42810000
nn_kernel_gpu_mem,63052,1,1,334454,128,342480000,171240000,171240000,342480000,1,42810000
nn_kernel_cpu,34822,0,1,1,64,0,0,0,0,1,42820000
nn_kernel_gpu,2549,1,1,334532,128,0,0,0,0,1,42820000
nn_kernel_gpu_mem,54756,1,1,334532,128,342560000,171280000,171280000,342560000,1,42820000
nn_kernel_cpu,25908,0,1,1,64,0,0,0,0,1,42830000
nn_kernel_gpu,2551,1,1,334610,128,0,0,0,0,1,42830000
nn_kernel_gpu_mem,64165,1,1,334610,128,342640000,171320000,171320000,342640000,1,42830000
nn_kernel_cpu,32754,0,1,1,64,0,0,0,0,1,42840000
nn_kernel_gpu,2546,1,1,334688,128,0,0,0,0,1,42840000
nn_kernel_gpu_mem,51344,1,1,334688,128,342720000,171360000,171360000,342720000,1,42840000
nn_kernel_cpu,20014,0,1,1,64,0,0,0,0,1,42850000
nn_kernel_gpu,2560,1,1,334766,128,0,0,0,0,1,42850000
nn_kernel_gpu_mem,63913,1,1,334766,128,342800000,171400000,171400000,342800000,1,42850000
nn_kernel_cpu,59458,0,1,1,64,0,0,0,0,1,42860000
nn_kernel_gpu,2553,1,1,334844,128,0,0,0,0,1,42860000
nn_kernel_gpu_mem,63591,1,1,334844,128,342880000,171440000,171440000,342880000,1,42860000
nn_kernel_cpu,20190,0,1,1,64,0,0,0,0,1,42870000
nn_kernel_gpu,2556,1,1,334922,128,0,0,0,0,1,42870000
nn_kernel_gpu_mem,64499,1,1,334922,128,342960000,171480000,171480000,342960000,1,42870000
nn_kernel_cpu,25397,0,1,1,64,0,0,0,0,1,42880000
nn_kernel_gpu,2608,1,1,335000,128,0,0,0,0,1,42880000
nn_kernel_gpu_mem,55510,1,1,335000,128,343040000,171520000,171520000,343040000,1,42880000
nn_kernel_cpu,36999,0,1,1,64,0,0,0,0,1,42890000
nn_kernel_gpu,2551,1,1,335079,128,0,0,0,0,1,42890000
nn_kernel_gpu_mem,57431,1,1,335079,128,343120000,171560000,171560000,343120000,1,42890000
nn_kernel_cpu,16306,0,1,1,64,0,0,0,0,1,42900000
nn_kernel_gpu,2570,1,1,335157,128,0,0,0,0,1,42900000
nn_kernel_gpu_mem,62674,1,1,335157,128,343200000,171600000,171600000,343200000,1,42900000
nn_kernel_cpu,5730,0,1,1,64,0,0,0,0,1,4290000
nn_kernel_gpu,297,1,1,33516,128,0,0,0,0,1,4290000
nn_kernel_gpu_mem,6912,1,1,33516,128,34320000,17160000,17160000,34320000,1,4290000
nn_kernel_cpu,25114,0,1,1,64,0,0,0,0,1,42910000
nn_kernel_gpu,2565,1,1,335235,128,0,0,0,0,1,42910000
nn_kernel_gpu_mem,63419,1,1,335235,128,343280000,171640000,171640000,343280000,1,42910000
nn_kernel_cpu,26858,0,1,1,64,0,0,0,0,1,42920000
nn_kernel_gpu,2571,1,1,335313,128,0,0,0,0,1,42920000
nn_kernel_gpu_mem,59955,1,1,335313,128,343360000,171680000,171680000,343360000,1,42920000
nn_kernel_cpu,24789,0,1,1,64,0,0,0,0,1,42930000
nn_kernel_gpu,2567,1,1,335391,128,0,0,0,0,1,42930000
nn_kernel_gpu_mem,67138,1,1,335391,128,343440000,171720000,171720000,343440000,1,42930000
nn_kernel_cpu,32101,0,1,1,64,0,0,0,0,1,42940000
nn_kernel_gpu,2620,1,1,335469,128,0,0,0,0,1,42940000
nn_kernel_gpu_mem,58317,1,1,335469,128,343520000,171760000,171760000,343520000,1,42940000
nn_kernel_cpu,26069,0,1,1,64,0,0,0,0,1,42950000
nn_kernel_gpu,2560,1,1,335547,128,0,0,0,0,1,42950000
nn_kernel_gpu_mem,55574,1,1,335547,128,343600000,171800000,171800000,343600000,1,42950000
nn_kernel_cpu,29309,0,1,1,64,0,0,0,0,1,42960000
nn_kernel_gpu,2580,1,1,335625,128,0,0,0,0,1,42960000
nn_kernel_gpu_mem,62398,1,1,335625,128,343680000,171840000,171840000,343680000,1,42960000
nn_kernel_cpu,25500,0,1,1,64,0,0,0,0,1,42970000
nn_kernel_gpu,2558,1,1,335704,128,0,0,0,0,1,42970000
nn_kernel_gpu_mem,62950,1,1,335704,128,343760000,171880000,171880000,343760000,1,42970000
nn_kernel_cpu,33804,0,1,1,64,0,0,0,0,1,42980000
nn_kernel_gpu,2619,1,1,335782,128,0,0,0,0,1,42980000
nn_kernel_gpu_mem,54798,1,1,335782,128,343840000,171920000,171920000,343840000,1,42980000
nn_kernel_cpu,43696,0,1,1,64,0,0,0,0,1,42990000
nn_kernel_gpu,2557,1,1,335860,128,0,0,0,0,1,42990000
nn_kernel_gpu_mem,63143,1,1,335860,128,343920000,171960000,171960000,343920000,1,42990000
nn_kernel_cpu,21607,0,1,1,64,0,0,0,0,1,43000000
nn_kernel_gpu,2546,1,1,335938,128,0,0,0,0,1,43000000
nn_kernel_gpu_mem,63585,1,1,335938,128,344000000,172000000,172000000,344000000,1,43000000
nn_kernel_cpu,28864,0,1,1,64,0,0,0,0,1,4300000
nn_kernel_gpu,304,1,1,33594,128,0,0,0,0,1,4300000
nn_kernel_gpu_mem,7093,1,1,33594,128,34400000,17200000,17200000,34400000,1,4300000
nn_kernel_cpu,892,0,1,1,64,0,0,0,0,1,430000
nn_kernel_gpu,66,1,1,3360,128,0,0,0,0,1,430000
nn_kernel_gpu_mem,1779,1,1,3360,128,3440000,1720000,1720000,3440000,1,430000
nn_kernel_cpu,31083,0,1,1,64,0,0,0,0,1,43010000
nn_kernel_gpu,2544,1,1,336016,128,0,0,0,0,1,43010000
nn_kernel_gpu_mem,65996,1,1,336016,128,344080000,172040000,172040000,344080000,1,43010000
nn_kernel_cpu,17241,0,1,1,64,0,0,0,0,1,43020000
nn_kernel_gpu,2559,1,1,336094,128,0,0,0,0,1,43020000
nn_kernel_gpu_mem,64561,1,1,336094,128,344160000,172080000,172080000,344160000,1,43020000
nn_kernel_cpu,13499,0,1,1,64,0,0,0,0,1,43030000
nn_kernel_gpu,2603,1,1,336172,128,0,0,0,0,1,43030000
nn_kernel_gpu_mem,63721,1,1,336172,128,344240000,172120000,172120000,344240000,1,43030000
nn_kernel_cpu,16408,0,1,1,64,0,0,0,0,1,43040000
nn_kernel_gpu,2550,1,1,336250,128,0,0,0,0,1,43040000
nn_kernel_gpu_mem,63432,1,1,336250,128,344320000,172160000,172160000,344320000,1,43040000
nn_kernel_cpu,22429,0,1,1,64,0,0,0,0,1,43050000
nn_kernel_gpu,2547,1,1,336329,128,0,0,0,0,1,43050000
nn_kernel_gpu_mem,55730,1,1,336329,128,344400000,172200000,172200000,344400000,1,43050000
nn_kernel_cpu,8761,0,1,1,64,0,0,0,0,1,43060000
nn_kernel_gpu,2555,1,1,336407,128,0,0,0,0,1,43060000
nn_kernel_gpu_mem,63082,1,1,336407,128,344480000,172240000,172240000,344480000,1,43060000
nn_kernel_cpu,18908,0,1,1,64,0,0,0,0,1,43070000
nn_kernel_gpu,2552,1,1,336485,128,0,0,0,0,1,43070000
nn_kernel_gpu_mem,64463,1,1,336485,128,344560000,172280000,172280000,344560000,1,43070000
nn_kernel_cpu,46189,0,1,1,64,0,0,0,0,1,43080000
nn_kernel_gpu,2563,1,1,336563,128,0,0,0,0,1,43080000
nn_kernel_gpu_mem,64058,1,1,336563,128,344640000,172320000,172320000,344640000,1,43080000
nn_kernel_cpu,27709,0,1,1,64,0,0,0,0,1,43090000
nn_kernel_gpu,2546,1,1,336641,128,0,0,0,0,1,43090000
nn_kernel_gpu_mem,65482,1,1,336641,128,344720000,172360000,172360000,344720000,1,43090000
nn_kernel_cpu,25515,0,1,1,64,0,0,0,0,1,43100000
nn_kernel_gpu,2544,1,1,336719,128,0,0,0,0,1,43100000
nn_kernel_gpu_mem,61281,1,1,336719,128,344800000,172400000,172400000,344800000,1,43100000
nn_kernel_cpu,14975,0,1,1,64,0,0,0,0,1,4310000
nn_kernel_gpu,290,1,1,33672,128,0,0,0,0,1,4310000
nn_kernel_gpu_mem,6743,1,1,33672,128,34480000,17240000,17240000,34480000,1,4310000
nn_kernel_cpu,15983,0,1,1,64,0,0,0,0,1,43110000
nn_kernel_gpu,2567,1,1,336797,128,0,0,0,0,1,43110000
nn_kernel_gpu_mem,63888,1,1,336797,128,344880000,172440000,172440000,344880000,1,43110000
nn_kernel_cpu,22328,0,1,1,64,0,0,0,0,1,43120000
nn_kernel_gpu,2559,1,1,336875,128,0,0,0,0,1,43120000
nn_kernel_gpu_mem,63040,1,1,336875,128,344960000,172480000,172480000,344960000,1,43120000
nn_kernel_cpu,14866,0,1,1,64,0,0,0,0,1,43130000
nn_kernel_gpu,2609,1,1,336954,128,0,0,0,0,1,43130000
nn_kernel_gpu_mem,64406,1,1,336954,128,345040000,172520000,172520000,345040000,1,43130000
nn_kernel_cpu,29006,0,1,1,64,0,0,0,0,1,43140000
nn_kernel_gpu,2574,1,1,337032,128,0,0,0,0,1,43140000
nn_kernel_gpu_mem,56138,1,1,337032,128,345120000,172560000,172560000,345120000,1,43140000
nn_kernel_cpu,23730,0,1,1,64,0,0,0,0,1,43150000
nn_kernel_gpu,2552,1,1,337110,128,0,0,0,0,1,43150000
nn_kernel_gpu_mem,63279,1,1,337110,128,345200000,172600000,172600000,345200000,1,43150000
nn_kernel_cpu,27242,0,1,1,64,0,0,0,0,1,43160000
nn_kernel_gpu,2554,1,1,337188,128,0,0,0,0,1,43160000
nn_kernel_gpu_mem,64525,1,1,337188,128,345280000,172640000,172640000,345280000,1,43160000
nn_kernel_cpu,20493,0,1,1,64,0,0,0,0,1,43170000
nn_kernel_gpu,2568,1,1,337266,128,0,0,0,0,1,43170000
nn_kernel_gpu_mem,62771,1,1,337266,128,345360000,172680000,172680000,345360000,1,43170000
nn_kernel_cpu,11513,0,1,1,64,0,0,0,0,1,43180000
nn_kernel_gpu,2565,1,1,337344,128,0,0,0,0,1,43180000
nn_kernel_gpu_mem,64641,1,1,337344,128,345440000,172720000,172720000,345440000,1,43180000
nn_kernel_cpu,12967,0,1,1,64,0,0,0,0,1,43190000
nn_kernel_gpu,2559,1,1,337422,128,0,0,0,0,1,43190000
nn_kernel_gpu_mem,63430,1,1,337422,128,345520000,172760000,172760000,345520000,1,43190000
nn_kernel_cpu,17434,0,1,1,64,0,0,0,0,1,43200000
nn_kernel_gpu,2552,1,1,337500,128,0,0,0,0,1,43200000
nn_kernel_gpu_mem,64875,1,1,337500,128,345600000,172800000,172800000,345600000,1,43200000
nn_kernel_cpu,15749,0,1,1,64,0,0,0,0,1,4320000
nn_kernel_gpu,292,1,1,33750,128,0,0,0,0,1,4320000
nn_kernel_gpu_mem,6799,1,1,33750,128,34560000,17280000,17280000,34560000,1,4320000
nn_kernel_cpu,27314,0,1,1,64,0,0,0,0,1,43210000
nn_kernel_gpu,2560,1,1,337579,128,0,0,0,0,1,43210000
nn_kernel_gpu_mem,66382,1,1,337579,128,345680000,172840000,172840000,345680000,1,43210000
nn_kernel_cpu,19352,0,1,1,64,0,0,0,0,1,43220000
nn_kernel_gpu,2561,1,1,337657,128,0,0,0,0,1,43220000
nn_kernel_gpu_mem,63162,1,1,337657,128,345760000,172880000,172880000,345760000,1,43220000
nn_kernel_cpu,10638,0,1,1,64,0,0,0,0,1,43230000
nn_kernel_gpu,2557,1,1,337735,128,0,0,0,0,1,43230000
nn_kernel_gpu_mem,54702,1,1,337735,128,345840000,172920000,172920000,345840000,1,43230000
nn_kernel_cpu,16072,0,1,1,64,0,0,0,0,1,43240000
nn_kernel_gpu,2562,1,1,337813,128,0,0,0,0,1,43240000
nn_kernel_gpu_mem,62270,1,1,337813,128,345920000,172960000,172960000,345920000,1,43240000
nn_kernel_cpu,27467,0,1,1,64,0,0,0,0,1,43250000
nn_kernel_gpu,2612,1,1,337891,128,0,0,0,0,1,43250000
nn_kernel_gpu_mem,67239,1,1,337891,128,346000000,173000000,173000000,346000000,1,43250000
nn_kernel_cpu,23436,0,1,1,64,0,0,0,0,1,43260000
nn_kernel_gpu,2567,1,1,337969,128,0,0,0,0,1,43260000
nn_kernel_gpu_mem,57786,1,1,337969,128,346080000,173040000,173040000,346080000,1,43260000
nn_kernel_cpu,31450,0,1,1,64,0,0,0,0,1,43270000
nn_kernel_gpu,2572,1,1,338047,128,0,0,0,0,1,43270000
nn_kernel_gpu_mem,64453,1,1,338047,128,346160000,173080000,173080000,346160000,1,43270000
nn_kernel_cpu,38046,0,1,1,64,0,0,0,0,1,43280000
nn_kernel_gpu,2566,1,1,338125,128,0,0,0,0,1,43280000
nn_kernel_gpu_mem,57429,1,1,338125,128,346240000,173120000,173120000,346240000,1,43280000
nn_kernel_cpu,29039,0,1,1,64,0,0,0,0,1,43290000
nn_kernel_gpu,2560,1,1,338204,128,0,0,0,0,1,43290000
nn_kernel_gpu_mem,55294,1,1,338204,128,346320000,173160000,173160000,346320000,1,43290000
nn_kernel_cpu,29792,0,1,1,64,0,0,0,0,1,43300000
nn_kernel_gpu,2549,1,1,338282,128,0,0,0,0,1,43300000
nn_kernel_gpu_mem,52552,1,1,338282,128,346400000,173200000,173200000,346400000,1,43300000
nn_kernel_cpu,19737,0,1,1,64,0,0,0,0,1,4330000
nn_kernel_gpu,290,1,1,33829,128,0,0,0,0,1,4330000
nn_kernel_gpu_mem,12676,1,1,33829,128,34640000,17320000,17320000,34640000,1,4330000
nn_kernel_cpu,29011,0,1,1,64,0,0,0,0,1,43310000
nn_kernel_gpu,2572,1,1,338360,128,0,0,0,0,1,43310000
nn_kernel_gpu_mem,55848,1,1,338360,128,346480000,173240000,173240000,346480000,1,43310000
nn_kernel_cpu,26070,0,1,1,64,0,0,0,0,1,43320000
nn_kernel_gpu,2576,1,1,338438,128,0,0,0,0,1,43320000
nn_kernel_gpu_mem,56257,1,1,338438,128,346560000,173280000,173280000,346560000,1,43320000
nn_kernel_cpu,45812,0,1,1,64,0,0,0,0,1,43330000
nn_kernel_gpu,2566,1,1,338516,128,0,0,0,0,1,43330000
nn_kernel_gpu_mem,69418,1,1,338516,128,346640000,173320000,173320000,346640000,1,43330000
nn_kernel_cpu,35654,0,1,1,64,0,0,0,0,1,43340000
nn_kernel_gpu,2595,1,1,338594,128,0,0,0,0,1,43340000
nn_kernel_gpu_mem,59163,1,1,338594,128,346720000,173360000,173360000,346720000,1,43340000
nn_kernel_cpu,28027,0,1,1,64,0,0,0,0,1,43350000
nn_kernel_gpu,2573,1,1,338672,128,0,0,0,0,1,43350000
nn_kernel_gpu_mem,52059,1,1,338672,128,346800000,173400000,173400000,346800000,1,43350000
nn_kernel_cpu,26979,0,1,1,64,0,0,0,0,1,43360000
nn_kernel_gpu,2555,1,1,338750,128,0,0,0,0,1,43360000
nn_kernel_gpu_mem,51351,1,1,338750,128,346880000,173440000,173440000,346880000,1,43360000
nn_kernel_cpu,27073,0,1,1,64,0,0,0,0,1,43370000
nn_kernel_gpu,2562,1,1,338829,128,0,0,0,0,1,43370000
nn_kernel_gpu_mem,59189,1,1,338829,128,346960000,173480000,173480000,346960000,1,43370000
nn_kernel_cpu,35131,0,1,1,64,0,0,0,0,1,43380000
nn_kernel_gpu,2575,1,1,338907,128,0,0,0,0,1,43380000
nn_kernel_gpu_mem,54931,1,1,338907,128,347040000,173520000,173520000,347040000,1,43380000
nn_kernel_cpu,25707,0,1,1,64,0,0,0,0,1,43390000
nn_kernel_gpu,2565,1,1,338985,128,0,0,0,0,1,43390000
nn_kernel_gpu_mem,53129,1,1,338985,128,347120000,173560000,173560000,347120000,1,43390000
nn_kernel_cpu,21506,0,1,1,64,0,0,0,0,1,43400000
nn_kernel_gpu,2557,1,1,339063,128,0,0,0,0,1,43400000
nn_kernel_gpu_mem,60727,1,1,339063,128,347200000,173600000,173600000,347200000,1,43400000
nn_kernel_cpu,12923,0,1,1,64,0,0,0,0,1,4340000
nn_kernel_gpu,299,1,1,33907,128,0,0,0,0,1,4340000
nn_kernel_gpu_mem,5526,1,1,33907,128,34720000,17360000,17360000,34720000,1,4340000
nn_kernel_cpu,26387,0,1,1,64,0,0,0,0,1,43410000
nn_kernel_gpu,2573,1,1,339141,128,0,0,0,0,1,43410000
nn_kernel_gpu_mem,66838,1,1,339141,128,347280000,173640000,173640000,347280000,1,43410000
nn_kernel_cpu,25415,0,1,1,64,0,0,0,0,1,43420000
nn_kernel_gpu,2560,1,1,339219,128,0,0,0,0,1,43420000
nn_kernel_gpu_mem,60777,1,1,339219,128,347360000,173680000,173680000,347360000,1,43420000
nn_kernel_cpu,19859,0,1,1,64,0,0,0,0,1,43430000
nn_kernel_gpu,2572,1,1,339297,128,0,0,0,0,1,43430000
nn_kernel_gpu_mem,72263,1,1,339297,128,347440000,173720000,173720000,347440000,1,43430000
nn_kernel_cpu,25538,0,1,1,64,0,0,0,0,1,43440000
nn_kernel_gpu,2562,1,1,339375,128,0,0,0,0,1,43440000
nn_kernel_gpu_mem,57281,1,1,339375,128,347520000,173760000,173760000,347520000,1,43440000
nn_kernel_cpu,30489,0,1,1,64,0,0,0,0,1,43450000
nn_kernel_gpu,2570,1,1,339454,128,0,0,0,0,1,43450000
nn_kernel_gpu_mem,66604,1,1,339454,128,347600000,173800000,173800000,347600000,1,43450000
nn_kernel_cpu,26402,0,1,1,64,0,0,0,0,1,43460000
nn_kernel_gpu,2566,1,1,339532,128,0,0,0,0,1,43460000
nn_kernel_gpu_mem,54993,1,1,339532,128,347680000,173840000,173840000,347680000,1,43460000
nn_kernel_cpu,26353,0,1,1,64,0,0,0,0,1,43470000
nn_kernel_gpu,2573,1,1,339610,128,0,0,0,0,1,43470000
nn_kernel_gpu_mem,54042,1,1,339610,128,347760000,173880000,173880000,347760000,1,43470000
nn_kernel_cpu,23220,0,1,1,64,0,0,0,0,1,43480000
nn_kernel_gpu,2552,1,1,339688,128,0,0,0,0,1,43480000
nn_kernel_gpu_mem,53031,1,1,339688,128,347840000,173920000,173920000,347840000,1,43480000
nn_kernel_cpu,23574,0,1,1,64,0,0,0,0,1,43490000
nn_kernel_gpu,2571,1,1,339766,128,0,0,0,0,1,43490000
nn_kernel_gpu_mem,56365,1,1,339766,128,347920000,173960000,173960000,347920000,1,43490000
nn_kernel_cpu,35725,0,1,1,64,0,0,0,0,1,43500000
nn_kernel_gpu,2577,1,1,339844,128,0,0,0,0,1,43500000
nn_kernel_gpu_mem,55388,1,1,339844,128,348000000,174000000,174000000,348000000,1,43500000
nn_kernel_cpu,4983,0,1,1,64,0,0,0,0,1,4350000
nn_kernel_gpu,293,1,1,33985,128,0,0,0,0,1,4350000
nn_kernel_gpu_mem,6761,1,1,33985,128,34800000,17400000,17400000,34800000,1,4350000
nn_kernel_cpu,28978,0,1,1,64,0,0,0,0,1,43510000
nn_kernel_gpu,2577,1,1,339922,128,0,0,0,0,1,43510000
nn_kernel_gpu_mem,54902,1,1,339922,128,348080000,174040000,174040000,348080000,1,43510000
nn_kernel_cpu,32579,0,1,1,64,0,0,0,0,1,43520000
nn_kernel_gpu,2618,1,1,340000,128,0,0,0,0,1,43520000
nn_kernel_gpu_mem,59275,1,1,340000,128,348160000,174080000,174080000,348160000,1,43520000
nn_kernel_cpu,19801,0,1,1,64,0,0,0,0,1,43530000
nn_kernel_gpu,2566,1,1,340079,128,0,0,0,0,1,43530000
nn_kernel_gpu_mem,64504,1,1,340079,128,348240000,174120000,174120000,348240000,1,43530000
nn_kernel_cpu,35116,0,1,1,64,0,0,0,0,1,43540000
nn_kernel_gpu,2558,1,1,340157,128,0,0,0,0,1,43540000
nn_kernel_gpu_mem,61800,1,1,340157,128,348320000,174160000,174160000,348320000,1,43540000
nn_kernel_cpu,28926,0,1,1,64,0,0,0,0,1,43550000
nn_kernel_gpu,2552,1,1,340235,128,0,0,0,0,1,43550000
nn_kernel_gpu_mem,54344,1,1,340235,128,348400000,174200000,174200000,348400000,1,43550000
nn_kernel_cpu,27908,0,1,1,64,0,0,0,0,1,43560000
nn_kernel_gpu,2579,1,1,340313,128,0,0,0,0,1,43560000
nn_kernel_gpu_mem,55078,1,1,340313,128,348480000,174240000,174240000,348480000,1,43560000
nn_kernel_cpu,28167,0,1,1,64,0,0,0,0,1,43570000
nn_kernel_gpu,2579,1,1,340391,128,0,0,0,0,1,43570000
nn_kernel_gpu_mem,54629,1,1,340391,128,348560000,174280000,174280000,348560000,1,43570000
nn_kernel_cpu,37124,0,1,1,64,0,0,0,0,1,43580000
nn_kernel_gpu,2577,1,1,340469,128,0,0,0,0,1,43580000
nn_kernel_gpu_mem,70954,1,1,340469,128,348640000,174320000,174320000,348640000,1,43580000
nn_kernel_cpu,29085,0,1,1,64,0,0,0,0,1,43590000
nn_kernel_gpu,2563,1,1,340547,128,0,0,0,0,1,43590000
nn_kernel_gpu_mem,51908,1,1,340547,128,348720000,174360000,174360000,348720000,1,43590000
nn_kernel_cpu,24367,0,1,1,64,0,0,0,0,1,43600000
nn_kernel_gpu,2559,1,1,340625,128,0,0,0,0,1,43600000
nn_kernel_gpu_mem,59432,1,1,340625,128,348800000,174400000,174400000,348800000,1,43600000
nn_kernel_cpu,21050,0,1,1,64,0,0,0,0,1,4360000
nn_kernel_gpu,317,1,1,34063,128,0,0,0,0,1,4360000
nn_kernel_gpu_mem,11245,1,1,34063,128,34880000,17440000,17440000,34880000,1,4360000
nn_kernel_cpu,23664,0,1,1,64,0,0,0,0,1,43610000
nn_kernel_gpu,2568,1,1,340704,128,0,0,0,0,1,43610000
nn_kernel_gpu_mem,64363,1,1,340704,128,348880000,174440000,174440000,348880000,1,43610000
nn_kernel_cpu,31342,0,1,1,64,0,0,0,0,1,43620000
nn_kernel_gpu,2569,1,1,340782,128,0,0,0,0,1,43620000
nn_kernel_gpu_mem,53774,1,1,340782,128,348960000,174480000,174480000,348960000,1,43620000
nn_kernel_cpu,25974,0,1,1,64,0,0,0,0,1,43630000
nn_kernel_gpu,2570,1,1,340860,128,0,0,0,0,1,43630000
nn_kernel_gpu_mem,58904,1,1,340860,128,349040000,174520000,174520000,349040000,1,43630000
nn_kernel_cpu,27444,0,1,1,64,0,0,0,0,1,43640000
nn_kernel_gpu,2563,1,1,340938,128,0,0,0,0,1,43640000
nn_kernel_gpu_mem,59670,1,1,340938,128,349120000,174560000,174560000,349120000,1,43640000
nn_kernel_cpu,29085,0,1,1,64,0,0,0,0,1,43650000
nn_kernel_gpu,2575,1,1,341016,128,0,0,0,0,1,43650000
nn_kernel_gpu_mem,52941,1,1,341016,128,349200000,174600000,174600000,349200000,1,43650000
nn_kernel_cpu,26079,0,1,1,64,0,0,0,0,1,43660000
nn_kernel_gpu,2577,1,1,341094,128,0,0,0,0,1,43660000
nn_kernel_gpu_mem,61352,1,1,341094,128,349280000,174640000,174640000,349280000,1,43660000
nn_kernel_cpu,27024,0,1,1,64,0,0,0,0,1,43670000
nn_kernel_gpu,2575,1,1,341172,128,0,0,0,0,1,43670000
nn_kernel_gpu_mem,54886,1,1,341172,128,349360000,174680000,174680000,349360000,1,43670000
nn_kernel_cpu,21272,0,1,1,64,0,0,0,0,1,43680000
nn_kernel_gpu,2556,1,1,341250,128,0,0,0,0,1,43680000
nn_kernel_gpu_mem,58707,1,1,341250,128,349440000,174720000,174720000,349440000,1,43680000
nn_kernel_cpu,31387,0,1,1,64,0,0,0,0,1,43690000
nn_kernel_gpu,2575,1,1,341329,128,0,0,0,0,1,43690000
nn_kernel_gpu_mem,55035,1,1,341329,128,349520000,174760000,174760000,349520000,1,43690000
nn_kernel_cpu,25462,0,1,1,64,0,0,0,0,1,43700000
nn_kernel_gpu,2562,1,1,341407,128,0,0,0,0,1,43700000
nn_kernel_gpu_mem,55427,1,1,341407,128,349600000,174800000,174800000,349600000,1,43700000
nn_kernel_cpu,23926,0,1,1,64,0,0,0,0,1,4370000
nn_kernel_gpu,295,1,1,34141,128,0,0,0,0,1,4370000
nn_kernel_gpu_mem,5734,1,1,34141,128,34960000,17480000,17480000,34960000,1,4370000
nn_kernel_cpu,30090,0,1,1,64,0,0,0,0,1,43710000
nn_kernel_gpu,2575,1,1,341485,128,0,0,0,0,1,43710000
nn_kernel_gpu_mem,54544,1,1,341485,128,349680000,174840000,174840000,349680000,1,43710000
nn_kernel_cpu,17797,0,1,1,64,0,0,0,0,1,43720000
nn_kernel_gpu,2621,1,1,341563,128,0,0,0,0,1,43720000
nn_kernel_gpu_mem,64224,1,1,341563,128,349760000,174880000,174880000,349760000,1,43720000
nn_kernel_cpu,25687,0,1,1,64,0,0,0,0,1,43730000
nn_kernel_gpu,2590,1,1,341641,128,0,0,0,0,1,43730000
nn_kernel_gpu_mem,57244,1,1,341641,128,349840000,174920000,174920000,349840000,1,43730000
nn_kernel_cpu,30374,0,1,1,64,0,0,0,0,1,43740000
nn_kernel_gpu,2579,1,1,341719,128,0,0,0,0,1,43740000
nn_kernel_gpu_mem,53282,1,1,341719,128,349920000,174960000,174960000,349920000,1,43740000
nn_kernel_cpu,26332,0,1,1,64,0,0,0,0,1,43750000
nn_kernel_gpu,2577,1,1,341797,128,0,0,0,0,1,43750000
nn_kernel_gpu_mem,55121,1,1,341797,128,350000000,175000000,175000000,350000000,1,43750000
nn_kernel_cpu,28555,0,1,1,64,0,0,0,0,1,43760000
nn_kernel_gpu,2578,1,1,341875,128,0,0,0,0,1,43760000
nn_kernel_gpu_mem,51757,1,1,341875,128,350080000,175040000,175040000,350080000,1,43760000
nn_kernel_cpu,30374,0,1,1,64,0,0,0,0,1,43770000
nn_kernel_gpu,2578,1,1,341954,128,0,0,0,0,1,43770000
nn_kernel_gpu_mem,56160,1,1,341954,128,350160000,175080000,175080000,350160000,1,43770000
nn_kernel_cpu,26200,0,1,1,64,0,0,0,0,1,43780000
nn_kernel_gpu,2577,1,1,342032,128,0,0,0,0,1,43780000
nn_kernel_gpu_mem,54740,1,1,342032,128,350240000,175120000,175120000,350240000,1,43780000
nn_kernel_cpu,23500,0,1,1,64,0,0,0,0,1,43790000
nn_kernel_gpu,2623,1,1,342110,128,0,0,0,0,1,43790000
nn_kernel_gpu_mem,64091,1,1,342110,128,350320000,175160000,175160000,350320000,1,43790000
nn_kernel_cpu,28482,0,1,1,64,0,0,0,0,1,43800000
nn_kernel_gpu,2584,1,1,342188,128,0,0,0,0,1,43800000
nn_kernel_gpu_mem,63959,1,1,342188,128,350400000,175200000,175200000,350400000,1,43800000
nn_kernel_cpu,27617,0,1,1,64,0,0,0,0,1,4380000
nn_kernel_gpu,316,1,1,34219,128,0,0,0,0,1,4380000
nn_kernel_gpu_mem,6433,1,1,34219,128,35040000,17520000,17520000,35040000,1,4380000
nn_kernel_cpu,23698,0,1,1,64,0,0,0,0,1,43810000
nn_kernel_gpu,2599,1,1,342266,128,0,0,0,0,1,43810000
nn_kernel_gpu_mem,64728,1,1,342266,128,350480000,175240000,175240000,350480000,1,43810000
nn_kernel_cpu,31284,0,1,1,64,0,0,0,0,1,43820000
nn_kernel_gpu,2580,1,1,342344,128,0,0,0,0,1,43820000
nn_kernel_gpu_mem,56691,1,1,342344,128,350560000,175280000,175280000,350560000,1,43820000
nn_kernel_cpu,32501,0,1,1,64,0,0,0,0,1,43830000
nn_kernel_gpu,2587,1,1,342422,128,0,0,0,0,1,43830000
nn_kernel_gpu_mem,64294,1,1,342422,128,350640000,175320000,175320000,350640000,1,43830000
nn_kernel_cpu,12002,0,1,1,64,0,0,0,0,1,43840000
nn_kernel_gpu,2605,1,1,342500,128,0,0,0,0,1,43840000
nn_kernel_gpu_mem,65958,1,1,342500,128,350720000,175360000,175360000,350720000,1,43840000
nn_kernel_cpu,23226,0,1,1,64,0,0,0,0,1,43850000
nn_kernel_gpu,2598,1,1,342579,128,0,0,0,0,1,43850000
nn_kernel_gpu_mem,54353,1,1,342579,128,350800000,175400000,175400000,350800000,1,43850000
nn_kernel_cpu,23365,0,1,1,64,0,0,0,0,1,43860000
nn_kernel_gpu,2572,1,1,342657,128,0,0,0,0,1,43860000
nn_kernel_gpu_mem,65933,1,1,342657,128,350880000,175440000,175440000,350880000,1,43860000
nn_kernel_cpu,19935,0,1,1,64,0,0,0,0,1,43870000
nn_kernel_gpu,2604,1,1,342735,128,0,0,0,0,1,43870000
nn_kernel_gpu_mem,63911,1,1,342735,128,350960000,175480000,175480000,350960000,1,43870000
nn_kernel_cpu,20988,0,1,1,64,0,0,0,0,1,43880000
nn_kernel_gpu,2631,1,1,342813,128,0,0,0,0,1,43880000
nn_kernel_gpu_mem,64946,1,1,342813,128,351040000,175520000,175520000,351040000,1,43880000
nn_kernel_cpu,34136,0,1,1,64,0,0,0,0,1,43890000
nn_kernel_gpu,2601,1,1,342891,128,0,0,0,0,1,43890000
nn_kernel_gpu_mem,52086,1,1,342891,128,351120000,175560000,175560000,351120000,1,43890000
nn_kernel_cpu,11184,0,1,1,64,0,0,0,0,1,43900000
nn_kernel_gpu,2601,1,1,342969,128,0,0,0,0,1,43900000
nn_kernel_gpu_mem,64985,1,1,342969,128,351200000,175600000,175600000,351200000,1,43900000
nn_kernel_cpu,18934,0,1,1,64,0,0,0,0,1,4390000
nn_kernel_gpu,314,1,1,34297,128,0,0,0,0,1,4390000
nn_kernel_gpu_mem,6383,1,1,34297,128,35120000,17560000,17560000,35120000,1,4390000
nn_kernel_cpu,16966,0,1,1,64,0,0,0,0,1,43910000
nn_kernel_gpu,2588,1,1,343047,128,0,0,0,0,1,43910000
nn_kernel_gpu_mem,65426,1,1,343047,128,351280000,175640000,175640000,351280000,1,43910000
nn_kernel_cpu,14638,0,1,1,64,0,0,0,0,1,43920000
nn_kernel_gpu,2588,1,1,343125,128,0,0,0,0,1,43920000
nn_kernel_gpu_mem,64727,1,1,343125,128,351360000,175680000,175680000,351360000,1,43920000
nn_kernel_cpu,14832,0,1,1,64,0,0,0,0,1,43930000
nn_kernel_gpu,2594,1,1,343204,128,0,0,0,0,1,43930000
nn_kernel_gpu_mem,65716,1,1,343204,128,351440000,175720000,175720000,351440000,1,43930000
nn_kernel_cpu,25110,0,1,1,64,0,0,0,0,1,43940000
nn_kernel_gpu,2622,1,1,343282,128,0,0,0,0,1,43940000
nn_kernel_gpu_mem,59605,1,1,343282,128,351520000,175760000,175760000,351520000,1,43940000
nn_kernel_cpu,29967,0,1,1,64,0,0,0,0,1,43950000
nn_kernel_gpu,2593,1,1,343360,128,0,0,0,0,1,43950000
nn_kernel_gpu_mem,62787,1,1,343360,128,351600000,175800000,175800000,351600000,1,43950000
nn_kernel_cpu,23686,0,1,1,64,0,0,0,0,1,43960000
nn_kernel_gpu,2626,1,1,343438,128,0,0,0,0,1,43960000
nn_kernel_gpu_mem,53701,1,1,343438,128,351680000,175840000,175840000,351680000,1,43960000
nn_kernel_cpu,12773,0,1,1,64,0,0,0,0,1,43970000
nn_kernel_gpu,2587,1,1,343516,128,0,0,0,0,1,43970000
nn_kernel_gpu_mem,52002,1,1,343516,128,351760000,175880000,175880000,351760000,1,43970000
nn_kernel_cpu,21788,0,1,1,64,0,0,0,0,1,43980000
nn_kernel_gpu,2601,1,1,343594,128,0,0,0,0,1,43980000
nn_kernel_gpu_mem,60292,1,1,343594,128,351840000,175920000,175920000,351840000,1,43980000
nn_kernel_cpu,10780,0,1,1,64,0,0,0,0,1,43990000
nn_kernel_gpu,2591,1,1,343672,128,0,0,0,0,1,43990000
nn_kernel_gpu_mem,73291,1,1,343672,128,351920000,175960000,175960000,351920000,1,43990000
nn_kernel_cpu,31211,0,1,1,64,0,0,0,0,1,44000000
nn_kernel_gpu,2596,1,1,343750,128,0,0,0,0,1,44000000
nn_kernel_gpu_mem,65755,1,1,343750,128,352000000,176000000,176000000,352000000,1,44000000
nn_kernel_cpu,5884,0,1,1,64,0,0,0,0,1,4400000
nn_kernel_gpu,321,1,1,34375,128,0,0,0,0,1,4400000
nn_kernel_gpu_mem,6541,1,1,34375,128,35200000,17600000,17600000,35200000,1,4400000
nn_kernel_cpu,1002,0,1,1,64,0,0,0,0,1,440000
nn_kernel_gpu,74,1,1,3438,128,0,0,0,0,1,440000
nn_kernel_gpu_mem,1543,1,1,3438,128,3520000,1760000,1760000,3520000,1,440000
nn_kernel_cpu,24124,0,1,1,64,0,0,0,0,1,44010000
nn_kernel_gpu,2599,1,1,343829,128,0,0,0,0,1,44010000
nn_kernel_gpu_mem,54604,1,1,343829,128,352080000,176040000,176040000,352080000,1,44010000
nn_kernel_cpu,32993,0,1,1,64,0,0,0,0,1,44020000
nn_kernel_gpu,2597,1,1,343907,128,0,0,0,0,1,44020000
nn_kernel_gpu_mem,67656,1,1,343907,128,352160000,176080000,176080000,352160000,1,44020000
nn_kernel_cpu,41383,0,1,1,64,0,0,0,0,1,44030000
nn_kernel_gpu,2601,1,1,343985,128,0,0,0,0,1,44030000
nn_kernel_gpu_mem,64956,1,1,343985,128,352240000,176120000,176120000,352240000,1,44030000
nn_kernel_cpu,40274,0,1,1,64,0,0,0,0,1,44040000
nn_kernel_gpu,2593,1,1,344063,128,0,0,0,0,1,44040000
nn_kernel_gpu_mem,55725,1,1,344063,128,352320000,176160000,176160000,352320000,1,44040000
nn_kernel_cpu,28436,0,1,1,64,0,0,0,0,1,44050000
nn_kernel_gpu,2607,1,1,344141,128,0,0,0,0,1,44050000
nn_kernel_gpu_mem,55654,1,1,344141,128,352400000,176200000,176200000,352400000,1,44050000
nn_kernel_cpu,13728,0,1,1,64,0,0,0,0,1,44060000
nn_kernel_gpu,2593,1,1,344219,128,0,0,0,0,1,44060000
nn_kernel_gpu_mem,56553,1,1,344219,128,352480000,176240000,176240000,352480000,1,44060000
nn_kernel_cpu,28075,0,1,1,64,0,0,0,0,1,44070000
nn_kernel_gpu,2650,1,1,344297,128,0,0,0,0,1,44070000
nn_kernel_gpu_mem,67501,1,1,344297,128,352560000,176280000,176280000,352560000,1,44070000
nn_kernel_cpu,17309,0,1,1,64,0,0,0,0,1,44080000
nn_kernel_gpu,2608,1,1,344375,128,0,0,0,0,1,44080000
nn_kernel_gpu_mem,65210,1,1,344375,128,352640000,176320000,176320000,352640000,1,44080000
nn_kernel_cpu,21660,0,1,1,64,0,0,0,0,1,44090000
nn_kernel_gpu,2613,1,1,344454,128,0,0,0,0,1,44090000
nn_kernel_gpu_mem,65891,1,1,344454,128,352720000,176360000,176360000,352720000,1,44090000
nn_kernel_cpu,33599,0,1,1,64,0,0,0,0,1,44100000
nn_kernel_gpu,2610,1,1,344532,128,0,0,0,0,1,44100000
nn_kernel_gpu_mem,67426,1,1,344532,128,352800000,176400000,176400000,352800000,1,44100000
nn_kernel_cpu,14560,0,1,1,64,0,0,0,0,1,4410000
nn_kernel_gpu,315,1,1,34454,128,0,0,0,0,1,4410000
nn_kernel_gpu_mem,6541,1,1,34454,128,35280000,17640000,17640000,35280000,1,4410000
nn_kernel_cpu,29937,0,1,1,64,0,0,0,0,1,44110000
nn_kernel_gpu,2605,1,1,344610,128,0,0,0,0,1,44110000
nn_kernel_gpu_mem,63960,1,1,344610,128,352880000,176440000,176440000,352880000,1,44110000
nn_kernel_cpu,24600,0,1,1,64,0,0,0,0,1,44120000
nn_kernel_gpu,2611,1,1,344688,128,0,0,0,0,1,44120000
nn_kernel_gpu_mem,63269,1,1,344688,128,352960000,176480000,176480000,352960000,1,44120000
nn_kernel_cpu,22774,0,1,1,64,0,0,0,0,1,44130000
nn_kernel_gpu,2596,1,1,344766,128,0,0,0,0,1,44130000
nn_kernel_gpu_mem,65957,1,1,344766,128,353040000,176520000,176520000,353040000,1,44130000
nn_kernel_cpu,26427,0,1,1,64,0,0,0,0,1,44140000
nn_kernel_gpu,2616,1,1,344844,128,0,0,0,0,1,44140000
nn_kernel_gpu_mem,64174,1,1,344844,128,353120000,176560000,176560000,353120000,1,44140000
nn_kernel_cpu,21373,0,1,1,64,0,0,0,0,1,44150000
nn_kernel_gpu,2610,1,1,344922,128,0,0,0,0,1,44150000
nn_kernel_gpu_mem,52942,1,1,344922,128,353200000,176600000,176600000,353200000,1,44150000
nn_kernel_cpu,13451,0,1,1,64,0,0,0,0,1,44160000
nn_kernel_gpu,2612,1,1,345000,128,0,0,0,0,1,44160000
nn_kernel_gpu_mem,64695,1,1,345000,128,353280000,176640000,176640000,353280000,1,44160000
nn_kernel_cpu,19831,0,1,1,64,0,0,0,0,1,44170000
nn_kernel_gpu,2660,1,1,345079,128,0,0,0,0,1,44170000
nn_kernel_gpu_mem,59303,1,1,345079,128,353360000,176680000,176680000,353360000,1,44170000
nn_kernel_cpu,14839,0,1,1,64,0,0,0,0,1,44180000
nn_kernel_gpu,2611,1,1,345157,128,0,0,0,0,1,44180000
nn_kernel_gpu_mem,64756,1,1,345157,128,353440000,176720000,176720000,353440000,1,44180000
nn_kernel_cpu,21322,0,1,1,64,0,0,0,0,1,44190000
nn_kernel_gpu,2651,1,1,345235,128,0,0,0,0,1,44190000
nn_kernel_gpu_mem,64433,1,1,345235,128,353520000,176760000,176760000,353520000,1,44190000
nn_kernel_cpu,17487,0,1,1,64,0,0,0,0,1,44200000
nn_kernel_gpu,2612,1,1,345313,128,0,0,0,0,1,44200000
nn_kernel_gpu_mem,64807,1,1,345313,128,353600000,176800000,176800000,353600000,1,44200000
nn_kernel_cpu,12638,0,1,1,64,0,0,0,0,1,4420000
nn_kernel_gpu,300,1,1,34532,128,0,0,0,0,1,4420000
nn_kernel_gpu_mem,5968,1,1,34532,128,35360000,17680000,17680000,35360000,1,4420000
nn_kernel_cpu,25242,0,1,1,64,0,0,0,0,1,44210000
nn_kernel_gpu,2633,1,1,345391,128,0,0,0,0,1,44210000
nn_kernel_gpu_mem,66932,1,1,345391,128,353680000,176840000,176840000,353680000,1,44210000
nn_kernel_cpu,17155,0,1,1,64,0,0,0,0,1,44220000
nn_kernel_gpu,2625,1,1,345469,128,0,0,0,0,1,44220000
nn_kernel_gpu_mem,52860,1,1,345469,128,353760000,176880000,176880000,353760000,1,44220000
nn_kernel_cpu,29564,0,1,1,64,0,0,0,0,1,44230000
nn_kernel_gpu,2632,1,1,345547,128,0,0,0,0,1,44230000
nn_kernel_gpu_mem,65337,1,1,345547,128,353840000,176920000,176920000,353840000,1,44230000
nn_kernel_cpu,17548,0,1,1,64,0,0,0,0,1,44240000
nn_kernel_gpu,2616,1,1,345625,128,0,0,0,0,1,44240000
nn_kernel_gpu_mem,65980,1,1,345625,128,353920000,176960000,176960000,353920000,1,44240000
nn_kernel_cpu,15202,0,1,1,64,0,0,0,0,1,44250000
nn_kernel_gpu,2621,1,1,345704,128,0,0,0,0,1,44250000
nn_kernel_gpu_mem,67294,1,1,345704,128,354000000,177000000,177000000,354000000,1,44250000
nn_kernel_cpu,24583,0,1,1,64,0,0,0,0,1,44260000
nn_kernel_gpu,2615,1,1,345782,128,0,0,0,0,1,44260000
nn_kernel_gpu_mem,65793,1,1,345782,128,354080000,177040000,177040000,354080000,1,44260000
nn_kernel_cpu,25122,0,1,1,64,0,0,0,0,1,44270000
nn_kernel_gpu,2634,1,1,345860,128,0,0,0,0,1,44270000
nn_kernel_gpu_mem,65144,1,1,345860,128,354160000,177080000,177080000,354160000,1,44270000
nn_kernel_cpu,22054,0,1,1,64,0,0,0,0,1,44280000
nn_kernel_gpu,2625,1,1,345938,128,0,0,0,0,1,44280000
nn_kernel_gpu_mem,88741,1,1,345938,128,354240000,177120000,177120000,354240000,1,44280000
nn_kernel_cpu,26355,0,1,1,64,0,0,0,0,1,44290000
nn_kernel_gpu,2672,1,1,346016,128,0,0,0,0,1,44290000
nn_kernel_gpu_mem,64843,1,1,346016,128,354320000,177160000,177160000,354320000,1,44290000
nn_kernel_cpu,19058,0,1,1,64,0,0,0,0,1,44300000
nn_kernel_gpu,2634,1,1,346094,128,0,0,0,0,1,44300000
nn_kernel_gpu_mem,66128,1,1,346094,128,354400000,177200000,177200000,354400000,1,44300000
nn_kernel_cpu,12247,0,1,1,64,0,0,0,0,1,4430000
nn_kernel_gpu,298,1,1,34610,128,0,0,0,0,1,4430000
nn_kernel_gpu_mem,5966,1,1,34610,128,35440000,17720000,17720000,35440000,1,4430000
nn_kernel_cpu,16965,0,1,1,64,0,0,0,0,1,44310000
nn_kernel_gpu,2628,1,1,346172,128,0,0,0,0,1,44310000
nn_kernel_gpu_mem,52649,1,1,346172,128,354480000,177240000,177240000,354480000,1,44310000
nn_kernel_cpu,28067,0,1,1,64,0,0,0,0,1,44320000
nn_kernel_gpu,2630,1,1,346250,128,0,0,0,0,1,44320000
nn_kernel_gpu_mem,64622,1,1,346250,128,354560000,177280000,177280000,354560000,1,44320000
nn_kernel_cpu,34083,0,1,1,64,0,0,0,0,1,44330000
nn_kernel_gpu,2638,1,1,346329,128,0,0,0,0,1,44330000
nn_kernel_gpu_mem,66333,1,1,346329,128,354640000,177320000,177320000,354640000,1,44330000
nn_kernel_cpu,23117,0,1,1,64,0,0,0,0,1,44340000
nn_kernel_gpu,2632,1,1,346407,128,0,0,0,0,1,44340000
nn_kernel_gpu_mem,66453,1,1,346407,128,354720000,177360000,177360000,354720000,1,44340000
nn_kernel_cpu,26780,0,1,1,64,0,0,0,0,1,44350000
nn_kernel_gpu,2641,1,1,346485,128,0,0,0,0,1,44350000
nn_kernel_gpu_mem,66366,1,1,346485,128,354800000,177400000,177400000,354800000,1,44350000
nn_kernel_cpu,19515,0,1,1,64,0,0,0,0,1,44360000
nn_kernel_gpu,2621,1,1,346563,128,0,0,0,0,1,44360000
nn_kernel_gpu_mem,65812,1,1,346563,128,354880000,177440000,177440000,354880000,1,44360000
nn_kernel_cpu,27775,0,1,1,64,0,0,0,0,1,44370000
nn_kernel_gpu,2651,1,1,346641,128,0,0,0,0,1,44370000
nn_kernel_gpu_mem,62718,1,1,346641,128,354960000,177480000,177480000,354960000,1,44370000
nn_kernel_cpu,26781,0,1,1,64,0,0,0,0,1,44380000
nn_kernel_gpu,2625,1,1,346719,128,0,0,0,0,1,44380000
nn_kernel_gpu_mem,66480,1,1,346719,128,355040000,177520000,177520000,355040000,1,44380000
nn_kernel_cpu,12266,0,1,1,64,0,0,0,0,1,44390000
nn_kernel_gpu,2624,1,1,346797,128,0,0,0,0,1,44390000
nn_kernel_gpu_mem,64299,1,1,346797,128,355120000,177560000,177560000,355120000,1,44390000
nn_kernel_cpu,17682,0,1,1,64,0,0,0,0,1,44400000
nn_kernel_gpu,2609,1,1,346875,128,0,0,0,0,1,44400000
nn_kernel_gpu_mem,73977,1,1,346875,128,355200000,177600000,177600000,355200000,1,44400000
nn_kernel_cpu,4770,0,1,1,64,0,0,0,0,1,4440000
nn_kernel_gpu,307,1,1,34688,128,0,0,0,0,1,4440000
nn_kernel_gpu_mem,6347,1,1,34688,128,35520000,17760000,17760000,35520000,1,4440000
nn_kernel_cpu,25264,0,1,1,64,0,0,0,0,1,44410000
nn_kernel_gpu,2637,1,1,346954,128,0,0,0,0,1,44410000
nn_kernel_gpu_mem,52504,1,1,346954,128,355280000,177640000,177640000,355280000,1,44410000
nn_kernel_cpu,19475,0,1,1,64,0,0,0,0,1,44420000
nn_kernel_gpu,2624,1,1,347032,128,0,0,0,0,1,44420000
nn_kernel_gpu_mem,53973,1,1,347032,128,355360000,177680000,177680000,355360000,1,44420000
nn_kernel_cpu,19590,0,1,1,64,0,0,0,0,1,44430000
nn_kernel_gpu,2621,1,1,347110,128,0,0,0,0,1,44430000
nn_kernel_gpu_mem,54370,1,1,347110,128,355440000,177720000,177720000,355440000,1,44430000
nn_kernel_cpu,15026,0,1,1,64,0,0,0,0,1,44440000
nn_kernel_gpu,2669,1,1,347188,128,0,0,0,0,1,44440000
nn_kernel_gpu_mem,64221,1,1,347188,128,355520000,177760000,177760000,355520000,1,44440000
nn_kernel_cpu,18887,0,1,1,64,0,0,0,0,1,44450000
nn_kernel_gpu,2624,1,1,347266,128,0,0,0,0,1,44450000
nn_kernel_gpu_mem,58203,1,1,347266,128,355600000,177800000,177800000,355600000,1,44450000
nn_kernel_cpu,22027,0,1,1,64,0,0,0,0,1,44460000
nn_kernel_gpu,2671,1,1,347344,128,0,0,0,0,1,44460000
nn_kernel_gpu_mem,55871,1,1,347344,128,355680000,177840000,177840000,355680000,1,44460000
nn_kernel_cpu,18255,0,1,1,64,0,0,0,0,1,44470000
nn_kernel_gpu,2625,1,1,347422,128,0,0,0,0,1,44470000
nn_kernel_gpu_mem,53373,1,1,347422,128,355760000,177880000,177880000,355760000,1,44470000
nn_kernel_cpu,24434,0,1,1,64,0,0,0,0,1,44480000
nn_kernel_gpu,2670,1,1,347500,128,0,0,0,0,1,44480000
nn_kernel_gpu_mem,67090,1,1,347500,128,355840000,177920000,177920000,355840000,1,44480000
nn_kernel_cpu,25585,0,1,1,64,0,0,0,0,1,44490000
nn_kernel_gpu,2629,1,1,347579,128,0,0,0,0,1,44490000
nn_kernel_gpu_mem,66959,1,1,347579,128,355920000,177960000,177960000,355920000,1,44490000
nn_kernel_cpu,43398,0,1,1,64,0,0,0,0,1,44500000
nn_kernel_gpu,2652,1,1,347657,128,0,0,0,0,1,44500000
nn_kernel_gpu_mem,56102,1,1,347657,128,356000000,178000000,178000000,356000000,1,44500000
nn_kernel_cpu,10714,0,1,1,64,0,0,0,0,1,4450000
nn_kernel_gpu,310,1,1,34766,128,0,0,0,0,1,4450000
nn_kernel_gpu_mem,6994,1,1,34766,128,35600000,17800000,17800000,35600000,1,4450000
nn_kernel_cpu,26169,0,1,1,64,0,0,0,0,1,44510000
nn_kernel_gpu,2634,1,1,347735,128,0,0,0,0,1,44510000
nn_kernel_gpu_mem,66455,1,1,347735,128,356080000,178040000,178040000,356080000,1,44510000
nn_kernel_cpu,24522,0,1,1,64,0,0,0,0,1,44520000
nn_kernel_gpu,2628,1,1,347813,128,0,0,0,0,1,44520000
nn_kernel_gpu_mem,60182,1,1,347813,128,356160000,178080000,178080000,356160000,1,44520000
nn_kernel_cpu,35182,0,1,1,64,0,0,0,0,1,44530000
nn_kernel_gpu,2634,1,1,347891,128,0,0,0,0,1,44530000
nn_kernel_gpu_mem,65871,1,1,347891,128,356240000,178120000,178120000,356240000,1,44530000
nn_kernel_cpu,22450,0,1,1,64,0,0,0,0,1,44540000
nn_kernel_gpu,2633,1,1,347969,128,0,0,0,0,1,44540000
nn_kernel_gpu_mem,57827,1,1,347969,128,356320000,178160000,178160000,356320000,1,44540000
nn_kernel_cpu,24380,0,1,1,64,0,0,0,0,1,44550000
nn_kernel_gpu,2662,1,1,348047,128,0,0,0,0,1,44550000
nn_kernel_gpu_mem,59639,1,1,348047,128,356400000,178200000,178200000,356400000,1,44550000
nn_kernel_cpu,23845,0,1,1,64,0,0,0,0,1,44560000
nn_kernel_gpu,2634,1,1,348125,128,0,0,0,0,1,44560000
nn_kernel_gpu_mem,66607,1,1,348125,128,356480000,178240000,178240000,356480000,1,44560000
nn_kernel_cpu,25153,0,1,1,64,0,0,0,0,1,44570000
nn_kernel_gpu,2652,1,1,348204,128,0,0,0,0,1,44570000
nn_kernel_gpu_mem,56974,1,1,348204,128,356560000,178280000,178280000,356560000,1,44570000
nn_kernel_cpu,32052,0,1,1,64,0,0,0,0,1,44580000
nn_kernel_gpu,2643,1,1,348282,128,0,0,0,0,1,44580000
nn_kernel_gpu_mem,56976,1,1,348282,128,356640000,178320000,178320000,356640000,1,44580000
nn_kernel_cpu,35925,0,1,1,64,0,0,0,0,1,44590000
nn_kernel_gpu,2632,1,1,348360,128,0,0,0,0,1,44590000
nn_kernel_gpu_mem,57490,1,1,348360,128,356720000,178360000,178360000,356720000,1,44590000
nn_kernel_cpu,28242,0,1,1,64,0,0,0,0,1,44600000
nn_kernel_gpu,2648,1,1,348438,128,0,0,0,0,1,44600000
nn_kernel_gpu_mem,54113,1,1,348438,128,356800000,178400000,178400000,356800000,1,44600000
nn_kernel_cpu,6305,0,1,1,64,0,0,0,0,1,4460000
nn_kernel_gpu,319,1,1,34844,128,0,0,0,0,1,4460000
nn_kernel_gpu_mem,6496,1,1,34844,128,35680000,17840000,17840000,35680000,1,4460000
nn_kernel_cpu,14104,0,1,1,64,0,0,0,0,1,44610000
nn_kernel_gpu,2650,1,1,348516,128,0,0,0,0,1,44610000
nn_kernel_gpu_mem,66130,1,1,348516,128,356880000,178440000,178440000,356880000,1,44610000
nn_kernel_cpu,30013,0,1,1,64,0,0,0,0,1,44620000
nn_kernel_gpu,2645,1,1,348594,128,0,0,0,0,1,44620000
nn_kernel_gpu_mem,57729,1,1,348594,128,356960000,178480000,178480000,356960000,1,44620000
nn_kernel_cpu,12885,0,1,1,64,0,0,0,0,1,44630000
nn_kernel_gpu,2638,1,1,348672,128,0,0,0,0,1,44630000
nn_kernel_gpu_mem,65183,1,1,348672,128,357040000,178520000,178520000,357040000,1,44630000
nn_kernel_cpu,21583,0,1,1,64,0,0,0,0,1,44640000
nn_kernel_gpu,2641,1,1,348750,128,0,0,0,0,1,44640000
nn_kernel_gpu_mem,66239,1,1,348750,128,357120000,178560000,178560000,357120000,1,44640000
nn_kernel_cpu,14189,0,1,1,64,0,0,0,0,1,44650000
nn_kernel_gpu,2649,1,1,348829,128,0,0,0,0,1,44650000
nn_kernel_gpu_mem,67700,1,1,348829,128,357200000,178600000,178600000,357200000,1,44650000
nn_kernel_cpu,19133,0,1,1,64,0,0,0,0,1,44660000
nn_kernel_gpu,2639,1,1,348907,128,0,0,0,0,1,44660000
nn_kernel_gpu_mem,66443,1,1,348907,128,357280000,178640000,178640000,357280000,1,44660000
nn_kernel_cpu,15463,0,1,1,64,0,0,0,0,1,44670000
nn_kernel_gpu,2639,1,1,348985,128,0,0,0,0,1,44670000
nn_kernel_gpu_mem,66046,1,1,348985,128,357360000,178680000,178680000,357360000,1,44670000
nn_kernel_cpu,15131,0,1,1,64,0,0,0,0,1,44680000
nn_kernel_gpu,2675,1,1,349063,128,0,0,0,0,1,44680000
nn_kernel_gpu_mem,59819,1,1,349063,128,357440000,178720000,178720000,357440000,1,44680000
nn_kernel_cpu,14124,0,1,1,64,0,0,0,0,1,44690000
nn_kernel_gpu,2647,1,1,349141,128,0,0,0,0,1,44690000
nn_kernel_gpu_mem,65997,1,1,349141,128,357520000,178760000,178760000,357520000,1,44690000
nn_kernel_cpu,18523,0,1,1,64,0,0,0,0,1,44700000
nn_kernel_gpu,2637,1,1,349219,128,0,0,0,0,1,44700000
nn_kernel_gpu_mem,56685,1,1,349219,128,357600000,178800000,178800000,357600000,1,44700000
nn_kernel_cpu,45728,0,1,1,64,0,0,0,0,1,4470000
nn_kernel_gpu,314,1,1,34922,128,0,0,0,0,1,4470000
nn_kernel_gpu_mem,5848,1,1,34922,128,35760000,17880000,17880000,35760000,1,4470000
nn_kernel_cpu,30118,0,1,1,64,0,0,0,0,1,44710000
nn_kernel_gpu,2652,1,1,349297,128,0,0,0,0,1,44710000
nn_kernel_gpu_mem,64107,1,1,349297,128,357680000,178840000,178840000,357680000,1,44710000
nn_kernel_cpu,26907,0,1,1,64,0,0,0,0,1,44720000
nn_kernel_gpu,2679,1,1,349375,128,0,0,0,0,1,44720000
nn_kernel_gpu_mem,68315,1,1,349375,128,357760000,178880000,178880000,357760000,1,44720000
nn_kernel_cpu,24207,0,1,1,64,0,0,0,0,1,44730000
nn_kernel_gpu,2630,1,1,349454,128,0,0,0,0,1,44730000
nn_kernel_gpu_mem,67862,1,1,349454,128,357840000,178920000,178920000,357840000,1,44730000
nn_kernel_cpu,25231,0,1,1,64,0,0,0,0,1,44740000
nn_kernel_gpu,2697,1,1,349532,128,0,0,0,0,1,44740000
nn_kernel_gpu_mem,57180,1,1,349532,128,357920000,178960000,178960000,357920000,1,44740000
nn_kernel_cpu,23467,0,1,1,64,0,0,0,0,1,44750000
nn_kernel_gpu,2678,1,1,349610,128,0,0,0,0,1,44750000
nn_kernel_gpu_mem,56850,1,1,349610,128,358000000,179000000,179000000,358000000,1,44750000
nn_kernel_cpu,24014,0,1,1,64,0,0,0,0,1,44760000
nn_kernel_gpu,2648,1,1,349688,128,0,0,0,0,1,44760000
nn_kernel_gpu_mem,53941,1,1,349688,128,358080000,179040000,179040000,358080000,1,44760000
nn_kernel_cpu,35306,0,1,1,64,0,0,0,0,1,44770000
nn_kernel_gpu,2655,1,1,349766,128,0,0,0,0,1,44770000
nn_kernel_gpu_mem,60502,1,1,349766,128,358160000,179080000,179080000,358160000,1,44770000
nn_kernel_cpu,28813,0,1,1,64,0,0,0,0,1,44780000
nn_kernel_gpu,2644,1,1,349844,128,0,0,0,0,1,44780000
nn_kernel_gpu_mem,57334,1,1,349844,128,358240000,179120000,179120000,358240000,1,44780000
nn_kernel_cpu,32678,0,1,1,64,0,0,0,0,1,44790000
nn_kernel_gpu,2641,1,1,349922,128,0,0,0,0,1,44790000
nn_kernel_gpu_mem,52944,1,1,349922,128,358320000,179160000,179160000,358320000,1,44790000
nn_kernel_cpu,27514,0,1,1,64,0,0,0,0,1,44800000
nn_kernel_gpu,2635,1,1,350000,128,0,0,0,0,1,44800000
nn_kernel_gpu_mem,54967,1,1,350000,128,358400000,179200000,179200000,358400000,1,44800000
nn_kernel_cpu,29521,0,1,1,64,0,0,0,0,1,4480000
nn_kernel_gpu,309,1,1,35000,128,0,0,0,0,1,4480000
nn_kernel_gpu_mem,6075,1,1,35000,128,35840000,17920000,17920000,35840000,1,4480000
nn_kernel_cpu,27219,0,1,1,64,0,0,0,0,1,44810000
nn_kernel_gpu,2636,1,1,350079,128,0,0,0,0,1,44810000
nn_kernel_gpu_mem,62547,1,1,350079,128,358480000,179240000,179240000,358480000,1,44810000
nn_kernel_cpu,26524,0,1,1,64,0,0,0,0,1,44820000
nn_kernel_gpu,2646,1,1,350157,128,0,0,0,0,1,44820000
nn_kernel_gpu_mem,60102,1,1,350157,128,358560000,179280000,179280000,358560000,1,44820000
nn_kernel_cpu,26241,0,1,1,64,0,0,0,0,1,44830000
nn_kernel_gpu,2648,1,1,350235,128,0,0,0,0,1,44830000
nn_kernel_gpu_mem,56904,1,1,350235,128,358640000,179320000,179320000,358640000,1,44830000
nn_kernel_cpu,52018,0,1,1,64,0,0,0,0,1,44840000
nn_kernel_gpu,2676,1,1,350313,128,0,0,0,0,1,44840000
nn_kernel_gpu_mem,61898,1,1,350313,128,358720000,179360000,179360000,358720000,1,44840000
nn_kernel_cpu,24832,0,1,1,64,0,0,0,0,1,44850000
nn_kernel_gpu,2645,1,1,350391,128,0,0,0,0,1,44850000
nn_kernel_gpu_mem,61679,1,1,350391,128,358800000,179400000,179400000,358800000,1,44850000
nn_kernel_cpu,17081,0,1,1,64,0,0,0,0,1,44860000
nn_kernel_gpu,2646,1,1,350469,128,0,0,0,0,1,44860000
nn_kernel_gpu_mem,59511,1,1,350469,128,358880000,179440000,179440000,358880000,1,44860000
nn_kernel_cpu,31993,0,1,1,64,0,0,0,0,1,44870000
nn_kernel_gpu,2650,1,1,350547,128,0,0,0,0,1,44870000
nn_kernel_gpu_mem,66030,1,1,350547,128,358960000,179480000,179480000,358960000,1,44870000
nn_kernel_cpu,27655,0,1,1,64,0,0,0,0,1,44880000
nn_kernel_gpu,2651,1,1,350625,128,0,0,0,0,1,44880000
nn_kernel_gpu_mem,56337,1,1,350625,128,359040000,179520000,179520000,359040000,1,44880000
nn_kernel_cpu,29182,0,1,1,64,0,0,0,0,1,44890000
nn_kernel_gpu,2658,1,1,350704,128,0,0,0,0,1,44890000
nn_kernel_gpu_mem,66838,1,1,350704,128,359120000,179560000,179560000,359120000,1,44890000
nn_kernel_cpu,15001,0,1,1,64,0,0,0,0,1,44900000
nn_kernel_gpu,2656,1,1,350782,128,0,0,0,0,1,44900000
nn_kernel_gpu_mem,65671,1,1,350782,128,359200000,179600000,179600000,359200000,1,44900000
nn_kernel_cpu,9618,0,1,1,64,0,0,0,0,1,4490000
nn_kernel_gpu,318,1,1,35079,128,0,0,0,0,1,4490000
nn_kernel_gpu_mem,7254,1,1,35079,128,35920000,17960000,17960000,35920000,1,4490000
nn_kernel_cpu,23606,0,1,1,64,0,0,0,0,1,44910000
nn_kernel_gpu,2655,1,1,350860,128,0,0,0,0,1,44910000
nn_kernel_gpu_mem,67789,1,1,350860,128,359280000,179640000,179640000,359280000,1,44910000
nn_kernel_cpu,28365,0,1,1,64,0,0,0,0,1,44920000
nn_kernel_gpu,2699,1,1,350938,128,0,0,0,0,1,44920000
nn_kernel_gpu_mem,66860,1,1,350938,128,359360000,179680000,179680000,359360000,1,44920000
nn_kernel_cpu,11813,0,1,1,64,0,0,0,0,1,44930000
nn_kernel_gpu,2669,1,1,351016,128,0,0,0,0,1,44930000
nn_kernel_gpu_mem,63866,1,1,351016,128,359440000,179720000,179720000,359440000,1,44930000
nn_kernel_cpu,18584,0,1,1,64,0,0,0,0,1,44940000
nn_kernel_gpu,2661,1,1,351094,128,0,0,0,0,1,44940000
nn_kernel_gpu_mem,56610,1,1,351094,128,359520000,179760000,179760000,359520000,1,44940000
nn_kernel_cpu,15394,0,1,1,64,0,0,0,0,1,44950000
nn_kernel_gpu,2659,1,1,351172,128,0,0,0,0,1,44950000
nn_kernel_gpu_mem,66054,1,1,351172,128,359600000,179800000,179800000,359600000,1,44950000
nn_kernel_cpu,23070,0,1,1,64,0,0,0,0,1,44960000
nn_kernel_gpu,2644,1,1,351250,128,0,0,0,0,1,44960000
nn_kernel_gpu_mem,62741,1,1,351250,128,359680000,179840000,179840000,359680000,1,44960000
nn_kernel_cpu,31080,0,1,1,64,0,0,0,0,1,44970000
nn_kernel_gpu,2659,1,1,351329,128,0,0,0,0,1,44970000
nn_kernel_gpu_mem,66211,1,1,351329,128,359760000,179880000,179880000,359760000,1,44970000
nn_kernel_cpu,17567,0,1,1,64,0,0,0,0,1,44980000
nn_kernel_gpu,2656,1,1,351407,128,0,0,0,0,1,44980000
nn_kernel_gpu_mem,68229,1,1,351407,128,359840000,179920000,179920000,359840000,1,44980000
nn_kernel_cpu,29876,0,1,1,64,0,0,0,0,1,44990000
nn_kernel_gpu,2651,1,1,351485,128,0,0,0,0,1,44990000
nn_kernel_gpu_mem,54849,1,1,351485,128,359920000,179960000,179960000,359920000,1,44990000
nn_kernel_cpu,31753,0,1,1,64,0,0,0,0,1,45000000
nn_kernel_gpu,2656,1,1,351563,128,0,0,0,0,1,45000000
nn_kernel_gpu_mem,67008,1,1,351563,128,360000000,180000000,180000000,360000000,1,45000000
nn_kernel_cpu,27768,0,1,1,64,0,0,0,0,1,4500000
nn_kernel_gpu,319,1,1,35157,128,0,0,0,0,1,4500000
nn_kernel_gpu_mem,6783,1,1,35157,128,36000000,18000000,18000000,36000000,1,4500000
nn_kernel_cpu,7934,0,1,1,64,0,0,0,0,1,450000
nn_kernel_gpu,74,1,1,3516,128,0,0,0,0,1,450000
nn_kernel_gpu_mem,1676,1,1,3516,128,3600000,1800000,1800000,3600000,1,450000
nn_kernel_cpu,34357,0,1,1,64,0,0,0,0,1,45010000
nn_kernel_gpu,2662,1,1,351641,128,0,0,0,0,1,45010000
nn_kernel_gpu_mem,65085,1,1,351641,128,360080000,180040000,180040000,360080000,1,45010000
nn_kernel_cpu,23846,0,1,1,64,0,0,0,0,1,45020000
nn_kernel_gpu,2666,1,1,351719,128,0,0,0,0,1,45020000
nn_kernel_gpu_mem,58043,1,1,351719,128,360160000,180080000,180080000,360160000,1,45020000
nn_kernel_cpu,25266,0,1,1,64,0,0,0,0,1,45030000
nn_kernel_gpu,2661,1,1,351797,128,0,0,0,0,1,45030000
nn_kernel_gpu_mem,62942,1,1,351797,128,360240000,180120000,180120000,360240000,1,45030000
nn_kernel_cpu,26823,0,1,1,64,0,0,0,0,1,45040000
nn_kernel_gpu,2645,1,1,351875,128,0,0,0,0,1,45040000
nn_kernel_gpu_mem,67286,1,1,351875,128,360320000,180160000,180160000,360320000,1,45040000
nn_kernel_cpu,29217,0,1,1,64,0,0,0,0,1,45050000
nn_kernel_gpu,2648,1,1,351954,128,0,0,0,0,1,45050000
nn_kernel_gpu_mem,57130,1,1,351954,128,360400000,180200000,180200000,360400000,1,45050000
nn_kernel_cpu,38010,0,1,1,64,0,0,0,0,1,45060000
nn_kernel_gpu,2664,1,1,352032,128,0,0,0,0,1,45060000
nn_kernel_gpu_mem,66135,1,1,352032,128,360480000,180240000,180240000,360480000,1,45060000
nn_kernel_cpu,34688,0,1,1,64,0,0,0,0,1,45070000
nn_kernel_gpu,2678,1,1,352110,128,0,0,0,0,1,45070000
nn_kernel_gpu_mem,66060,1,1,352110,128,360560000,180280000,180280000,360560000,1,45070000
nn_kernel_cpu,23015,0,1,1,64,0,0,0,0,1,45080000
nn_kernel_gpu,2681,1,1,352188,128,0,0,0,0,1,45080000
nn_kernel_gpu_mem,62925,1,1,352188,128,360640000,180320000,180320000,360640000,1,45080000
nn_kernel_cpu,18350,0,1,1,64,0,0,0,0,1,45090000
nn_kernel_gpu,2680,1,1,352266,128,0,0,0,0,1,45090000
nn_kernel_gpu_mem,66755,1,1,352266,128,360720000,180360000,180360000,360720000,1,45090000
nn_kernel_cpu,16120,0,1,1,64,0,0,0,0,1,45100000
nn_kernel_gpu,2654,1,1,352344,128,0,0,0,0,1,45100000
nn_kernel_gpu_mem,50562,1,1,352344,128,360800000,180400000,180400000,360800000,1,45100000
nn_kernel_cpu,9689,0,1,1,64,0,0,0,0,1,4510000
nn_kernel_gpu,302,1,1,35235,128,0,0,0,0,1,4510000
nn_kernel_gpu_mem,6841,1,1,35235,128,36080000,18040000,18040000,36080000,1,4510000
nn_kernel_cpu,16092,0,1,1,64,0,0,0,0,1,45110000
nn_kernel_gpu,2667,1,1,352422,128,0,0,0,0,1,45110000
nn_kernel_gpu_mem,57610,1,1,352422,128,360880000,180440000,180440000,360880000,1,45110000
nn_kernel_cpu,21865,0,1,1,64,0,0,0,0,1,45120000
nn_kernel_gpu,2718,1,1,352500,128,0,0,0,0,1,45120000
nn_kernel_gpu_mem,64704,1,1,352500,128,360960000,180480000,180480000,360960000,1,45120000
nn_kernel_cpu,12119,0,1,1,64,0,0,0,0,1,45130000
nn_kernel_gpu,2671,1,1,352579,128,0,0,0,0,1,45130000
nn_kernel_gpu_mem,66707,1,1,352579,128,361040000,180520000,180520000,361040000,1,45130000
nn_kernel_cpu,24037,0,1,1,64,0,0,0,0,1,45140000
nn_kernel_gpu,2669,1,1,352657,128,0,0,0,0,1,45140000
nn_kernel_gpu_mem,66546,1,1,352657,128,361120000,180560000,180560000,361120000,1,45140000
nn_kernel_cpu,34767,0,1,1,64,0,0,0,0,1,45150000
nn_kernel_gpu,2709,1,1,352735,128,0,0,0,0,1,45150000
nn_kernel_gpu_mem,58681,1,1,352735,128,361200000,180600000,180600000,361200000,1,45150000
nn_kernel_cpu,41316,0,1,1,64,0,0,0,0,1,45160000
nn_kernel_gpu,2724,1,1,352813,128,0,0,0,0,1,45160000
nn_kernel_gpu_mem,56620,1,1,352813,128,361280000,180640000,180640000,361280000,1,45160000
nn_kernel_cpu,27189,0,1,1,64,0,0,0,0,1,45170000
nn_kernel_gpu,2665,1,1,352891,128,0,0,0,0,1,45170000
nn_kernel_gpu_mem,56561,1,1,352891,128,361360000,180680000,180680000,361360000,1,45170000
nn_kernel_cpu,26512,0,1,1,64,0,0,0,0,1,45180000
nn_kernel_gpu,2665,1,1,352969,128,0,0,0,0,1,45180000
nn_kernel_gpu_mem,53148,1,1,352969,128,361440000,180720000,180720000,361440000,1,45180000
nn_kernel_cpu,31081,0,1,1,64,0,0,0,0,1,45190000
nn_kernel_gpu,2680,1,1,353047,128,0,0,0,0,1,45190000
nn_kernel_gpu_mem,68181,1,1,353047,128,361520000,180760000,180760000,361520000,1,45190000
nn_kernel_cpu,25987,0,1,1,64,0,0,0,0,1,45200000
nn_kernel_gpu,2698,1,1,353125,128,0,0,0,0,1,45200000
nn_kernel_gpu_mem,58778,1,1,353125,128,361600000,180800000,180800000,361600000,1,45200000
nn_kernel_cpu,33390,0,1,1,64,0,0,0,0,1,4520000
nn_kernel_gpu,317,1,1,35313,128,0,0,0,0,1,4520000
nn_kernel_gpu_mem,7114,1,1,35313,128,36160000,18080000,18080000,36160000,1,4520000
nn_kernel_cpu,25188,0,1,1,64,0,0,0,0,1,45210000
nn_kernel_gpu,2690,1,1,353204,128,0,0,0,0,1,45210000
nn_kernel_gpu_mem,66402,1,1,353204,128,361680000,180840000,180840000,361680000,1,45210000
nn_kernel_cpu,30875,0,1,1,64,0,0,0,0,1,45220000
nn_kernel_gpu,2670,1,1,353282,128,0,0,0,0,1,45220000
nn_kernel_gpu_mem,67140,1,1,353282,128,361760000,180880000,180880000,361760000,1,45220000
nn_kernel_cpu,48454,0,1,1,64,0,0,0,0,1,45230000
nn_kernel_gpu,2675,1,1,353360,128,0,0,0,0,1,45230000
nn_kernel_gpu_mem,66048,1,1,353360,128,361840000,180920000,180920000,361840000,1,45230000
nn_kernel_cpu,30768,0,1,1,64,0,0,0,0,1,45240000
nn_kernel_gpu,2691,1,1,353438,128,0,0,0,0,1,45240000
nn_kernel_gpu_mem,66191,1,1,353438,128,361920000,180960000,180960000,361920000,1,45240000
nn_kernel_cpu,27643,0,1,1,64,0,0,0,0,1,45250000
nn_kernel_gpu,2692,1,1,353516,128,0,0,0,0,1,45250000
nn_kernel_gpu_mem,58101,1,1,353516,128,362000000,181000000,181000000,362000000,1,45250000
nn_kernel_cpu,27182,0,1,1,64,0,0,0,0,1,45260000
nn_kernel_gpu,2677,1,1,353594,128,0,0,0,0,1,45260000
nn_kernel_gpu_mem,58990,1,1,353594,128,362080000,181040000,181040000,362080000,1,45260000
nn_kernel_cpu,21230,0,1,1,64,0,0,0,0,1,45270000
nn_kernel_gpu,2681,1,1,353672,128,0,0,0,0,1,45270000
nn_kernel_gpu_mem,66395,1,1,353672,128,362160000,181080000,181080000,362160000,1,45270000
nn_kernel_cpu,28181,0,1,1,64,0,0,0,0,1,45280000
nn_kernel_gpu,2685,1,1,353750,128,0,0,0,0,1,45280000
nn_kernel_gpu_mem,57325,1,1,353750,128,362240000,181120000,181120000,362240000,1,45280000
nn_kernel_cpu,26362,0,1,1,64,0,0,0,0,1,45290000
nn_kernel_gpu,2688,1,1,353829,128,0,0,0,0,1,45290000
nn_kernel_gpu_mem,55927,1,1,353829,128,362320000,181160000,181160000,362320000,1,45290000
nn_kernel_cpu,16145,0,1,1,64,0,0,0,0,1,45300000
nn_kernel_gpu,2700,1,1,353907,128,0,0,0,0,1,45300000
nn_kernel_gpu_mem,67084,1,1,353907,128,362400000,181200000,181200000,362400000,1,45300000
nn_kernel_cpu,12776,0,1,1,64,0,0,0,0,1,4530000
nn_kernel_gpu,315,1,1,35391,128,0,0,0,0,1,4530000
nn_kernel_gpu_mem,7118,1,1,35391,128,36240000,18120000,18120000,36240000,1,4530000
nn_kernel_cpu,25895,0,1,1,64,0,0,0,0,1,45310000
nn_kernel_gpu,2681,1,1,353985,128,0,0,0,0,1,45310000
nn_kernel_gpu_mem,67370,1,1,353985,128,362480000,181240000,181240000,362480000,1,45310000
nn_kernel_cpu,27612,0,1,1,64,0,0,0,0,1,45320000
nn_kernel_gpu,2680,1,1,354063,128,0,0,0,0,1,45320000
nn_kernel_gpu_mem,57077,1,1,354063,128,362560000,181280000,181280000,362560000,1,45320000
nn_kernel_cpu,22819,0,1,1,64,0,0,0,0,1,45330000
nn_kernel_gpu,2699,1,1,354141,128,0,0,0,0,1,45330000
nn_kernel_gpu_mem,66406,1,1,354141,128,362640000,181320000,181320000,362640000,1,45330000
nn_kernel_cpu,25607,0,1,1,64,0,0,0,0,1,45340000
nn_kernel_gpu,2681,1,1,354219,128,0,0,0,0,1,45340000
nn_kernel_gpu_mem,54937,1,1,354219,128,362720000,181360000,181360000,362720000,1,45340000
nn_kernel_cpu,32829,0,1,1,64,0,0,0,0,1,45350000
nn_kernel_gpu,2688,1,1,354297,128,0,0,0,0,1,45350000
nn_kernel_gpu_mem,65794,1,1,354297,128,362800000,181400000,181400000,362800000,1,45350000
nn_kernel_cpu,23999,0,1,1,64,0,0,0,0,1,45360000
nn_kernel_gpu,2700,1,1,354375,128,0,0,0,0,1,45360000
nn_kernel_gpu_mem,66022,1,1,354375,128,362880000,181440000,181440000,362880000,1,45360000
nn_kernel_cpu,37217,0,1,1,64,0,0,0,0,1,45370000
nn_kernel_gpu,2684,1,1,354454,128,0,0,0,0,1,45370000
nn_kernel_gpu_mem,66504,1,1,354454,128,362960000,181480000,181480000,362960000,1,45370000
nn_kernel_cpu,12834,0,1,1,64,0,0,0,0,1,45380000
nn_kernel_gpu,2691,1,1,354532,128,0,0,0,0,1,45380000
nn_kernel_gpu_mem,55039,1,1,354532,128,363040000,181520000,181520000,363040000,1,45380000
nn_kernel_cpu,10839,0,1,1,64,0,0,0,0,1,45390000
nn_kernel_gpu,2699,1,1,354610,128,0,0,0,0,1,45390000
nn_kernel_gpu_mem,66814,1,1,354610,128,363120000,181560000,181560000,363120000,1,45390000
nn_kernel_cpu,44681,0,1,1,64,0,0,0,0,1,45400000
nn_kernel_gpu,2687,1,1,354688,128,0,0,0,0,1,45400000
nn_kernel_gpu_mem,66794,1,1,354688,128,363200000,181600000,181600000,363200000,1,45400000
nn_kernel_cpu,29788,0,1,1,64,0,0,0,0,1,4540000
nn_kernel_gpu,300,1,1,35469,128,0,0,0,0,1,4540000
nn_kernel_gpu_mem,6694,1,1,35469,128,36320000,18160000,18160000,36320000,1,4540000
nn_kernel_cpu,23166,0,1,1,64,0,0,0,0,1,45410000
nn_kernel_gpu,2684,1,1,354766,128,0,0,0,0,1,45410000
nn_kernel_gpu_mem,59805,1,1,354766,128,363280000,181640000,181640000,363280000,1,45410000
nn_kernel_cpu,28041,0,1,1,64,0,0,0,0,1,45420000
nn_kernel_gpu,2680,1,1,354844,128,0,0,0,0,1,45420000
nn_kernel_gpu_mem,57293,1,1,354844,128,363360000,181680000,181680000,363360000,1,45420000
nn_kernel_cpu,25161,0,1,1,64,0,0,0,0,1,45430000
nn_kernel_gpu,2709,1,1,354922,128,0,0,0,0,1,45430000
nn_kernel_gpu_mem,68953,1,1,354922,128,363440000,181720000,181720000,363440000,1,45430000
nn_kernel_cpu,19121,0,1,1,64,0,0,0,0,1,45440000
nn_kernel_gpu,2736,1,1,355000,128,0,0,0,0,1,45440000
nn_kernel_gpu_mem,64745,1,1,355000,128,363520000,181760000,181760000,363520000,1,45440000
nn_kernel_cpu,26036,0,1,1,64,0,0,0,0,1,45450000
nn_kernel_gpu,2703,1,1,355079,128,0,0,0,0,1,45450000
nn_kernel_gpu_mem,66555,1,1,355079,128,363600000,181800000,181800000,363600000,1,45450000
nn_kernel_cpu,30906,0,1,1,64,0,0,0,0,1,45460000
nn_kernel_gpu,2701,1,1,355157,128,0,0,0,0,1,45460000
nn_kernel_gpu_mem,58043,1,1,355157,128,363680000,181840000,181840000,363680000,1,45460000
nn_kernel_cpu,16538,0,1,1,64,0,0,0,0,1,45470000
nn_kernel_gpu,2681,1,1,355235,128,0,0,0,0,1,45470000
nn_kernel_gpu_mem,51138,1,1,355235,128,363760000,181880000,181880000,363760000,1,45470000
nn_kernel_cpu,12927,0,1,1,64,0,0,0,0,1,45480000
nn_kernel_gpu,2687,1,1,355313,128,0,0,0,0,1,45480000
nn_kernel_gpu_mem,66394,1,1,355313,128,363840000,181920000,181920000,363840000,1,45480000
nn_kernel_cpu,24663,0,1,1,64,0,0,0,0,1,45490000
nn_kernel_gpu,2683,1,1,355391,128,0,0,0,0,1,45490000
nn_kernel_gpu_mem,55493,1,1,355391,128,363920000,181960000,181960000,363920000,1,45490000
nn_kernel_cpu,28279,0,1,1,64,0,0,0,0,1,45500000
nn_kernel_gpu,2717,1,1,355469,128,0,0,0,0,1,45500000
nn_kernel_gpu_mem,56124,1,1,355469,128,364000000,182000000,182000000,364000000,1,45500000
nn_kernel_cpu,4479,0,1,1,64,0,0,0,0,1,4550000
nn_kernel_gpu,324,1,1,35547,128,0,0,0,0,1,4550000
nn_kernel_gpu_mem,6614,1,1,35547,128,36400000,18200000,18200000,36400000,1,4550000
nn_kernel_cpu,11181,0,1,1,64,0,0,0,0,1,45510000
nn_kernel_gpu,2669,1,1,355547,128,0,0,0,0,1,45510000
nn_kernel_gpu_mem,59244,1,1,355547,128,364080000,182040000,182040000,364080000,1,45510000
nn_kernel_cpu,25087,0,1,1,64,0,0,0,0,1,45520000
nn_kernel_gpu,2700,1,1,355625,128,0,0,0,0,1,45520000
nn_kernel_gpu_mem,67933,1,1,355625,128,364160000,182080000,182080000,364160000,1,45520000
nn_kernel_cpu,25942,0,1,1,64,0,0,0,0,1,45530000
nn_kernel_gpu,2734,1,1,355704,128,0,0,0,0,1,45530000
nn_kernel_gpu_mem,69232,1,1,355704,128,364240000,182120000,182120000,364240000,1,45530000
nn_kernel_cpu,30196,0,1,1,64,0,0,0,0,1,45540000
nn_kernel_gpu,2755,1,1,355782,128,0,0,0,0,1,45540000
nn_kernel_gpu_mem,65646,1,1,355782,128,364320000,182160000,182160000,364320000,1,45540000
nn_kernel_cpu,24682,0,1,1,64,0,0,0,0,1,45550000
nn_kernel_gpu,2704,1,1,355860,128,0,0,0,0,1,45550000
nn_kernel_gpu_mem,68022,1,1,355860,128,364400000,182200000,182200000,364400000,1,45550000
nn_kernel_cpu,14362,0,1,1,64,0,0,0,0,1,45560000
nn_kernel_gpu,2705,1,1,355938,128,0,0,0,0,1,45560000
nn_kernel_gpu_mem,66824,1,1,355938,128,364480000,182240000,182240000,364480000,1,45560000
nn_kernel_cpu,21525,0,1,1,64,0,0,0,0,1,45570000
nn_kernel_gpu,2713,1,1,356016,128,0,0,0,0,1,45570000
nn_kernel_gpu_mem,67244,1,1,356016,128,364560000,182280000,182280000,364560000,1,45570000
nn_kernel_cpu,30895,0,1,1,64,0,0,0,0,1,45580000
nn_kernel_gpu,2761,1,1,356094,128,0,0,0,0,1,45580000
nn_kernel_gpu_mem,68053,1,1,356094,128,364640000,182320000,182320000,364640000,1,45580000
nn_kernel_cpu,25714,0,1,1,64,0,0,0,0,1,45590000
nn_kernel_gpu,2708,1,1,356172,128,0,0,0,0,1,45590000
nn_kernel_gpu_mem,66275,1,1,356172,128,364720000,182360000,182360000,364720000,1,45590000
nn_kernel_cpu,34706,0,1,1,64,0,0,0,0,1,45600000
nn_kernel_gpu,2709,1,1,356250,128,0,0,0,0,1,45600000
nn_kernel_gpu_mem,53526,1,1,356250,128,364800000,182400000,182400000,364800000,1,45600000
nn_kernel_cpu,9329,0,1,1,64,0,0,0,0,1,4560000
nn_kernel_gpu,319,1,1,35625,128,0,0,0,0,1,4560000
nn_kernel_gpu_mem,7255,1,1,35625,128,36480000,18240000,18240000,36480000,1,4560000
nn_kernel_cpu,21372,0,1,1,64,0,0,0,0,1,45610000
nn_kernel_gpu,2709,1,1,356329,128,0,0,0,0,1,45610000
nn_kernel_gpu_mem,52675,1,1,356329,128,364880000,182440000,182440000,364880000,1,45610000
nn_kernel_cpu,27679,0,1,1,64,0,0,0,0,1,45620000
nn_kernel_gpu,2699,1,1,356407,128,0,0,0,0,1,45620000
nn_kernel_gpu_mem,64418,1,1,356407,128,364960000,182480000,182480000,364960000,1,45620000
nn_kernel_cpu,19136,0,1,1,64,0,0,0,0,1,45630000
nn_kernel_gpu,2712,1,1,356485,128,0,0,0,0,1,45630000
nn_kernel_gpu_mem,71018,1,1,356485,128,365040000,182520000,182520000,365040000,1,45630000
nn_kernel_cpu,27666,0,1,1,64,0,0,0,0,1,45640000
nn_kernel_gpu,2700,1,1,356563,128,0,0,0,0,1,45640000
nn_kernel_gpu_mem,60346,1,1,356563,128,365120000,182560000,182560000,365120000,1,45640000
nn_kernel_cpu,65898,0,1,1,64,0,0,0,0,1,45650000
nn_kernel_gpu,2708,1,1,356641,128,0,0,0,0,1,45650000
nn_kernel_gpu_mem,65855,1,1,356641,128,365200000,182600000,182600000,365200000,1,45650000
nn_kernel_cpu,19693,0,1,1,64,0,0,0,0,1,45660000
nn_kernel_gpu,2702,1,1,356719,128,0,0,0,0,1,45660000
nn_kernel_gpu_mem,55394,1,1,356719,128,365280000,182640000,182640000,365280000,1,45660000
nn_kernel_cpu,36791,0,1,1,64,0,0,0,0,1,45670000
nn_kernel_gpu,2689,1,1,356797,128,0,0,0,0,1,45670000
nn_kernel_gpu_mem,63812,1,1,356797,128,365360000,182680000,182680000,365360000,1,45670000
nn_kernel_cpu,28401,0,1,1,64,0,0,0,0,1,45680000
nn_kernel_gpu,2692,1,1,356875,128,0,0,0,0,1,45680000
nn_kernel_gpu_mem,67409,1,1,356875,128,365440000,182720000,182720000,365440000,1,45680000
nn_kernel_cpu,20744,0,1,1,64,0,0,0,0,1,45690000
nn_kernel_gpu,2759,1,1,356954,128,0,0,0,0,1,45690000
nn_kernel_gpu_mem,66888,1,1,356954,128,365520000,182760000,182760000,365520000,1,45690000
nn_kernel_cpu,30298,0,1,1,64,0,0,0,0,1,45700000
nn_kernel_gpu,2702,1,1,357032,128,0,0,0,0,1,45700000
nn_kernel_gpu_mem,54048,1,1,357032,128,365600000,182800000,182800000,365600000,1,45700000
nn_kernel_cpu,15745,0,1,1,64,0,0,0,0,1,4570000
nn_kernel_gpu,331,1,1,35704,128,0,0,0,0,1,4570000
nn_kernel_gpu_mem,6918,1,1,35704,128,36560000,18280000,18280000,36560000,1,4570000
nn_kernel_cpu,18378,0,1,1,64,0,0,0,0,1,45710000
nn_kernel_gpu,2703,1,1,357110,128,0,0,0,0,1,45710000
nn_kernel_gpu_mem,66560,1,1,357110,128,365680000,182840000,182840000,365680000,1,45710000
nn_kernel_cpu,24783,0,1,1,64,0,0,0,0,1,45720000
nn_kernel_gpu,2717,1,1,357188,128,0,0,0,0,1,45720000
nn_kernel_gpu_mem,66337,1,1,357188,128,365760000,182880000,182880000,365760000,1,45720000
nn_kernel_cpu,43375,0,1,1,64,0,0,0,0,1,45730000
nn_kernel_gpu,2695,1,1,357266,128,0,0,0,0,1,45730000
nn_kernel_gpu_mem,53799,1,1,357266,128,365840000,182920000,182920000,365840000,1,45730000
nn_kernel_cpu,27615,0,1,1,64,0,0,0,0,1,45740000
nn_kernel_gpu,2703,1,1,357344,128,0,0,0,0,1,45740000
nn_kernel_gpu_mem,53962,1,1,357344,128,365920000,182960000,182960000,365920000,1,45740000
nn_kernel_cpu,27126,0,1,1,64,0,0,0,0,1,45750000
nn_kernel_gpu,2701,1,1,357422,128,0,0,0,0,1,45750000
nn_kernel_gpu_mem,66609,1,1,357422,128,366000000,183000000,183000000,366000000,1,45750000
nn_kernel_cpu,32220,0,1,1,64,0,0,0,0,1,45760000
nn_kernel_gpu,2709,1,1,357500,128,0,0,0,0,1,45760000
nn_kernel_gpu_mem,56274,1,1,357500,128,366080000,183040000,183040000,366080000,1,45760000
nn_kernel_cpu,26919,0,1,1,64,0,0,0,0,1,45770000
nn_kernel_gpu,2689,1,1,357579,128,0,0,0,0,1,45770000
nn_kernel_gpu_mem,56303,1,1,357579,128,366160000,183080000,183080000,366160000,1,45770000
nn_kernel_cpu,30660,0,1,1,64,0,0,0,0,1,45780000
nn_kernel_gpu,2685,1,1,357657,128,0,0,0,0,1,45780000
nn_kernel_gpu_mem,55394,1,1,357657,128,366240000,183120000,183120000,366240000,1,45780000
nn_kernel_cpu,12213,0,1,1,64,0,0,0,0,1,45790000
nn_kernel_gpu,2696,1,1,357735,128,0,0,0,0,1,45790000
nn_kernel_gpu_mem,61554,1,1,357735,128,366320000,183160000,183160000,366320000,1,45790000
nn_kernel_cpu,30347,0,1,1,64,0,0,0,0,1,45800000
nn_kernel_gpu,2697,1,1,357813,128,0,0,0,0,1,45800000
nn_kernel_gpu_mem,58723,1,1,357813,128,366400000,183200000,183200000,366400000,1,45800000
nn_kernel_cpu,18526,0,1,1,64,0,0,0,0,1,4580000
nn_kernel_gpu,328,1,1,35782,128,0,0,0,0,1,4580000
nn_kernel_gpu_mem,11587,1,1,35782,128,36640000,18320000,18320000,36640000,1,4580000
nn_kernel_cpu,28207,0,1,1,64,0,0,0,0,1,45810000
nn_kernel_gpu,2689,1,1,357891,128,0,0,0,0,1,45810000
nn_kernel_gpu_mem,63569,1,1,357891,128,366480000,183240000,183240000,366480000,1,45810000
nn_kernel_cpu,25377,0,1,1,64,0,0,0,0,1,45820000
nn_kernel_gpu,2702,1,1,357969,128,0,0,0,0,1,45820000
nn_kernel_gpu_mem,57863,1,1,357969,128,366560000,183280000,183280000,366560000,1,45820000
nn_kernel_cpu,29436,0,1,1,64,0,0,0,0,1,45830000
nn_kernel_gpu,2705,1,1,358047,128,0,0,0,0,1,45830000
nn_kernel_gpu_mem,56023,1,1,358047,128,366640000,183320000,183320000,366640000,1,45830000
nn_kernel_cpu,24185,0,1,1,64,0,0,0,0,1,45840000
nn_kernel_gpu,2906,1,1,358125,128,0,0,0,0,1,45840000
nn_kernel_gpu_mem,60552,1,1,358125,128,366720000,183360000,183360000,366720000,1,45840000
nn_kernel_cpu,10396,0,1,1,64,0,0,0,0,1,45850000
nn_kernel_gpu,2730,1,1,358204,128,0,0,0,0,1,45850000
nn_kernel_gpu_mem,54486,1,1,358204,128,366800000,183400000,183400000,366800000,1,45850000
nn_kernel_cpu,25284,0,1,1,64,0,0,0,0,1,45860000
nn_kernel_gpu,2749,1,1,358282,128,0,0,0,0,1,45860000
nn_kernel_gpu_mem,58771,1,1,358282,128,366880000,183440000,183440000,366880000,1,45860000
nn_kernel_cpu,30185,0,1,1,64,0,0,0,0,1,45870000
nn_kernel_gpu,2710,1,1,358360,128,0,0,0,0,1,45870000
nn_kernel_gpu_mem,62362,1,1,358360,128,366960000,183480000,183480000,366960000,1,45870000
nn_kernel_cpu,38209,0,1,1,64,0,0,0,0,1,45880000
nn_kernel_gpu,2700,1,1,358438,128,0,0,0,0,1,45880000
nn_kernel_gpu_mem,72454,1,1,358438,128,367040000,183520000,183520000,367040000,1,45880000
nn_kernel_cpu,27284,0,1,1,64,0,0,0,0,1,45890000
nn_kernel_gpu,2711,1,1,358516,128,0,0,0,0,1,45890000
nn_kernel_gpu_mem,59031,1,1,358516,128,367120000,183560000,183560000,367120000,1,45890000
nn_kernel_cpu,30902,0,1,1,64,0,0,0,0,1,45900000
nn_kernel_gpu,2721,1,1,358594,128,0,0,0,0,1,45900000
nn_kernel_gpu_mem,58701,1,1,358594,128,367200000,183600000,183600000,367200000,1,45900000
nn_kernel_cpu,30091,0,1,1,64,0,0,0,0,1,4590000
nn_kernel_gpu,329,1,1,35860,128,0,0,0,0,1,4590000
nn_kernel_gpu_mem,6956,1,1,35860,128,36720000,18360000,18360000,36720000,1,4590000
nn_kernel_cpu,48373,0,1,1,64,0,0,0,0,1,45910000
nn_kernel_gpu,2716,1,1,358672,128,0,0,0,0,1,45910000
nn_kernel_gpu_mem,54987,1,1,358672,128,367280000,183640000,183640000,367280000,1,45910000
nn_kernel_cpu,10806,0,1,1,64,0,0,0,0,1,45920000
nn_kernel_gpu,2714,1,1,358750,128,0,0,0,0,1,45920000
nn_kernel_gpu_mem,54350,1,1,358750,128,367360000,183680000,183680000,367360000,1,45920000
nn_kernel_cpu,26559,0,1,1,64,0,0,0,0,1,45930000
nn_kernel_gpu,2712,1,1,358829,128,0,0,0,0,1,45930000
nn_kernel_gpu_mem,56389,1,1,358829,128,367440000,183720000,183720000,367440000,1,45930000
nn_kernel_cpu,23761,0,1,1,64,0,0,0,0,1,45940000
nn_kernel_gpu,2723,1,1,358907,128,0,0,0,0,1,45940000
nn_kernel_gpu_mem,57012,1,1,358907,128,367520000,183760000,183760000,367520000,1,45940000
nn_kernel_cpu,23317,0,1,1,64,0,0,0,0,1,45950000
nn_kernel_gpu,2727,1,1,358985,128,0,0,0,0,1,45950000
nn_kernel_gpu_mem,59809,1,1,358985,128,367600000,183800000,183800000,367600000,1,45950000
nn_kernel_cpu,9438,0,1,1,64,0,0,0,0,1,45960000
nn_kernel_gpu,2721,1,1,359063,128,0,0,0,0,1,45960000
nn_kernel_gpu_mem,66164,1,1,359063,128,367680000,183840000,183840000,367680000,1,45960000
nn_kernel_cpu,23837,0,1,1,64,0,0,0,0,1,45970000
nn_kernel_gpu,2704,1,1,359141,128,0,0,0,0,1,45970000
nn_kernel_gpu_mem,59000,1,1,359141,128,367760000,183880000,183880000,367760000,1,45970000
nn_kernel_cpu,29899,0,1,1,64,0,0,0,0,1,45980000
nn_kernel_gpu,2708,1,1,359219,128,0,0,0,0,1,45980000
nn_kernel_gpu_mem,54701,1,1,359219,128,367840000,183920000,183920000,367840000,1,45980000
nn_kernel_cpu,30466,0,1,1,64,0,0,0,0,1,45990000
nn_kernel_gpu,2708,1,1,359297,128,0,0,0,0,1,45990000
nn_kernel_gpu_mem,57258,1,1,359297,128,367920000,183960000,183960000,367920000,1,45990000
nn_kernel_cpu,32349,0,1,1,64,0,0,0,0,1,46000000
nn_kernel_gpu,2712,1,1,359375,128,0,0,0,0,1,46000000
nn_kernel_gpu_mem,67381,1,1,359375,128,368000000,184000000,184000000,368000000,1,46000000
nn_kernel_cpu,4715,0,1,1,64,0,0,0,0,1,4600000
nn_kernel_gpu,308,1,1,35938,128,0,0,0,0,1,4600000
nn_kernel_gpu_mem,7720,1,1,35938,128,36800000,18400000,18400000,36800000,1,4600000
nn_kernel_cpu,4646,0,1,1,64,0,0,0,0,1,460000
nn_kernel_gpu,64,1,1,3594,128,0,0,0,0,1,460000
nn_kernel_gpu_mem,883,1,1,3594,128,3680000,1840000,1840000,3680000,1,460000
nn_kernel_cpu,29421,0,1,1,64,0,0,0,0,1,46010000
nn_kernel_gpu,2722,1,1,359454,128,0,0,0,0,1,46010000
nn_kernel_gpu_mem,58738,1,1,359454,128,368080000,184040000,184040000,368080000,1,46010000
nn_kernel_cpu,24248,0,1,1,64,0,0,0,0,1,46020000
nn_kernel_gpu,2716,1,1,359532,128,0,0,0,0,1,46020000
nn_kernel_gpu_mem,55761,1,1,359532,128,368160000,184080000,184080000,368160000,1,46020000
nn_kernel_cpu,32226,0,1,1,64,0,0,0,0,1,46030000
nn_kernel_gpu,2725,1,1,359610,128,0,0,0,0,1,46030000
nn_kernel_gpu_mem,57221,1,1,359610,128,368240000,184120000,184120000,368240000,1,46030000
nn_kernel_cpu,24800,0,1,1,64,0,0,0,0,1,46040000
nn_kernel_gpu,2722,1,1,359688,128,0,0,0,0,1,46040000
nn_kernel_gpu_mem,55572,1,1,359688,128,368320000,184160000,184160000,368320000,1,46040000
nn_kernel_cpu,24895,0,1,1,64,0,0,0,0,1,46050000
nn_kernel_gpu,2723,1,1,359766,128,0,0,0,0,1,46050000
nn_kernel_gpu_mem,65836,1,1,359766,128,368400000,184200000,184200000,368400000,1,46050000
nn_kernel_cpu,30300,0,1,1,64,0,0,0,0,1,46060000
nn_kernel_gpu,2700,1,1,359844,128,0,0,0,0,1,46060000
nn_kernel_gpu_mem,59248,1,1,359844,128,368480000,184240000,184240000,368480000,1,46060000
nn_kernel_cpu,18282,0,1,1,64,0,0,0,0,1,46070000
nn_kernel_gpu,2714,1,1,359922,128,0,0,0,0,1,46070000
nn_kernel_gpu_mem,69450,1,1,359922,128,368560000,184280000,184280000,368560000,1,46070000
nn_kernel_cpu,30821,0,1,1,64,0,0,0,0,1,46080000
nn_kernel_gpu,2708,1,1,360000,128,0,0,0,0,1,46080000
nn_kernel_gpu_mem,59809,1,1,360000,128,368640000,184320000,184320000,368640000,1,46080000
nn_kernel_cpu,27197,0,1,1,64,0,0,0,0,1,46090000
nn_kernel_gpu,2727,1,1,360079,128,0,0,0,0,1,46090000
nn_kernel_gpu_mem,57962,1,1,360079,128,368720000,184360000,184360000,368720000,1,46090000
nn_kernel_cpu,25136,0,1,1,64,0,0,0,0,1,46100000
nn_kernel_gpu,2710,1,1,360157,128,0,0,0,0,1,46100000
nn_kernel_gpu_mem,57964,1,1,360157,128,368800000,184400000,184400000,368800000,1,46100000
nn_kernel_cpu,21465,0,1,1,64,0,0,0,0,1,4610000
nn_kernel_gpu,320,1,1,36016,128,0,0,0,0,1,4610000
nn_kernel_gpu_mem,14168,1,1,36016,128,36880000,18440000,18440000,36880000,1,4610000
nn_kernel_cpu,23141,0,1,1,64,0,0,0,0,1,46110000
nn_kernel_gpu,2719,1,1,360235,128,0,0,0,0,1,46110000
nn_kernel_gpu_mem,61995,1,1,360235,128,368880000,184440000,184440000,368880000,1,46110000
nn_kernel_cpu,25313,0,1,1,64,0,0,0,0,1,46120000
nn_kernel_gpu,2721,1,1,360313,128,0,0,0,0,1,46120000
nn_kernel_gpu_mem,58231,1,1,360313,128,368960000,184480000,184480000,368960000,1,46120000
nn_kernel_cpu,25768,0,1,1,64,0,0,0,0,1,46130000
nn_kernel_gpu,2789,1,1,360391,128,0,0,0,0,1,46130000
nn_kernel_gpu_mem,62766,1,1,360391,128,369040000,184520000,184520000,369040000,1,46130000
nn_kernel_cpu,17088,0,1,1,64,0,0,0,0,1,46140000
nn_kernel_gpu,2718,1,1,360469,128,0,0,0,0,1,46140000
nn_kernel_gpu_mem,56540,1,1,360469,128,369120000,184560000,184560000,369120000,1,46140000
nn_kernel_cpu,27998,0,1,1,64,0,0,0,0,1,46150000
nn_kernel_gpu,2725,1,1,360547,128,0,0,0,0,1,46150000
nn_kernel_gpu_mem,55428,1,1,360547,128,369200000,184600000,184600000,369200000,1,46150000
nn_kernel_cpu,27382,0,1,1,64,0,0,0,0,1,46160000
nn_kernel_gpu,2761,1,1,360625,128,0,0,0,0,1,46160000
nn_kernel_gpu_mem,60938,1,1,360625,128,369280000,184640000,184640000,369280000,1,46160000
nn_kernel_cpu,40837,0,1,1,64,0,0,0,0,1,46170000
nn_kernel_gpu,2723,1,1,360704,128,0,0,0,0,1,46170000
nn_kernel_gpu_mem,67391,1,1,360704,128,369360000,184680000,184680000,369360000,1,46170000
nn_kernel_cpu,17508,0,1,1,64,0,0,0,0,1,46180000
nn_kernel_gpu,2723,1,1,360782,128,0,0,0,0,1,46180000
nn_kernel_gpu_mem,56879,1,1,360782,128,369440000,184720000,184720000,369440000,1,46180000
nn_kernel_cpu,31678,0,1,1,64,0,0,0,0,1,46190000
nn_kernel_gpu,2716,1,1,360860,128,0,0,0,0,1,46190000
nn_kernel_gpu_mem,58938,1,1,360860,128,369520000,184760000,184760000,369520000,1,46190000
nn_kernel_cpu,17221,0,1,1,64,0,0,0,0,1,46200000
nn_kernel_gpu,2719,1,1,360938,128,0,0,0,0,1,46200000
nn_kernel_gpu_mem,53896,1,1,360938,128,369600000,184800000,184800000,369600000,1,46200000
nn_kernel_cpu,22095,0,1,1,64,0,0,0,0,1,4620000
nn_kernel_gpu,318,1,1,36094,128,0,0,0,0,1,4620000
nn_kernel_gpu_mem,11797,1,1,36094,128,36960000,18480000,18480000,36960000,1,4620000
nn_kernel_cpu,27011,0,1,1,64,0,0,0,0,1,46210000
nn_kernel_gpu,2715,1,1,361016,128,0,0,0,0,1,46210000
nn_kernel_gpu_mem,57032,1,1,361016,128,369680000,184840000,184840000,369680000,1,46210000
nn_kernel_cpu,26462,0,1,1,64,0,0,0,0,1,46220000
nn_kernel_gpu,2725,1,1,361094,128,0,0,0,0,1,46220000
nn_kernel_gpu_mem,60149,1,1,361094,128,369760000,184880000,184880000,369760000,1,46220000
nn_kernel_cpu,17300,0,1,1,64,0,0,0,0,1,46230000
nn_kernel_gpu,2725,1,1,361172,128,0,0,0,0,1,46230000
nn_kernel_gpu_mem,69968,1,1,361172,128,369840000,184920000,184920000,369840000,1,46230000
nn_kernel_cpu,33349,0,1,1,64,0,0,0,0,1,46240000
nn_kernel_gpu,2728,1,1,361250,128,0,0,0,0,1,46240000
nn_kernel_gpu_mem,67508,1,1,361250,128,369920000,184960000,184960000,369920000,1,46240000
nn_kernel_cpu,13825,0,1,1,64,0,0,0,0,1,46250000
nn_kernel_gpu,2755,1,1,361329,128,0,0,0,0,1,46250000
nn_kernel_gpu_mem,74008,1,1,361329,128,370000000,185000000,185000000,370000000,1,46250000
nn_kernel_cpu,24105,0,1,1,64,0,0,0,0,1,46260000
nn_kernel_gpu,2728,1,1,361407,128,0,0,0,0,1,46260000
nn_kernel_gpu_mem,58001,1,1,361407,128,370080000,185040000,185040000,370080000,1,46260000
nn_kernel_cpu,24391,0,1,1,64,0,0,0,0,1,46270000
nn_kernel_gpu,2775,1,1,361485,128,0,0,0,0,1,46270000
nn_kernel_gpu_mem,68937,1,1,361485,128,370160000,185080000,185080000,370160000,1,46270000
nn_kernel_cpu,25357,0,1,1,64,0,0,0,0,1,46280000
nn_kernel_gpu,2753,1,1,361563,128,0,0,0,0,1,46280000
nn_kernel_gpu_mem,81816,1,1,361563,128,370240000,185120000,185120000,370240000,1,46280000
nn_kernel_cpu,10145,0,1,1,64,0,0,0,0,1,46290000
nn_kernel_gpu,2725,1,1,361641,128,0,0,0,0,1,46290000
nn_kernel_gpu_mem,59529,1,1,361641,128,370320000,185160000,185160000,370320000,1,46290000
nn_kernel_cpu,26259,0,1,1,64,0,0,0,0,1,46300000
nn_kernel_gpu,2726,1,1,361719,128,0,0,0,0,1,46300000
nn_kernel_gpu_mem,57434,1,1,361719,128,370400000,185200000,185200000,370400000,1,46300000
nn_kernel_cpu,13152,0,1,1,64,0,0,0,0,1,4630000
nn_kernel_gpu,330,1,1,36172,128,0,0,0,0,1,4630000
nn_kernel_gpu_mem,6972,1,1,36172,128,37040000,18520000,18520000,37040000,1,4630000
nn_kernel_cpu,19367,0,1,1,64,0,0,0,0,1,46310000
nn_kernel_gpu,2730,1,1,361797,128,0,0,0,0,1,46310000
nn_kernel_gpu_mem,67314,1,1,361797,128,370480000,185240000,185240000,370480000,1,46310000
nn_kernel_cpu,35792,0,1,1,64,0,0,0,0,1,46320000
nn_kernel_gpu,2735,1,1,361875,128,0,0,0,0,1,46320000
nn_kernel_gpu_mem,67781,1,1,361875,128,370560000,185280000,185280000,370560000,1,46320000
nn_kernel_cpu,15607,0,1,1,64,0,0,0,0,1,46330000
nn_kernel_gpu,2733,1,1,361954,128,0,0,0,0,1,46330000
nn_kernel_gpu_mem,67745,1,1,361954,128,370640000,185320000,185320000,370640000,1,46330000
nn_kernel_cpu,18046,0,1,1,64,0,0,0,0,1,46340000
nn_kernel_gpu,2762,1,1,362032,128,0,0,0,0,1,46340000
nn_kernel_gpu_mem,59145,1,1,362032,128,370720000,185360000,185360000,370720000,1,46340000
nn_kernel_cpu,25144,0,1,1,64,0,0,0,0,1,46350000
nn_kernel_gpu,2724,1,1,362110,128,0,0,0,0,1,46350000
nn_kernel_gpu_mem,58796,1,1,362110,128,370800000,185400000,185400000,370800000,1,46350000
nn_kernel_cpu,10945,0,1,1,64,0,0,0,0,1,46360000
nn_kernel_gpu,2736,1,1,362188,128,0,0,0,0,1,46360000
nn_kernel_gpu_mem,68632,1,1,362188,128,370880000,185440000,185440000,370880000,1,46360000
nn_kernel_cpu,20373,0,1,1,64,0,0,0,0,1,46370000
nn_kernel_gpu,2737,1,1,362266,128,0,0,0,0,1,46370000
nn_kernel_gpu_mem,68935,1,1,362266,128,370960000,185480000,185480000,370960000,1,46370000
nn_kernel_cpu,17194,0,1,1,64,0,0,0,0,1,46380000
nn_kernel_gpu,2733,1,1,362344,128,0,0,0,0,1,46380000
nn_kernel_gpu_mem,67698,1,1,362344,128,371040000,185520000,185520000,371040000,1,46380000
nn_kernel_cpu,24406,0,1,1,64,0,0,0,0,1,46390000
nn_kernel_gpu,2784,1,1,362422,128,0,0,0,0,1,46390000
nn_kernel_gpu_mem,67488,1,1,362422,128,371120000,185560000,185560000,371120000,1,46390000
nn_kernel_cpu,20939,0,1,1,64,0,0,0,0,1,46400000
nn_kernel_gpu,2731,1,1,362500,128,0,0,0,0,1,46400000
nn_kernel_gpu_mem,56904,1,1,362500,128,371200000,185600000,185600000,371200000,1,46400000
nn_kernel_cpu,33408,0,1,1,64,0,0,0,0,1,4640000
nn_kernel_gpu,327,1,1,36250,128,0,0,0,0,1,4640000
nn_kernel_gpu_mem,6684,1,1,36250,128,37120000,18560000,18560000,37120000,1,4640000
nn_kernel_cpu,20260,0,1,1,64,0,0,0,0,1,46410000
nn_kernel_gpu,2740,1,1,362579,128,0,0,0,0,1,46410000
nn_kernel_gpu_mem,67672,1,1,362579,128,371280000,185640000,185640000,371280000,1,46410000
nn_kernel_cpu,22169,0,1,1,64,0,0,0,0,1,46420000
nn_kernel_gpu,2727,1,1,362657,128,0,0,0,0,1,46420000
nn_kernel_gpu_mem,54834,1,1,362657,128,371360000,185680000,185680000,371360000,1,46420000
nn_kernel_cpu,28802,0,1,1,64,0,0,0,0,1,46430000
nn_kernel_gpu,2738,1,1,362735,128,0,0,0,0,1,46430000
nn_kernel_gpu_mem,66503,1,1,362735,128,371440000,185720000,185720000,371440000,1,46430000
nn_kernel_cpu,25362,0,1,1,64,0,0,0,0,1,46440000
nn_kernel_gpu,2738,1,1,362813,128,0,0,0,0,1,46440000
nn_kernel_gpu_mem,68007,1,1,362813,128,371520000,185760000,185760000,371520000,1,46440000
nn_kernel_cpu,34089,0,1,1,64,0,0,0,0,1,46450000
nn_kernel_gpu,2735,1,1,362891,128,0,0,0,0,1,46450000
nn_kernel_gpu_mem,56165,1,1,362891,128,371600000,185800000,185800000,371600000,1,46450000
nn_kernel_cpu,34663,0,1,1,64,0,0,0,0,1,46460000
nn_kernel_gpu,2745,1,1,362969,128,0,0,0,0,1,46460000
nn_kernel_gpu_mem,69225,1,1,362969,128,371680000,185840000,185840000,371680000,1,46460000
nn_kernel_cpu,22641,0,1,1,64,0,0,0,0,1,46470000
nn_kernel_gpu,2776,1,1,363047,128,0,0,0,0,1,46470000
nn_kernel_gpu_mem,70278,1,1,363047,128,371760000,185880000,185880000,371760000,1,46470000
nn_kernel_cpu,26565,0,1,1,64,0,0,0,0,1,46480000
nn_kernel_gpu,2743,1,1,363125,128,0,0,0,0,1,46480000
nn_kernel_gpu_mem,69398,1,1,363125,128,371840000,185920000,185920000,371840000,1,46480000
nn_kernel_cpu,30505,0,1,1,64,0,0,0,0,1,46490000
nn_kernel_gpu,2731,1,1,363204,128,0,0,0,0,1,46490000
nn_kernel_gpu_mem,56769,1,1,363204,128,371920000,185960000,185960000,371920000,1,46490000
nn_kernel_cpu,26991,0,1,1,64,0,0,0,0,1,46500000
nn_kernel_gpu,2741,1,1,363282,128,0,0,0,0,1,46500000
nn_kernel_gpu_mem,68805,1,1,363282,128,372000000,186000000,186000000,372000000,1,46500000
nn_kernel_cpu,9503,0,1,1,64,0,0,0,0,1,4650000
nn_kernel_gpu,308,1,1,36329,128,0,0,0,0,1,4650000
nn_kernel_gpu_mem,8229,1,1,36329,128,37200000,18600000,18600000,37200000,1,4650000
nn_kernel_cpu,18526,0,1,1,64,0,0,0,0,1,46510000
nn_kernel_gpu,2741,1,1,363360,128,0,0,0,0,1,46510000
nn_kernel_gpu_mem,65638,1,1,363360,128,372080000,186040000,186040000,372080000,1,46510000
nn_kernel_cpu,24267,0,1,1,64,0,0,0,0,1,46520000
nn_kernel_gpu,2743,1,1,363438,128,0,0,0,0,1,46520000
nn_kernel_gpu_mem,68034,1,1,363438,128,372160000,186080000,186080000,372160000,1,46520000
nn_kernel_cpu,37850,0,1,1,64,0,0,0,0,1,46530000
nn_kernel_gpu,2754,1,1,363516,128,0,0,0,0,1,46530000
nn_kernel_gpu_mem,69020,1,1,363516,128,372240000,186120000,186120000,372240000,1,46530000
nn_kernel_cpu,15818,0,1,1,64,0,0,0,0,1,46540000
nn_kernel_gpu,2797,1,1,363594,128,0,0,0,0,1,46540000
nn_kernel_gpu_mem,68247,1,1,363594,128,372320000,186160000,186160000,372320000,1,46540000
nn_kernel_cpu,13978,0,1,1,64,0,0,0,0,1,46550000
nn_kernel_gpu,2744,1,1,363672,128,0,0,0,0,1,46550000
nn_kernel_gpu_mem,67590,1,1,363672,128,372400000,186200000,186200000,372400000,1,46550000
nn_kernel_cpu,13659,0,1,1,64,0,0,0,0,1,46560000
nn_kernel_gpu,2744,1,1,363750,128,0,0,0,0,1,46560000
nn_kernel_gpu_mem,67231,1,1,363750,128,372480000,186240000,186240000,372480000,1,46560000
nn_kernel_cpu,28736,0,1,1,64,0,0,0,0,1,46570000
nn_kernel_gpu,2789,1,1,363829,128,0,0,0,0,1,46570000
nn_kernel_gpu_mem,68275,1,1,363829,128,372560000,186280000,186280000,372560000,1,46570000
nn_kernel_cpu,26354,0,1,1,64,0,0,0,0,1,46580000
nn_kernel_gpu,2746,1,1,363907,128,0,0,0,0,1,46580000
nn_kernel_gpu_mem,57750,1,1,363907,128,372640000,186320000,186320000,372640000,1,46580000
nn_kernel_cpu,27089,0,1,1,64,0,0,0,0,1,46590000
nn_kernel_gpu,2738,1,1,363985,128,0,0,0,0,1,46590000
nn_kernel_gpu_mem,53294,1,1,363985,128,372720000,186360000,186360000,372720000,1,46590000
nn_kernel_cpu,14927,0,1,1,64,0,0,0,0,1,46600000
nn_kernel_gpu,2760,1,1,364063,128,0,0,0,0,1,46600000
nn_kernel_gpu_mem,84274,1,1,364063,128,372800000,186400000,186400000,372800000,1,46600000
nn_kernel_cpu,15432,0,1,1,64,0,0,0,0,1,4660000
nn_kernel_gpu,323,1,1,36407,128,0,0,0,0,1,4660000
nn_kernel_gpu_mem,7069,1,1,36407,128,37280000,18640000,18640000,37280000,1,4660000
nn_kernel_cpu,28356,0,1,1,64,0,0,0,0,1,46610000
nn_kernel_gpu,2750,1,1,364141,128,0,0,0,0,1,46610000
nn_kernel_gpu_mem,67515,1,1,364141,128,372880000,186440000,186440000,372880000,1,46610000
nn_kernel_cpu,34767,0,1,1,64,0,0,0,0,1,46620000
nn_kernel_gpu,2766,1,1,364219,128,0,0,0,0,1,46620000
nn_kernel_gpu_mem,60305,1,1,364219,128,372960000,186480000,186480000,372960000,1,46620000
nn_kernel_cpu,33616,0,1,1,64,0,0,0,0,1,46630000
nn_kernel_gpu,2750,1,1,364297,128,0,0,0,0,1,46630000
nn_kernel_gpu_mem,57501,1,1,364297,128,373040000,186520000,186520000,373040000,1,46630000
nn_kernel_cpu,16603,0,1,1,64,0,0,0,0,1,46640000
nn_kernel_gpu,2732,1,1,364375,128,0,0,0,0,1,46640000
nn_kernel_gpu_mem,54979,1,1,364375,128,373120000,186560000,186560000,373120000,1,46640000
nn_kernel_cpu,25052,0,1,1,64,0,0,0,0,1,46650000
nn_kernel_gpu,2747,1,1,364454,128,0,0,0,0,1,46650000
nn_kernel_gpu_mem,58033,1,1,364454,128,373200000,186600000,186600000,373200000,1,46650000
nn_kernel_cpu,22501,0,1,1,64,0,0,0,0,1,46660000
nn_kernel_gpu,2760,1,1,364532,128,0,0,0,0,1,46660000
nn_kernel_gpu_mem,67890,1,1,364532,128,373280000,186640000,186640000,373280000,1,46660000
nn_kernel_cpu,29190,0,1,1,64,0,0,0,0,1,46670000
nn_kernel_gpu,2743,1,1,364610,128,0,0,0,0,1,46670000
nn_kernel_gpu_mem,59073,1,1,364610,128,373360000,186680000,186680000,373360000,1,46670000
nn_kernel_cpu,28790,0,1,1,64,0,0,0,0,1,46680000
nn_kernel_gpu,2746,1,1,364688,128,0,0,0,0,1,46680000
nn_kernel_gpu_mem,53443,1,1,364688,128,373440000,186720000,186720000,373440000,1,46680000
nn_kernel_cpu,21118,0,1,1,64,0,0,0,0,1,46690000
nn_kernel_gpu,2762,1,1,364766,128,0,0,0,0,1,46690000
nn_kernel_gpu_mem,69239,1,1,364766,128,373520000,186760000,186760000,373520000,1,46690000
nn_kernel_cpu,24130,0,1,1,64,0,0,0,0,1,46700000
nn_kernel_gpu,2750,1,1,364844,128,0,0,0,0,1,46700000
nn_kernel_gpu_mem,62839,1,1,364844,128,373600000,186800000,186800000,373600000,1,46700000
nn_kernel_cpu,5594,0,1,1,64,0,0,0,0,1,4670000
nn_kernel_gpu,311,1,1,36485,128,0,0,0,0,1,4670000
nn_kernel_gpu_mem,9793,1,1,36485,128,37360000,18680000,18680000,37360000,1,4670000
nn_kernel_cpu,21426,0,1,1,64,0,0,0,0,1,46710000
nn_kernel_gpu,2746,1,1,364922,128,0,0,0,0,1,46710000
nn_kernel_gpu_mem,54383,1,1,364922,128,373680000,186840000,186840000,373680000,1,46710000
nn_kernel_cpu,29289,0,1,1,64,0,0,0,0,1,46720000
nn_kernel_gpu,2811,1,1,365000,128,0,0,0,0,1,46720000
nn_kernel_gpu_mem,68815,1,1,365000,128,373760000,186880000,186880000,373760000,1,46720000
nn_kernel_cpu,34615,0,1,1,64,0,0,0,0,1,46730000
nn_kernel_gpu,2751,1,1,365079,128,0,0,0,0,1,46730000
nn_kernel_gpu_mem,67866,1,1,365079,128,373840000,186920000,186920000,373840000,1,46730000
nn_kernel_cpu,16476,0,1,1,64,0,0,0,0,1,46740000
nn_kernel_gpu,2763,1,1,365157,128,0,0,0,0,1,46740000
nn_kernel_gpu_mem,69192,1,1,365157,128,373920000,186960000,186960000,373920000,1,46740000
nn_kernel_cpu,34107,0,1,1,64,0,0,0,0,1,46750000
nn_kernel_gpu,2755,1,1,365235,128,0,0,0,0,1,46750000
nn_kernel_gpu_mem,58759,1,1,365235,128,374000000,187000000,187000000,374000000,1,46750000
nn_kernel_cpu,27032,0,1,1,64,0,0,0,0,1,46760000
nn_kernel_gpu,2762,1,1,365313,128,0,0,0,0,1,46760000
nn_kernel_gpu_mem,70746,1,1,365313,128,374080000,187040000,187040000,374080000,1,46760000
nn_kernel_cpu,25959,0,1,1,64,0,0,0,0,1,46770000
nn_kernel_gpu,2752,1,1,365391,128,0,0,0,0,1,46770000
nn_kernel_gpu_mem,68803,1,1,365391,128,374160000,187080000,187080000,374160000,1,46770000
nn_kernel_cpu,25297,0,1,1,64,0,0,0,0,1,46780000
nn_kernel_gpu,2757,1,1,365469,128,0,0,0,0,1,46780000
nn_kernel_gpu_mem,59187,1,1,365469,128,374240000,187120000,187120000,374240000,1,46780000
nn_kernel_cpu,26938,0,1,1,64,0,0,0,0,1,46790000
nn_kernel_gpu,2757,1,1,365547,128,0,0,0,0,1,46790000
nn_kernel_gpu_mem,60458,1,1,365547,128,374320000,187160000,187160000,374320000,1,46790000
nn_kernel_cpu,29160,0,1,1,64,0,0,0,0,1,46800000
nn_kernel_gpu,2757,1,1,365625,128,0,0,0,0,1,46800000
nn_kernel_gpu_mem,59569,1,1,365625,128,374400000,187200000,187200000,374400000,1,46800000
nn_kernel_cpu,24267,0,1,1,64,0,0,0,0,1,4680000
nn_kernel_gpu,312,1,1,36563,128,0,0,0,0,1,4680000
nn_kernel_gpu_mem,7752,1,1,36563,128,37440000,18720000,18720000,37440000,1,4680000
nn_kernel_cpu,36789,0,1,1,64,0,0,0,0,1,46810000
nn_kernel_gpu,2756,1,1,365704,128,0,0,0,0,1,46810000
nn_kernel_gpu_mem,55773,1,1,365704,128,374480000,187240000,187240000,374480000,1,46810000
nn_kernel_cpu,25205,0,1,1,64,0,0,0,0,1,46820000
nn_kernel_gpu,2759,1,1,365782,128,0,0,0,0,1,46820000
nn_kernel_gpu_mem,76001,1,1,365782,128,374560000,187280000,187280000,374560000,1,46820000
nn_kernel_cpu,12732,0,1,1,64,0,0,0,0,1,46830000
nn_kernel_gpu,2767,1,1,365860,128,0,0,0,0,1,46830000
nn_kernel_gpu_mem,67548,1,1,365860,128,374640000,187320000,187320000,374640000,1,46830000
nn_kernel_cpu,17892,0,1,1,64,0,0,0,0,1,46840000
nn_kernel_gpu,2759,1,1,365938,128,0,0,0,0,1,46840000
nn_kernel_gpu_mem,69080,1,1,365938,128,374720000,187360000,187360000,374720000,1,46840000
nn_kernel_cpu,27499,0,1,1,64,0,0,0,0,1,46850000
nn_kernel_gpu,2755,1,1,366016,128,0,0,0,0,1,46850000
nn_kernel_gpu_mem,52842,1,1,366016,128,374800000,187400000,187400000,374800000,1,46850000
nn_kernel_cpu,23799,0,1,1,64,0,0,0,0,1,46860000
nn_kernel_gpu,2759,1,1,366094,128,0,0,0,0,1,46860000
nn_kernel_gpu_mem,70963,1,1,366094,128,374880000,187440000,187440000,374880000,1,46860000
nn_kernel_cpu,22727,0,1,1,64,0,0,0,0,1,46870000
nn_kernel_gpu,2760,1,1,366172,128,0,0,0,0,1,46870000
nn_kernel_gpu_mem,68410,1,1,366172,128,374960000,187480000,187480000,374960000,1,46870000
nn_kernel_cpu,22541,0,1,1,64,0,0,0,0,1,46880000
nn_kernel_gpu,2754,1,1,366250,128,0,0,0,0,1,46880000
nn_kernel_gpu_mem,68191,1,1,366250,128,375040000,187520000,187520000,375040000,1,46880000
nn_kernel_cpu,39927,0,1,1,64,0,0,0,0,1,46890000
nn_kernel_gpu,2758,1,1,366329,128,0,0,0,0,1,46890000
nn_kernel_gpu_mem,61774,1,1,366329,128,375120000,187560000,187560000,375120000,1,46890000
nn_kernel_cpu,20140,0,1,1,64,0,0,0,0,1,46900000
nn_kernel_gpu,2765,1,1,366407,128,0,0,0,0,1,46900000
nn_kernel_gpu_mem,69052,1,1,366407,128,375200000,187600000,187600000,375200000,1,46900000
nn_kernel_cpu,5124,0,1,1,64,0,0,0,0,1,4690000
nn_kernel_gpu,339,1,1,36641,128,0,0,0,0,1,4690000
nn_kernel_gpu_mem,6669,1,1,36641,128,37520000,18760000,18760000,37520000,1,4690000
nn_kernel_cpu,20016,0,1,1,64,0,0,0,0,1,46910000
nn_kernel_gpu,2771,1,1,366485,128,0,0,0,0,1,46910000
nn_kernel_gpu_mem,80427,1,1,366485,128,375280000,187640000,187640000,375280000,1,46910000
nn_kernel_cpu,11062,0,1,1,64,0,0,0,0,1,46920000
nn_kernel_gpu,2763,1,1,366563,128,0,0,0,0,1,46920000
nn_kernel_gpu_mem,70416,1,1,366563,128,375360000,187680000,187680000,375360000,1,46920000
nn_kernel_cpu,29344,0,1,1,64,0,0,0,0,1,46930000
nn_kernel_gpu,2770,1,1,366641,128,0,0,0,0,1,46930000
nn_kernel_gpu_mem,65087,1,1,366641,128,375440000,187720000,187720000,375440000,1,46930000
nn_kernel_cpu,15174,0,1,1,64,0,0,0,0,1,46940000
nn_kernel_gpu,2775,1,1,366719,128,0,0,0,0,1,46940000
nn_kernel_gpu_mem,64869,1,1,366719,128,375520000,187760000,187760000,375520000,1,46940000
nn_kernel_cpu,27534,0,1,1,64,0,0,0,0,1,46950000
nn_kernel_gpu,2776,1,1,366797,128,0,0,0,0,1,46950000
nn_kernel_gpu_mem,63474,1,1,366797,128,375600000,187800000,187800000,375600000,1,46950000
nn_kernel_cpu,18657,0,1,1,64,0,0,0,0,1,46960000
nn_kernel_gpu,2765,1,1,366875,128,0,0,0,0,1,46960000
nn_kernel_gpu_mem,59978,1,1,366875,128,375680000,187840000,187840000,375680000,1,46960000
nn_kernel_cpu,27260,0,1,1,64,0,0,0,0,1,46970000
nn_kernel_gpu,2768,1,1,366954,128,0,0,0,0,1,46970000
nn_kernel_gpu_mem,69466,1,1,366954,128,375760000,187880000,187880000,375760000,1,46970000
nn_kernel_cpu,27382,0,1,1,64,0,0,0,0,1,46980000
nn_kernel_gpu,2770,1,1,367032,128,0,0,0,0,1,46980000
nn_kernel_gpu_mem,55836,1,1,367032,128,375840000,187920000,187920000,375840000,1,46980000
nn_kernel_cpu,16472,0,1,1,64,0,0,0,0,1,46990000
nn_kernel_gpu,2767,1,1,367110,128,0,0,0,0,1,46990000
nn_kernel_gpu_mem,56433,1,1,367110,128,375920000,187960000,187960000,375920000,1,46990000
nn_kernel_cpu,13528,0,1,1,64,0,0,0,0,1,47000000
nn_kernel_gpu,2764,1,1,367188,128,0,0,0,0,1,47000000
nn_kernel_gpu_mem,70064,1,1,367188,128,376000000,188000000,188000000,376000000,1,47000000
nn_kernel_cpu,36704,0,1,1,64,0,0,0,0,1,4700000
nn_kernel_gpu,337,1,1,36719,128,0,0,0,0,1,4700000
nn_kernel_gpu_mem,6905,1,1,36719,128,37600000,18800000,18800000,37600000,1,4700000
nn_kernel_cpu,767,0,1,1,64,0,0,0,0,1,470000
nn_kernel_gpu,74,1,1,3672,128,0,0,0,0,1,470000
nn_kernel_gpu_mem,1000,1,1,3672,128,3760000,1880000,1880000,3760000,1,470000
nn_kernel_cpu,22366,0,1,1,64,0,0,0,0,1,47010000
nn_kernel_gpu,2757,1,1,367266,128,0,0,0,0,1,47010000
nn_kernel_gpu_mem,52756,1,1,367266,128,376080000,188040000,188040000,376080000,1,47010000
nn_kernel_cpu,29787,0,1,1,64,0,0,0,0,1,47020000
nn_kernel_gpu,2804,1,1,367344,128,0,0,0,0,1,47020000
nn_kernel_gpu_mem,58189,1,1,367344,128,376160000,188080000,188080000,376160000,1,47020000
nn_kernel_cpu,14471,0,1,1,64,0,0,0,0,1,47030000
nn_kernel_gpu,2809,1,1,367422,128,0,0,0,0,1,47030000
nn_kernel_gpu_mem,71845,1,1,367422,128,376240000,188120000,188120000,376240000,1,47030000
nn_kernel_cpu,32342,0,1,1,64,0,0,0,0,1,47040000
nn_kernel_gpu,2799,1,1,367500,128,0,0,0,0,1,47040000
nn_kernel_gpu_mem,68784,1,1,367500,128,376320000,188160000,188160000,376320000,1,47040000
nn_kernel_cpu,19561,0,1,1,64,0,0,0,0,1,47050000
nn_kernel_gpu,2762,1,1,367579,128,0,0,0,0,1,47050000
nn_kernel_gpu_mem,68299,1,1,367579,128,376400000,188200000,188200000,376400000,1,47050000
nn_kernel_cpu,16415,0,1,1,64,0,0,0,0,1,47060000
nn_kernel_gpu,2767,1,1,367657,128,0,0,0,0,1,47060000
nn_kernel_gpu_mem,68633,1,1,367657,128,376480000,188240000,188240000,376480000,1,47060000
nn_kernel_cpu,32559,0,1,1,64,0,0,0,0,1,47070000
nn_kernel_gpu,2806,1,1,367735,128,0,0,0,0,1,47070000
nn_kernel_gpu_mem,61263,1,1,367735,128,376560000,188280000,188280000,376560000,1,47070000
nn_kernel_cpu,29639,0,1,1,64,0,0,0,0,1,47080000
nn_kernel_gpu,2761,1,1,367813,128,0,0,0,0,1,47080000
nn_kernel_gpu_mem,59951,1,1,367813,128,376640000,188320000,188320000,376640000,1,47080000
nn_kernel_cpu,16494,0,1,1,64,0,0,0,0,1,47090000
nn_kernel_gpu,2778,1,1,367891,128,0,0,0,0,1,47090000
nn_kernel_gpu_mem,54721,1,1,367891,128,376720000,188360000,188360000,376720000,1,47090000
nn_kernel_cpu,21268,0,1,1,64,0,0,0,0,1,47100000
nn_kernel_gpu,2772,1,1,367969,128,0,0,0,0,1,47100000
nn_kernel_gpu_mem,60189,1,1,367969,128,376800000,188400000,188400000,376800000,1,47100000
nn_kernel_cpu,13295,0,1,1,64,0,0,0,0,1,4710000
nn_kernel_gpu,340,1,1,36797,128,0,0,0,0,1,4710000
nn_kernel_gpu_mem,6779,1,1,36797,128,37680000,18840000,18840000,37680000,1,4710000
nn_kernel_cpu,17282,0,1,1,64,0,0,0,0,1,47110000
nn_kernel_gpu,2760,1,1,368047,128,0,0,0,0,1,47110000
nn_kernel_gpu_mem,59091,1,1,368047,128,376880000,188440000,188440000,376880000,1,47110000
nn_kernel_cpu,28314,0,1,1,64,0,0,0,0,1,47120000
nn_kernel_gpu,2782,1,1,368125,128,0,0,0,0,1,47120000
nn_kernel_gpu_mem,70023,1,1,368125,128,376960000,188480000,188480000,376960000,1,47120000
nn_kernel_cpu,18750,0,1,1,64,0,0,0,0,1,47130000
nn_kernel_gpu,2782,1,1,368204,128,0,0,0,0,1,47130000
nn_kernel_gpu_mem,64352,1,1,368204,128,377040000,188520000,188520000,377040000,1,47130000
nn_kernel_cpu,32986,0,1,1,64,0,0,0,0,1,47140000
nn_kernel_gpu,2773,1,1,368282,128,0,0,0,0,1,47140000
nn_kernel_gpu_mem,59690,1,1,368282,128,377120000,188560000,188560000,377120000,1,47140000
nn_kernel_cpu,25000,0,1,1,64,0,0,0,0,1,47150000
nn_kernel_gpu,2778,1,1,368360,128,0,0,0,0,1,47150000
nn_kernel_gpu_mem,69934,1,1,368360,128,377200000,188600000,188600000,377200000,1,47150000
nn_kernel_cpu,21511,0,1,1,64,0,0,0,0,1,47160000
nn_kernel_gpu,2782,1,1,368438,128,0,0,0,0,1,47160000
nn_kernel_gpu_mem,68252,1,1,368438,128,377280000,188640000,188640000,377280000,1,47160000
nn_kernel_cpu,26940,0,1,1,64,0,0,0,0,1,47170000
nn_kernel_gpu,2781,1,1,368516,128,0,0,0,0,1,47170000
nn_kernel_gpu_mem,70370,1,1,368516,128,377360000,188680000,188680000,377360000,1,47170000
nn_kernel_cpu,17828,0,1,1,64,0,0,0,0,1,47180000
nn_kernel_gpu,2780,1,1,368594,128,0,0,0,0,1,47180000
nn_kernel_gpu_mem,71958,1,1,368594,128,377440000,188720000,188720000,377440000,1,47180000
nn_kernel_cpu,16824,0,1,1,64,0,0,0,0,1,47190000
nn_kernel_gpu,2776,1,1,368672,128,0,0,0,0,1,47190000
nn_kernel_gpu_mem,54763,1,1,368672,128,377520000,188760000,188760000,377520000,1,47190000
nn_kernel_cpu,24926,0,1,1,64,0,0,0,0,1,47200000
nn_kernel_gpu,2778,1,1,368750,128,0,0,0,0,1,47200000
nn_kernel_gpu_mem,59326,1,1,368750,128,377600000,188800000,188800000,377600000,1,47200000
nn_kernel_cpu,28500,0,1,1,64,0,0,0,0,1,4720000
nn_kernel_gpu,334,1,1,36875,128,0,0,0,0,1,4720000
nn_kernel_gpu_mem,7188,1,1,36875,128,37760000,18880000,18880000,37760000,1,4720000
nn_kernel_cpu,23357,0,1,1,64,0,0,0,0,1,47210000
nn_kernel_gpu,2822,1,1,368829,128,0,0,0,0,1,47210000
nn_kernel_gpu_mem,60543,1,1,368829,128,377680000,188840000,188840000,377680000,1,47210000
nn_kernel_cpu,28227,0,1,1,64,0,0,0,0,1,47220000
nn_kernel_gpu,2769,1,1,368907,128,0,0,0,0,1,47220000
nn_kernel_gpu_mem,57850,1,1,368907,128,377760000,188880000,188880000,377760000,1,47220000
nn_kernel_cpu,12047,0,1,1,64,0,0,0,0,1,47230000
nn_kernel_gpu,2780,1,1,368985,128,0,0,0,0,1,47230000
nn_kernel_gpu_mem,60135,1,1,368985,128,377840000,188920000,188920000,377840000,1,47230000
nn_kernel_cpu,29237,0,1,1,64,0,0,0,0,1,47240000
nn_kernel_gpu,2782,1,1,369063,128,0,0,0,0,1,47240000
nn_kernel_gpu_mem,67563,1,1,369063,128,377920000,188960000,188960000,377920000,1,47240000
nn_kernel_cpu,18714,0,1,1,64,0,0,0,0,1,47250000
nn_kernel_gpu,2779,1,1,369141,128,0,0,0,0,1,47250000
nn_kernel_gpu_mem,59925,1,1,369141,128,378000000,189000000,189000000,378000000,1,47250000
nn_kernel_cpu,25474,0,1,1,64,0,0,0,0,1,47260000
nn_kernel_gpu,2783,1,1,369219,128,0,0,0,0,1,47260000
nn_kernel_gpu_mem,70601,1,1,369219,128,378080000,189040000,189040000,378080000,1,47260000
nn_kernel_cpu,24948,0,1,1,64,0,0,0,0,1,47270000
nn_kernel_gpu,2788,1,1,369297,128,0,0,0,0,1,47270000
nn_kernel_gpu_mem,71313,1,1,369297,128,378160000,189080000,189080000,378160000,1,47270000
nn_kernel_cpu,19334,0,1,1,64,0,0,0,0,1,47280000
nn_kernel_gpu,2787,1,1,369375,128,0,0,0,0,1,47280000
nn_kernel_gpu_mem,62685,1,1,369375,128,378240000,189120000,189120000,378240000,1,47280000
nn_kernel_cpu,19306,0,1,1,64,0,0,0,0,1,47290000
nn_kernel_gpu,2784,1,1,369454,128,0,0,0,0,1,47290000
nn_kernel_gpu_mem,63404,1,1,369454,128,378320000,189160000,189160000,378320000,1,47290000
nn_kernel_cpu,28079,0,1,1,64,0,0,0,0,1,47300000
nn_kernel_gpu,2783,1,1,369532,128,0,0,0,0,1,47300000
nn_kernel_gpu_mem,57513,1,1,369532,128,378400000,189200000,189200000,378400000,1,47300000
nn_kernel_cpu,24141,0,1,1,64,0,0,0,0,1,4730000
nn_kernel_gpu,339,1,1,36954,128,0,0,0,0,1,4730000
nn_kernel_gpu_mem,7109,1,1,36954,128,37840000,18920000,18920000,37840000,1,4730000
nn_kernel_cpu,20796,0,1,1,64,0,0,0,0,1,47310000
nn_kernel_gpu,2796,1,1,369610,128,0,0,0,0,1,47310000
nn_kernel_gpu_mem,67266,1,1,369610,128,378480000,189240000,189240000,378480000,1,47310000
nn_kernel_cpu,17739,0,1,1,64,0,0,0,0,1,47320000
nn_kernel_gpu,2793,1,1,369688,128,0,0,0,0,1,47320000
nn_kernel_gpu_mem,69640,1,1,369688,128,378560000,189280000,189280000,378560000,1,47320000
nn_kernel_cpu,24500,0,1,1,64,0,0,0,0,1,47330000
nn_kernel_gpu,2787,1,1,369766,128,0,0,0,0,1,47330000
nn_kernel_gpu_mem,69931,1,1,369766,128,378640000,189320000,189320000,378640000,1,47330000
nn_kernel_cpu,21300,0,1,1,64,0,0,0,0,1,47340000
nn_kernel_gpu,2782,1,1,369844,128,0,0,0,0,1,47340000
nn_kernel_gpu_mem,69123,1,1,369844,128,378720000,189360000,189360000,378720000,1,47340000
nn_kernel_cpu,21458,0,1,1,64,0,0,0,0,1,47350000
nn_kernel_gpu,2792,1,1,369922,128,0,0,0,0,1,47350000
nn_kernel_gpu_mem,61355,1,1,369922,128,378800000,189400000,189400000,378800000,1,47350000
nn_kernel_cpu,29785,0,1,1,64,0,0,0,0,1,47360000
nn_kernel_gpu,2799,1,1,370000,128,0,0,0,0,1,47360000
nn_kernel_gpu_mem,67336,1,1,370000,128,378880000,189440000,189440000,378880000,1,47360000
nn_kernel_cpu,31995,0,1,1,64,0,0,0,0,1,47370000
nn_kernel_gpu,2833,1,1,370079,128,0,0,0,0,1,47370000
nn_kernel_gpu_mem,68998,1,1,370079,128,378960000,189480000,189480000,378960000,1,47370000
nn_kernel_cpu,25096,0,1,1,64,0,0,0,0,1,47380000
nn_kernel_gpu,2788,1,1,370157,128,0,0,0,0,1,47380000
nn_kernel_gpu_mem,61802,1,1,370157,128,379040000,189520000,189520000,379040000,1,47380000
nn_kernel_cpu,20761,0,1,1,64,0,0,0,0,1,47390000
nn_kernel_gpu,2797,1,1,370235,128,0,0,0,0,1,47390000
nn_kernel_gpu_mem,69483,1,1,370235,128,379120000,189560000,189560000,379120000,1,47390000
nn_kernel_cpu,25200,0,1,1,64,0,0,0,0,1,47400000
nn_kernel_gpu,2793,1,1,370313,128,0,0,0,0,1,47400000
nn_kernel_gpu_mem,56868,1,1,370313,128,379200000,189600000,189600000,379200000,1,47400000
nn_kernel_cpu,3501,0,1,1,64,0,0,0,0,1,4740000
nn_kernel_gpu,334,1,1,37032,128,0,0,0,0,1,4740000
nn_kernel_gpu_mem,6812,1,1,37032,128,37920000,18960000,18960000,37920000,1,4740000
nn_kernel_cpu,34775,0,1,1,64,0,0,0,0,1,47410000
nn_kernel_gpu,2798,1,1,370391,128,0,0,0,0,1,47410000
nn_kernel_gpu_mem,79394,1,1,370391,128,379280000,189640000,189640000,379280000,1,47410000
nn_kernel_cpu,28324,0,1,1,64,0,0,0,0,1,47420000
nn_kernel_gpu,2808,1,1,370469,128,0,0,0,0,1,47420000
nn_kernel_gpu_mem,59015,1,1,370469,128,379360000,189680000,189680000,379360000,1,47420000
nn_kernel_cpu,23621,0,1,1,64,0,0,0,0,1,47430000
nn_kernel_gpu,2805,1,1,370547,128,0,0,0,0,1,47430000
nn_kernel_gpu_mem,70657,1,1,370547,128,379440000,189720000,189720000,379440000,1,47430000
nn_kernel_cpu,25393,0,1,1,64,0,0,0,0,1,47440000
nn_kernel_gpu,2796,1,1,370625,128,0,0,0,0,1,47440000
nn_kernel_gpu_mem,70287,1,1,370625,128,379520000,189760000,189760000,379520000,1,47440000
nn_kernel_cpu,19929,0,1,1,64,0,0,0,0,1,47450000
nn_kernel_gpu,2803,1,1,370704,128,0,0,0,0,1,47450000
nn_kernel_gpu_mem,56699,1,1,370704,128,379600000,189800000,189800000,379600000,1,47450000
nn_kernel_cpu,25222,0,1,1,64,0,0,0,0,1,47460000
nn_kernel_gpu,2799,1,1,370782,128,0,0,0,0,1,47460000
nn_kernel_gpu_mem,59326,1,1,370782,128,379680000,189840000,189840000,379680000,1,47460000
nn_kernel_cpu,25018,0,1,1,64,0,0,0,0,1,47470000
nn_kernel_gpu,2839,1,1,370860,128,0,0,0,0,1,47470000
nn_kernel_gpu_mem,68906,1,1,370860,128,379760000,189880000,189880000,379760000,1,47470000
nn_kernel_cpu,25224,0,1,1,64,0,0,0,0,1,47480000
nn_kernel_gpu,2801,1,1,370938,128,0,0,0,0,1,47480000
nn_kernel_gpu_mem,72265,1,1,370938,128,379840000,189920000,189920000,379840000,1,47480000
nn_kernel_cpu,27542,0,1,1,64,0,0,0,0,1,47490000
nn_kernel_gpu,2796,1,1,371016,128,0,0,0,0,1,47490000
nn_kernel_gpu_mem,69408,1,1,371016,128,379920000,189960000,189960000,379920000,1,47490000
nn_kernel_cpu,28361,0,1,1,64,0,0,0,0,1,47500000
nn_kernel_gpu,2852,1,1,371094,128,0,0,0,0,1,47500000
nn_kernel_gpu_mem,59577,1,1,371094,128,380000000,190000000,190000000,380000000,1,47500000
nn_kernel_cpu,12335,0,1,1,64,0,0,0,0,1,4750000
nn_kernel_gpu,336,1,1,37110,128,0,0,0,0,1,4750000
nn_kernel_gpu_mem,6845,1,1,37110,128,38000000,19000000,19000000,38000000,1,4750000
nn_kernel_cpu,13238,0,1,1,64,0,0,0,0,1,47510000
nn_kernel_gpu,2850,1,1,371172,128,0,0,0,0,1,47510000
nn_kernel_gpu_mem,60308,1,1,371172,128,380080000,190040000,190040000,380080000,1,47510000
nn_kernel_cpu,22557,0,1,1,64,0,0,0,0,1,47520000
nn_kernel_gpu,2848,1,1,371250,128,0,0,0,0,1,47520000
nn_kernel_gpu_mem,70258,1,1,371250,128,380160000,190080000,190080000,380160000,1,47520000
nn_kernel_cpu,22325,0,1,1,64,0,0,0,0,1,47530000
nn_kernel_gpu,2801,1,1,371329,128,0,0,0,0,1,47530000
nn_kernel_gpu_mem,69345,1,1,371329,128,380240000,190120000,190120000,380240000,1,47530000
nn_kernel_cpu,29796,0,1,1,64,0,0,0,0,1,47540000
nn_kernel_gpu,2834,1,1,371407,128,0,0,0,0,1,47540000
nn_kernel_gpu_mem,56620,1,1,371407,128,380320000,190160000,190160000,380320000,1,47540000
nn_kernel_cpu,26309,0,1,1,64,0,0,0,0,1,47550000
nn_kernel_gpu,2841,1,1,371485,128,0,0,0,0,1,47550000
nn_kernel_gpu_mem,67727,1,1,371485,128,380400000,190200000,190200000,380400000,1,47550000
nn_kernel_cpu,33989,0,1,1,64,0,0,0,0,1,47560000
nn_kernel_gpu,2806,1,1,371563,128,0,0,0,0,1,47560000
nn_kernel_gpu_mem,69420,1,1,371563,128,380480000,190240000,190240000,380480000,1,47560000
nn_kernel_cpu,29464,0,1,1,64,0,0,0,0,1,47570000
nn_kernel_gpu,2843,1,1,371641,128,0,0,0,0,1,47570000
nn_kernel_gpu_mem,71544,1,1,371641,128,380560000,190280000,190280000,380560000,1,47570000
nn_kernel_cpu,26454,0,1,1,64,0,0,0,0,1,47580000
nn_kernel_gpu,2800,1,1,371719,128,0,0,0,0,1,47580000
nn_kernel_gpu_mem,72254,1,1,371719,128,380640000,190320000,190320000,380640000,1,47580000
nn_kernel_cpu,27943,0,1,1,64,0,0,0,0,1,47590000
nn_kernel_gpu,2807,1,1,371797,128,0,0,0,0,1,47590000
nn_kernel_gpu_mem,71886,1,1,371797,128,380720000,190360000,190360000,380720000,1,47590000
nn_kernel_cpu,29449,0,1,1,64,0,0,0,0,1,47600000
nn_kernel_gpu,2843,1,1,371875,128,0,0,0,0,1,47600000
nn_kernel_gpu_mem,69949,1,1,371875,128,380800000,190400000,190400000,380800000,1,47600000
nn_kernel_cpu,3847,0,1,1,64,0,0,0,0,1,4760000
nn_kernel_gpu,327,1,1,37188,128,0,0,0,0,1,4760000
nn_kernel_gpu_mem,7128,1,1,37188,128,38080000,19040000,19040000,38080000,1,4760000
nn_kernel_cpu,20204,0,1,1,64,0,0,0,0,1,47610000
nn_kernel_gpu,2810,1,1,371954,128,0,0,0,0,1,47610000
nn_kernel_gpu_mem,61328,1,1,371954,128,380880000,190440000,190440000,380880000,1,47610000
nn_kernel_cpu,27848,0,1,1,64,0,0,0,0,1,47620000
nn_kernel_gpu,2805,1,1,372032,128,0,0,0,0,1,47620000
nn_kernel_gpu_mem,59282,1,1,372032,128,380960000,190480000,190480000,380960000,1,47620000
nn_kernel_cpu,14463,0,1,1,64,0,0,0,0,1,47630000
nn_kernel_gpu,2859,1,1,372110,128,0,0,0,0,1,47630000
nn_kernel_gpu_mem,60532,1,1,372110,128,381040000,190520000,190520000,381040000,1,47630000
nn_kernel_cpu,15326,0,1,1,64,0,0,0,0,1,47640000
nn_kernel_gpu,2811,1,1,372188,128,0,0,0,0,1,47640000
nn_kernel_gpu_mem,69691,1,1,372188,128,381120000,190560000,190560000,381120000,1,47640000
nn_kernel_cpu,19052,0,1,1,64,0,0,0,0,1,47650000
nn_kernel_gpu,2807,1,1,372266,128,0,0,0,0,1,47650000
nn_kernel_gpu_mem,64896,1,1,372266,128,381200000,190600000,190600000,381200000,1,47650000
nn_kernel_cpu,13811,0,1,1,64,0,0,0,0,1,47660000
nn_kernel_gpu,2810,1,1,372344,128,0,0,0,0,1,47660000
nn_kernel_gpu_mem,58472,1,1,372344,128,381280000,190640000,190640000,381280000,1,47660000
nn_kernel_cpu,23379,0,1,1,64,0,0,0,0,1,47670000
nn_kernel_gpu,2806,1,1,372422,128,0,0,0,0,1,47670000
nn_kernel_gpu_mem,69341,1,1,372422,128,381360000,190680000,190680000,381360000,1,47670000
nn_kernel_cpu,15904,0,1,1,64,0,0,0,0,1,47680000
nn_kernel_gpu,2808,1,1,372500,128,0,0,0,0,1,47680000
nn_kernel_gpu_mem,72438,1,1,372500,128,381440000,190720000,190720000,381440000,1,47680000
nn_kernel_cpu,55358,0,1,1,64,0,0,0,0,1,47690000
nn_kernel_gpu,2810,1,1,372579,128,0,0,0,0,1,47690000
nn_kernel_gpu_mem,70069,1,1,372579,128,381520000,190760000,190760000,381520000,1,47690000
nn_kernel_cpu,23807,0,1,1,64,0,0,0,0,1,47700000
nn_kernel_gpu,2808,1,1,372657,128,0,0,0,0,1,47700000
nn_kernel_gpu_mem,61310,1,1,372657,128,381600000,190800000,190800000,381600000,1,47700000
nn_kernel_cpu,15012,0,1,1,64,0,0,0,0,1,4770000
nn_kernel_gpu,316,1,1,37266,128,0,0,0,0,1,4770000
nn_kernel_gpu_mem,6835,1,1,37266,128,38160000,19080000,19080000,38160000,1,4770000
nn_kernel_cpu,31937,0,1,1,64,0,0,0,0,1,47710000
nn_kernel_gpu,2828,1,1,372735,128,0,0,0,0,1,47710000
nn_kernel_gpu_mem,71512,1,1,372735,128,381680000,190840000,190840000,381680000,1,47710000
nn_kernel_cpu,30118,0,1,1,64,0,0,0,0,1,47720000
nn_kernel_gpu,2817,1,1,372813,128,0,0,0,0,1,47720000
nn_kernel_gpu_mem,66078,1,1,372813,128,381760000,190880000,190880000,381760000,1,47720000
nn_kernel_cpu,21761,0,1,1,64,0,0,0,0,1,47730000
nn_kernel_gpu,2817,1,1,372891,128,0,0,0,0,1,47730000
nn_kernel_gpu_mem,70160,1,1,372891,128,381840000,190920000,190920000,381840000,1,47730000
nn_kernel_cpu,16479,0,1,1,64,0,0,0,0,1,47740000
nn_kernel_gpu,2820,1,1,372969,128,0,0,0,0,1,47740000
nn_kernel_gpu_mem,70396,1,1,372969,128,381920000,190960000,190960000,381920000,1,47740000
nn_kernel_cpu,25325,0,1,1,64,0,0,0,0,1,47750000
nn_kernel_gpu,2827,1,1,373047,128,0,0,0,0,1,47750000
nn_kernel_gpu_mem,69852,1,1,373047,128,382000000,191000000,191000000,382000000,1,47750000
nn_kernel_cpu,28479,0,1,1,64,0,0,0,0,1,47760000
nn_kernel_gpu,2856,1,1,373125,128,0,0,0,0,1,47760000
nn_kernel_gpu_mem,67719,1,1,373125,128,382080000,191040000,191040000,382080000,1,47760000
nn_kernel_cpu,29611,0,1,1,64,0,0,0,0,1,47770000
nn_kernel_gpu,2821,1,1,373204,128,0,0,0,0,1,47770000
nn_kernel_gpu_mem,56426,1,1,373204,128,382160000,191080000,191080000,382160000,1,47770000
nn_kernel_cpu,16665,0,1,1,64,0,0,0,0,1,47780000
nn_kernel_gpu,2827,1,1,373282,128,0,0,0,0,1,47780000
nn_kernel_gpu_mem,70310,1,1,373282,128,382240000,191120000,191120000,382240000,1,47780000
nn_kernel_cpu,25401,0,1,1,64,0,0,0,0,1,47790000
nn_kernel_gpu,2864,1,1,373360,128,0,0,0,0,1,47790000
nn_kernel_gpu_mem,70027,1,1,373360,128,382320000,191160000,191160000,382320000,1,47790000
nn_kernel_cpu,19484,0,1,1,64,0,0,0,0,1,47800000
nn_kernel_gpu,2865,1,1,373438,128,0,0,0,0,1,47800000
nn_kernel_gpu_mem,69662,1,1,373438,128,382400000,191200000,191200000,382400000,1,47800000
nn_kernel_cpu,20633,0,1,1,64,0,0,0,0,1,4780000
nn_kernel_gpu,341,1,1,37344,128,0,0,0,0,1,4780000
nn_kernel_gpu_mem,6886,1,1,37344,128,38240000,19120000,19120000,38240000,1,4780000
nn_kernel_cpu,31811,0,1,1,64,0,0,0,0,1,47810000
nn_kernel_gpu,2821,1,1,373516,128,0,0,0,0,1,47810000
nn_kernel_gpu_mem,70519,1,1,373516,128,382480000,191240000,191240000,382480000,1,47810000
nn_kernel_cpu,16566,0,1,1,64,0,0,0,0,1,47820000
nn_kernel_gpu,2829,1,1,373594,128,0,0,0,0,1,47820000
nn_kernel_gpu_mem,68591,1,1,373594,128,382560000,191280000,191280000,382560000,1,47820000
nn_kernel_cpu,27392,0,1,1,64,0,0,0,0,1,47830000
nn_kernel_gpu,2822,1,1,373672,128,0,0,0,0,1,47830000
nn_kernel_gpu_mem,61624,1,1,373672,128,382640000,191320000,191320000,382640000,1,47830000
nn_kernel_cpu,19945,0,1,1,64,0,0,0,0,1,47840000
nn_kernel_gpu,2823,1,1,373750,128,0,0,0,0,1,47840000
nn_kernel_gpu_mem,67917,1,1,373750,128,382720000,191360000,191360000,382720000,1,47840000
nn_kernel_cpu,27479,0,1,1,64,0,0,0,0,1,47850000
nn_kernel_gpu,2827,1,1,373829,128,0,0,0,0,1,47850000
nn_kernel_gpu_mem,70001,1,1,373829,128,382800000,191400000,191400000,382800000,1,47850000
nn_kernel_cpu,38654,0,1,1,64,0,0,0,0,1,47860000
nn_kernel_gpu,2841,1,1,373907,128,0,0,0,0,1,47860000
nn_kernel_gpu_mem,72089,1,1,373907,128,382880000,191440000,191440000,382880000,1,47860000
nn_kernel_cpu,14273,0,1,1,64,0,0,0,0,1,47870000
nn_kernel_gpu,2873,1,1,373985,128,0,0,0,0,1,47870000
nn_kernel_gpu_mem,70963,1,1,373985,128,382960000,191480000,191480000,382960000,1,47870000
nn_kernel_cpu,28061,0,1,1,64,0,0,0,0,1,47880000
nn_kernel_gpu,2819,1,1,374063,128,0,0,0,0,1,47880000
nn_kernel_gpu_mem,73385,1,1,374063,128,383040000,191520000,191520000,383040000,1,47880000
nn_kernel_cpu,29615,0,1,1,64,0,0,0,0,1,47890000
nn_kernel_gpu,2830,1,1,374141,128,0,0,0,0,1,47890000
nn_kernel_gpu_mem,60749,1,1,374141,128,383120000,191560000,191560000,383120000,1,47890000
nn_kernel_cpu,27054,0,1,1,64,0,0,0,0,1,47900000
nn_kernel_gpu,2829,1,1,374219,128,0,0,0,0,1,47900000
nn_kernel_gpu_mem,67927,1,1,374219,128,383200000,191600000,191600000,383200000,1,47900000
nn_kernel_cpu,23877,0,1,1,64,0,0,0,0,1,4790000
nn_kernel_gpu,341,1,1,37422,128,0,0,0,0,1,4790000
nn_kernel_gpu_mem,6881,1,1,37422,128,38320000,19160000,19160000,38320000,1,4790000
nn_kernel_cpu,20067,0,1,1,64,0,0,0,0,1,47910000
nn_kernel_gpu,2873,1,1,374297,128,0,0,0,0,1,47910000
nn_kernel_gpu_mem,70385,1,1,374297,128,383280000,191640000,191640000,383280000,1,47910000
nn_kernel_cpu,27478,0,1,1,64,0,0,0,0,1,47920000
nn_kernel_gpu,2830,1,1,374375,128,0,0,0,0,1,47920000
nn_kernel_gpu_mem,75443,1,1,374375,128,383360000,191680000,191680000,383360000,1,47920000
nn_kernel_cpu,25199,0,1,1,64,0,0,0,0,1,47930000
nn_kernel_gpu,2834,1,1,374454,128,0,0,0,0,1,47930000
nn_kernel_gpu_mem,61033,1,1,374454,128,383440000,191720000,191720000,383440000,1,47930000
nn_kernel_cpu,20342,0,1,1,64,0,0,0,0,1,47940000
nn_kernel_gpu,2874,1,1,374532,128,0,0,0,0,1,47940000
nn_kernel_gpu_mem,70829,1,1,374532,128,383520000,191760000,191760000,383520000,1,47940000
nn_kernel_cpu,17890,0,1,1,64,0,0,0,0,1,47950000
nn_kernel_gpu,2866,1,1,374610,128,0,0,0,0,1,47950000
nn_kernel_gpu_mem,60026,1,1,374610,128,383600000,191800000,191800000,383600000,1,47950000
nn_kernel_cpu,26655,0,1,1,64,0,0,0,0,1,47960000
nn_kernel_gpu,2859,1,1,374688,128,0,0,0,0,1,47960000
nn_kernel_gpu_mem,62014,1,1,374688,128,383680000,191840000,191840000,383680000,1,47960000
nn_kernel_cpu,32555,0,1,1,64,0,0,0,0,1,47970000
nn_kernel_gpu,2868,1,1,374766,128,0,0,0,0,1,47970000
nn_kernel_gpu_mem,70196,1,1,374766,128,383760000,191880000,191880000,383760000,1,47970000
nn_kernel_cpu,22103,0,1,1,64,0,0,0,0,1,47980000
nn_kernel_gpu,2835,1,1,374844,128,0,0,0,0,1,47980000
nn_kernel_gpu_mem,61054,1,1,374844,128,383840000,191920000,191920000,383840000,1,47980000
nn_kernel_cpu,24064,0,1,1,64,0,0,0,0,1,47990000
nn_kernel_gpu,2834,1,1,374922,128,0,0,0,0,1,47990000
nn_kernel_gpu_mem,69777,1,1,374922,128,383920000,191960000,191960000,383920000,1,47990000
nn_kernel_cpu,18583,0,1,1,64,0,0,0,0,1,48000000
nn_kernel_gpu,2833,1,1,375000,128,0,0,0,0,1,48000000
nn_kernel_gpu_mem,71667,1,1,375000,128,384000000,192000000,192000000,384000000,1,48000000
nn_kernel_cpu,23709,0,1,1,64,0,0,0,0,1,4800000
nn_kernel_gpu,319,1,1,37500,128,0,0,0,0,1,4800000
nn_kernel_gpu_mem,8171,1,1,37500,128,38400000,19200000,19200000,38400000,1,4800000
nn_kernel_cpu,7404,0,1,1,64,0,0,0,0,1,480000
nn_kernel_gpu,77,1,1,3750,128,0,0,0,0,1,480000
nn_kernel_gpu_mem,1581,1,1,3750,128,3840000,1920000,1920000,3840000,1,480000
nn_kernel_cpu,26975,0,1,1,64,0,0,0,0,1,48010000
nn_kernel_gpu,2887,1,1,375079,128,0,0,0,0,1,48010000
nn_kernel_gpu_mem,72141,1,1,375079,128,384080000,192040000,192040000,384080000,1,48010000
nn_kernel_cpu,26332,0,1,1,64,0,0,0,0,1,48020000
nn_kernel_gpu,2841,1,1,375157,128,0,0,0,0,1,48020000
nn_kernel_gpu_mem,71069,1,1,375157,128,384160000,192080000,192080000,384160000,1,48020000
nn_kernel_cpu,15947,0,1,1,64,0,0,0,0,1,48030000
nn_kernel_gpu,2840,1,1,375235,128,0,0,0,0,1,48030000
nn_kernel_gpu_mem,71264,1,1,375235,128,384240000,192120000,192120000,384240000,1,48030000
nn_kernel_cpu,16137,0,1,1,64,0,0,0,0,1,48040000
nn_kernel_gpu,2832,1,1,375313,128,0,0,0,0,1,48040000
nn_kernel_gpu_mem,67321,1,1,375313,128,384320000,192160000,192160000,384320000,1,48040000
nn_kernel_cpu,31632,0,1,1,64,0,0,0,0,1,48050000
nn_kernel_gpu,2833,1,1,375391,128,0,0,0,0,1,48050000
nn_kernel_gpu_mem,62481,1,1,375391,128,384400000,192200000,192200000,384400000,1,48050000
nn_kernel_cpu,24457,0,1,1,64,0,0,0,0,1,48060000
nn_kernel_gpu,2839,1,1,375469,128,0,0,0,0,1,48060000
nn_kernel_gpu_mem,61052,1,1,375469,128,384480000,192240000,192240000,384480000,1,48060000
nn_kernel_cpu,25164,0,1,1,64,0,0,0,0,1,48070000
nn_kernel_gpu,2884,1,1,375547,128,0,0,0,0,1,48070000
nn_kernel_gpu_mem,70824,1,1,375547,128,384560000,192280000,192280000,384560000,1,48070000
nn_kernel_cpu,38120,0,1,1,64,0,0,0,0,1,48080000
nn_kernel_gpu,2839,1,1,375625,128,0,0,0,0,1,48080000
nn_kernel_gpu_mem,71203,1,1,375625,128,384640000,192320000,192320000,384640000,1,48080000
nn_kernel_cpu,21296,0,1,1,64,0,0,0,0,1,48090000
nn_kernel_gpu,2838,1,1,375704,128,0,0,0,0,1,48090000
nn_kernel_gpu_mem,71294,1,1,375704,128,384720000,192360000,192360000,384720000,1,48090000
nn_kernel_cpu,27469,0,1,1,64,0,0,0,0,1,48100000
nn_kernel_gpu,2843,1,1,375782,128,0,0,0,0,1,48100000
nn_kernel_gpu_mem,71086,1,1,375782,128,384800000,192400000,192400000,384800000,1,48100000
nn_kernel_cpu,4726,0,1,1,64,0,0,0,0,1,4810000
nn_kernel_gpu,342,1,1,37579,128,0,0,0,0,1,4810000
nn_kernel_gpu_mem,6976,1,1,37579,128,38480000,19240000,19240000,38480000,1,4810000
nn_kernel_cpu,14147,0,1,1,64,0,0,0,0,1,48110000
nn_kernel_gpu,2842,1,1,375860,128,0,0,0,0,1,48110000
nn_kernel_gpu_mem,69717,1,1,375860,128,384880000,192440000,192440000,384880000,1,48110000
nn_kernel_cpu,25755,0,1,1,64,0,0,0,0,1,48120000
nn_kernel_gpu,2897,1,1,375938,128,0,0,0,0,1,48120000
nn_kernel_gpu_mem,70311,1,1,375938,128,384960000,192480000,192480000,384960000,1,48120000
nn_kernel_cpu,21293,0,1,1,64,0,0,0,0,1,48130000
nn_kernel_gpu,2835,1,1,376016,128,0,0,0,0,1,48130000
nn_kernel_gpu_mem,56611,1,1,376016,128,385040000,192520000,192520000,385040000,1,48130000
nn_kernel_cpu,16710,0,1,1,64,0,0,0,0,1,48140000
nn_kernel_gpu,2884,1,1,376094,128,0,0,0,0,1,48140000
nn_kernel_gpu_mem,60677,1,1,376094,128,385120000,192560000,192560000,385120000,1,48140000
nn_kernel_cpu,26780,0,1,1,64,0,0,0,0,1,48150000
nn_kernel_gpu,2840,1,1,376172,128,0,0,0,0,1,48150000
nn_kernel_gpu_mem,70247,1,1,376172,128,385200000,192600000,192600000,385200000,1,48150000
nn_kernel_cpu,32235,0,1,1,64,0,0,0,0,1,48160000
nn_kernel_gpu,2839,1,1,376250,128,0,0,0,0,1,48160000
nn_kernel_gpu_mem,67612,1,1,376250,128,385280000,192640000,192640000,385280000,1,48160000
nn_kernel_cpu,18943,0,1,1,64,0,0,0,0,1,48170000
nn_kernel_gpu,2891,1,1,376329,128,0,0,0,0,1,48170000
nn_kernel_gpu_mem,70073,1,1,376329,128,385360000,192680000,192680000,385360000,1,48170000
nn_kernel_cpu,38168,0,1,1,64,0,0,0,0,1,48180000
nn_kernel_gpu,2842,1,1,376407,128,0,0,0,0,1,48180000
nn_kernel_gpu_mem,57439,1,1,376407,128,385440000,192720000,192720000,385440000,1,48180000
nn_kernel_cpu,26752,0,1,1,64,0,0,0,0,1,48190000
nn_kernel_gpu,2843,1,1,376485,128,0,0,0,0,1,48190000
nn_kernel_gpu_mem,62408,1,1,376485,128,385520000,192760000,192760000,385520000,1,48190000
nn_kernel_cpu,24390,0,1,1,64,0,0,0,0,1,48200000
nn_kernel_gpu,2845,1,1,376563,128,0,0,0,0,1,48200000
nn_kernel_gpu_mem,60254,1,1,376563,128,385600000,192800000,192800000,385600000,1,48200000
nn_kernel_cpu,20109,0,1,1,64,0,0,0,0,1,4820000
nn_kernel_gpu,333,1,1,37657,128,0,0,0,0,1,4820000
nn_kernel_gpu_mem,7292,1,1,37657,128,38560000,19280000,19280000,38560000,1,4820000
nn_kernel_cpu,15254,0,1,1,64,0,0,0,0,1,48210000
nn_kernel_gpu,2841,1,1,376641,128,0,0,0,0,1,48210000
nn_kernel_gpu_mem,56567,1,1,376641,128,385680000,192840000,192840000,385680000,1,48210000
nn_kernel_cpu,17547,0,1,1,64,0,0,0,0,1,48220000
nn_kernel_gpu,2842,1,1,376719,128,0,0,0,0,1,48220000
nn_kernel_gpu_mem,58817,1,1,376719,128,385760000,192880000,192880000,385760000,1,48220000
nn_kernel_cpu,32489,0,1,1,64,0,0,0,0,1,48230000
nn_kernel_gpu,2841,1,1,376797,128,0,0,0,0,1,48230000
nn_kernel_gpu_mem,79069,1,1,376797,128,385840000,192920000,192920000,385840000,1,48230000
nn_kernel_cpu,25054,0,1,1,64,0,0,0,0,1,48240000
nn_kernel_gpu,2890,1,1,376875,128,0,0,0,0,1,48240000
nn_kernel_gpu_mem,71439,1,1,376875,128,385920000,192960000,192960000,385920000,1,48240000
nn_kernel_cpu,34157,0,1,1,64,0,0,0,0,1,48250000
nn_kernel_gpu,2838,1,1,376954,128,0,0,0,0,1,48250000
nn_kernel_gpu_mem,69627,1,1,376954,128,386000000,193000000,193000000,386000000,1,48250000
nn_kernel_cpu,33880,0,1,1,64,0,0,0,0,1,48260000
nn_kernel_gpu,2836,1,1,377032,128,0,0,0,0,1,48260000
nn_kernel_gpu_mem,61693,1,1,377032,128,386080000,193040000,193040000,386080000,1,48260000
nn_kernel_cpu,25666,0,1,1,64,0,0,0,0,1,48270000
nn_kernel_gpu,2887,1,1,377110,128,0,0,0,0,1,48270000
nn_kernel_gpu_mem,72207,1,1,377110,128,386160000,193080000,193080000,386160000,1,48270000
nn_kernel_cpu,18289,0,1,1,64,0,0,0,0,1,48280000
nn_kernel_gpu,2835,1,1,377188,128,0,0,0,0,1,48280000
nn_kernel_gpu_mem,57463,1,1,377188,128,386240000,193120000,193120000,386240000,1,48280000
nn_kernel_cpu,15316,0,1,1,64,0,0,0,0,1,48290000
nn_kernel_gpu,2850,1,1,377266,128,0,0,0,0,1,48290000
nn_kernel_gpu_mem,66372,1,1,377266,128,386320000,193160000,193160000,386320000,1,48290000
nn_kernel_cpu,23985,0,1,1,64,0,0,0,0,1,48300000
nn_kernel_gpu,2840,1,1,377344,128,0,0,0,0,1,48300000
nn_kernel_gpu_mem,58294,1,1,377344,128,386400000,193200000,193200000,386400000,1,48300000
nn_kernel_cpu,23318,0,1,1,64,0,0,0,0,1,4830000
nn_kernel_gpu,339,1,1,37735,128,0,0,0,0,1,4830000
nn_kernel_gpu_mem,6969,1,1,37735,128,38640000,19320000,19320000,38640000,1,4830000
nn_kernel_cpu,16676,0,1,1,64,0,0,0,0,1,48310000
nn_kernel_gpu,2841,1,1,377422,128,0,0,0,0,1,48310000
nn_kernel_gpu_mem,70501,1,1,377422,128,386480000,193240000,193240000,386480000,1,48310000
nn_kernel_cpu,63001,0,1,1,64,0,0,0,0,1,48320000
nn_kernel_gpu,2846,1,1,377500,128,0,0,0,0,1,48320000
nn_kernel_gpu_mem,70575,1,1,377500,128,386560000,193280000,193280000,386560000,1,48320000
nn_kernel_cpu,26645,0,1,1,64,0,0,0,0,1,48330000
nn_kernel_gpu,2842,1,1,377579,128,0,0,0,0,1,48330000
nn_kernel_gpu_mem,66584,1,1,377579,128,386640000,193320000,193320000,386640000,1,48330000
nn_kernel_cpu,21334,0,1,1,64,0,0,0,0,1,48340000
nn_kernel_gpu,2840,1,1,377657,128,0,0,0,0,1,48340000
nn_kernel_gpu_mem,73060,1,1,377657,128,386720000,193360000,193360000,386720000,1,48340000
nn_kernel_cpu,26847,0,1,1,64,0,0,0,0,1,48350000
nn_kernel_gpu,2887,1,1,377735,128,0,0,0,0,1,48350000
nn_kernel_gpu_mem,70615,1,1,377735,128,386800000,193400000,193400000,386800000,1,48350000
nn_kernel_cpu,29925,0,1,1,64,0,0,0,0,1,48360000
nn_kernel_gpu,2894,1,1,377813,128,0,0,0,0,1,48360000
nn_kernel_gpu_mem,61181,1,1,377813,128,386880000,193440000,193440000,386880000,1,48360000
nn_kernel_cpu,14035,0,1,1,64,0,0,0,0,1,48370000
nn_kernel_gpu,2888,1,1,377891,128,0,0,0,0,1,48370000
nn_kernel_gpu_mem,70946,1,1,377891,128,386960000,193480000,193480000,386960000,1,48370000
nn_kernel_cpu,25607,0,1,1,64,0,0,0,0,1,48380000
nn_kernel_gpu,2847,1,1,377969,128,0,0,0,0,1,48380000
nn_kernel_gpu_mem,71320,1,1,377969,128,387040000,193520000,193520000,387040000,1,48380000
nn_kernel_cpu,27321,0,1,1,64,0,0,0,0,1,48390000
nn_kernel_gpu,2894,1,1,378047,128,0,0,0,0,1,48390000
nn_kernel_gpu_mem,72954,1,1,378047,128,387120000,193560000,193560000,387120000,1,48390000
nn_kernel_cpu,25592,0,1,1,64,0,0,0,0,1,48400000
nn_kernel_gpu,2843,1,1,378125,128,0,0,0,0,1,48400000
nn_kernel_gpu_mem,70736,1,1,378125,128,387200000,193600000,193600000,387200000,1,48400000
nn_kernel_cpu,23230,0,1,1,64,0,0,0,0,1,4840000
nn_kernel_gpu,345,1,1,37813,128,0,0,0,0,1,4840000
nn_kernel_gpu_mem,6942,1,1,37813,128,38720000,19360000,19360000,38720000,1,4840000
nn_kernel_cpu,23731,0,1,1,64,0,0,0,0,1,48410000
nn_kernel_gpu,2836,1,1,378204,128,0,0,0,0,1,48410000
nn_kernel_gpu_mem,71413,1,1,378204,128,387280000,193640000,193640000,387280000,1,48410000
nn_kernel_cpu,21662,0,1,1,64,0,0,0,0,1,48420000
nn_kernel_gpu,2843,1,1,378282,128,0,0,0,0,1,48420000
nn_kernel_gpu_mem,57467,1,1,378282,128,387360000,193680000,193680000,387360000,1,48420000
nn_kernel_cpu,14111,0,1,1,64,0,0,0,0,1,48430000
nn_kernel_gpu,2854,1,1,378360,128,0,0,0,0,1,48430000
nn_kernel_gpu_mem,71145,1,1,378360,128,387440000,193720000,193720000,387440000,1,48430000
nn_kernel_cpu,21535,0,1,1,64,0,0,0,0,1,48440000
nn_kernel_gpu,2889,1,1,378438,128,0,0,0,0,1,48440000
nn_kernel_gpu_mem,70937,1,1,378438,128,387520000,193760000,193760000,387520000,1,48440000
nn_kernel_cpu,19695,0,1,1,64,0,0,0,0,1,48450000
nn_kernel_gpu,2848,1,1,378516,128,0,0,0,0,1,48450000
nn_kernel_gpu_mem,71086,1,1,378516,128,387600000,193800000,193800000,387600000,1,48450000
nn_kernel_cpu,23928,0,1,1,64,0,0,0,0,1,48460000
nn_kernel_gpu,2851,1,1,378594,128,0,0,0,0,1,48460000
nn_kernel_gpu_mem,60254,1,1,378594,128,387680000,193840000,193840000,387680000,1,48460000
nn_kernel_cpu,27945,0,1,1,64,0,0,0,0,1,48470000
nn_kernel_gpu,2846,1,1,378672,128,0,0,0,0,1,48470000
nn_kernel_gpu_mem,59400,1,1,378672,128,387760000,193880000,193880000,387760000,1,48470000
nn_kernel_cpu,30447,0,1,1,64,0,0,0,0,1,48480000
nn_kernel_gpu,2862,1,1,378750,128,0,0,0,0,1,48480000
nn_kernel_gpu_mem,71527,1,1,378750,128,387840000,193920000,193920000,387840000,1,48480000
nn_kernel_cpu,24726,0,1,1,64,0,0,0,0,1,48490000
nn_kernel_gpu,2853,1,1,378829,128,0,0,0,0,1,48490000
nn_kernel_gpu_mem,64888,1,1,378829,128,387920000,193960000,193960000,387920000,1,48490000
nn_kernel_cpu,30398,0,1,1,64,0,0,0,0,1,48500000
nn_kernel_gpu,2902,1,1,378907,128,0,0,0,0,1,48500000
nn_kernel_gpu_mem,70741,1,1,378907,128,388000000,194000000,194000000,388000000,1,48500000
nn_kernel_cpu,36017,0,1,1,64,0,0,0,0,1,4850000
nn_kernel_gpu,341,1,1,37891,128,0,0,0,0,1,4850000
nn_kernel_gpu_mem,7102,1,1,37891,128,38800000,19400000,19400000,38800000,1,4850000
nn_kernel_cpu,18690,0,1,1,64,0,0,0,0,1,48510000
nn_kernel_gpu,2853,1,1,378985,128,0,0,0,0,1,48510000
nn_kernel_gpu_mem,71153,1,1,378985,128,388080000,194040000,194040000,388080000,1,48510000
nn_kernel_cpu,27141,0,1,1,64,0,0,0,0,1,48520000
nn_kernel_gpu,2899,1,1,379063,128,0,0,0,0,1,48520000
nn_kernel_gpu_mem,69976,1,1,379063,128,388160000,194080000,194080000,388160000,1,48520000
nn_kernel_cpu,30609,0,1,1,64,0,0,0,0,1,48530000
nn_kernel_gpu,2848,1,1,379141,128,0,0,0,0,1,48530000
nn_kernel_gpu_mem,64222,1,1,379141,128,388240000,194120000,194120000,388240000,1,48530000
nn_kernel_cpu,14730,0,1,1,64,0,0,0,0,1,48540000
nn_kernel_gpu,2860,1,1,379219,128,0,0,0,0,1,48540000
nn_kernel_gpu_mem,70799,1,1,379219,128,388320000,194160000,194160000,388320000,1,48540000
nn_kernel_cpu,18403,0,1,1,64,0,0,0,0,1,48550000
nn_kernel_gpu,2858,1,1,379297,128,0,0,0,0,1,48550000
nn_kernel_gpu_mem,60112,1,1,379297,128,388400000,194200000,194200000,388400000,1,48550000
nn_kernel_cpu,14570,0,1,1,64,0,0,0,0,1,48560000
nn_kernel_gpu,2905,1,1,379375,128,0,0,0,0,1,48560000
nn_kernel_gpu_mem,56433,1,1,379375,128,388480000,194240000,194240000,388480000,1,48560000
nn_kernel_cpu,15001,0,1,1,64,0,0,0,0,1,48570000
nn_kernel_gpu,2858,1,1,379454,128,0,0,0,0,1,48570000
nn_kernel_gpu_mem,71605,1,1,379454,128,388560000,194280000,194280000,388560000,1,48570000
nn_kernel_cpu,20858,0,1,1,64,0,0,0,0,1,48580000
nn_kernel_gpu,2853,1,1,379532,128,0,0,0,0,1,48580000
nn_kernel_gpu_mem,56543,1,1,379532,128,388640000,194320000,194320000,388640000,1,48580000
nn_kernel_cpu,18583,0,1,1,64,0,0,0,0,1,48590000
nn_kernel_gpu,2860,1,1,379610,128,0,0,0,0,1,48590000
nn_kernel_gpu_mem,71936,1,1,379610,128,388720000,194360000,194360000,388720000,1,48590000
nn_kernel_cpu,35135,0,1,1,64,0,0,0,0,1,48600000
nn_kernel_gpu,2861,1,1,379688,128,0,0,0,0,1,48600000
nn_kernel_gpu_mem,70965,1,1,379688,128,388800000,194400000,194400000,388800000,1,48600000
nn_kernel_cpu,15741,0,1,1,64,0,0,0,0,1,4860000
nn_kernel_gpu,341,1,1,37969,128,0,0,0,0,1,4860000
nn_kernel_gpu_mem,7954,1,1,37969,128,38880000,19440000,19440000,38880000,1,4860000
nn_kernel_cpu,10728,0,1,1,64,0,0,0,0,1,48610000
nn_kernel_gpu,2862,1,1,379766,128,0,0,0,0,1,48610000
nn_kernel_gpu_mem,70918,1,1,379766,128,388880000,194440000,194440000,388880000,1,48610000
nn_kernel_cpu,17072,0,1,1,64,0,0,0,0,1,48620000
nn_kernel_gpu,2856,1,1,379844,128,0,0,0,0,1,48620000
nn_kernel_gpu_mem,72470,1,1,379844,128,388960000,194480000,194480000,388960000,1,48620000
nn_kernel_cpu,20716,0,1,1,64,0,0,0,0,1,48630000
nn_kernel_gpu,2902,1,1,379922,128,0,0,0,0,1,48630000
nn_kernel_gpu_mem,70172,1,1,379922,128,389040000,194520000,194520000,389040000,1,48630000
nn_kernel_cpu,24751,0,1,1,64,0,0,0,0,1,48640000
nn_kernel_gpu,2861,1,1,380000,128,0,0,0,0,1,48640000
nn_kernel_gpu_mem,69912,1,1,380000,128,389120000,194560000,194560000,389120000,1,48640000
nn_kernel_cpu,23541,0,1,1,64,0,0,0,0,1,48650000
nn_kernel_gpu,2864,1,1,380079,128,0,0,0,0,1,48650000
nn_kernel_gpu_mem,61155,1,1,380079,128,389200000,194600000,194600000,389200000,1,48650000
nn_kernel_cpu,15632,0,1,1,64,0,0,0,0,1,48660000
nn_kernel_gpu,2913,1,1,380157,128,0,0,0,0,1,48660000
nn_kernel_gpu_mem,70712,1,1,380157,128,389280000,194640000,194640000,389280000,1,48660000
nn_kernel_cpu,48744,0,1,1,64,0,0,0,0,1,48670000
nn_kernel_gpu,2860,1,1,380235,128,0,0,0,0,1,48670000
nn_kernel_gpu_mem,55602,1,1,380235,128,389360000,194680000,194680000,389360000,1,48670000
nn_kernel_cpu,12303,0,1,1,64,0,0,0,0,1,48680000
nn_kernel_gpu,2867,1,1,380313,128,0,0,0,0,1,48680000
nn_kernel_gpu_mem,76357,1,1,380313,128,389440000,194720000,194720000,389440000,1,48680000
nn_kernel_cpu,18395,0,1,1,64,0,0,0,0,1,48690000
nn_kernel_gpu,3186,1,1,380391,128,0,0,0,0,1,48690000
nn_kernel_gpu_mem,57299,1,1,380391,128,389520000,194760000,194760000,389520000,1,48690000
nn_kernel_cpu,17431,0,1,1,64,0,0,0,0,1,48700000
nn_kernel_gpu,2859,1,1,380469,128,0,0,0,0,1,48700000
nn_kernel_gpu_mem,70174,1,1,380469,128,389600000,194800000,194800000,389600000,1,48700000
nn_kernel_cpu,35998,0,1,1,64,0,0,0,0,1,4870000
nn_kernel_gpu,339,1,1,38047,128,0,0,0,0,1,4870000
nn_kernel_gpu_mem,7007,1,1,38047,128,38960000,19480000,19480000,38960000,1,4870000
nn_kernel_cpu,31547,0,1,1,64,0,0,0,0,1,48710000
nn_kernel_gpu,2878,1,1,380547,128,0,0,0,0,1,48710000
nn_kernel_gpu_mem,71160,1,1,380547,128,389680000,194840000,194840000,389680000,1,48710000
nn_kernel_cpu,32683,0,1,1,64,0,0,0,0,1,48720000
nn_kernel_gpu,2862,1,1,380625,128,0,0,0,0,1,48720000
nn_kernel_gpu_mem,63200,1,1,380625,128,389760000,194880000,194880000,389760000,1,48720000
nn_kernel_cpu,31177,0,1,1,64,0,0,0,0,1,48730000
nn_kernel_gpu,2906,1,1,380704,128,0,0,0,0,1,48730000
nn_kernel_gpu_mem,61571,1,1,380704,128,389840000,194920000,194920000,389840000,1,48730000
nn_kernel_cpu,20069,0,1,1,64,0,0,0,0,1,48740000
nn_kernel_gpu,2912,1,1,380782,128,0,0,0,0,1,48740000
nn_kernel_gpu_mem,68606,1,1,380782,128,389920000,194960000,194960000,389920000,1,48740000
nn_kernel_cpu,18994,0,1,1,64,0,0,0,0,1,48750000
nn_kernel_gpu,2867,1,1,380860,128,0,0,0,0,1,48750000
nn_kernel_gpu_mem,57707,1,1,380860,128,390000000,195000000,195000000,390000000,1,48750000
nn_kernel_cpu,14306,0,1,1,64,0,0,0,0,1,48760000
nn_kernel_gpu,2869,1,1,380938,128,0,0,0,0,1,48760000
nn_kernel_gpu_mem,73251,1,1,380938,128,390080000,195040000,195040000,390080000,1,48760000
nn_kernel_cpu,30312,0,1,1,64,0,0,0,0,1,48770000
nn_kernel_gpu,2866,1,1,381016,128,0,0,0,0,1,48770000
nn_kernel_gpu_mem,64284,1,1,381016,128,390160000,195080000,195080000,390160000,1,48770000
nn_kernel_cpu,24716,0,1,1,64,0,0,0,0,1,48780000
nn_kernel_gpu,2886,1,1,381094,128,0,0,0,0,1,48780000
nn_kernel_gpu_mem,70598,1,1,381094,128,390240000,195120000,195120000,390240000,1,48780000
nn_kernel_cpu,18100,0,1,1,64,0,0,0,0,1,48790000
nn_kernel_gpu,2870,1,1,381172,128,0,0,0,0,1,48790000
nn_kernel_gpu_mem,71857,1,1,381172,128,390320000,195160000,195160000,390320000,1,48790000
nn_kernel_cpu,21220,0,1,1,64,0,0,0,0,1,48800000
nn_kernel_gpu,2874,1,1,381250,128,0,0,0,0,1,48800000
nn_kernel_gpu_mem,58739,1,1,381250,128,390400000,195200000,195200000,390400000,1,48800000
nn_kernel_cpu,8287,0,1,1,64,0,0,0,0,1,4880000
nn_kernel_gpu,347,1,1,38125,128,0,0,0,0,1,4880000
nn_kernel_gpu_mem,7317,1,1,38125,128,39040000,19520000,19520000,39040000,1,4880000
nn_kernel_cpu,28069,0,1,1,64,0,0,0,0,1,48810000
nn_kernel_gpu,2887,1,1,381329,128,0,0,0,0,1,48810000
nn_kernel_gpu_mem,55966,1,1,381329,128,390480000,195240000,195240000,390480000,1,48810000
nn_kernel_cpu,54177,0,1,1,64,0,0,0,0,1,48820000
nn_kernel_gpu,2867,1,1,381407,128,0,0,0,0,1,48820000
nn_kernel_gpu_mem,71276,1,1,381407,128,390560000,195280000,195280000,390560000,1,48820000
nn_kernel_cpu,44972,0,1,1,64,0,0,0,0,1,48830000
nn_kernel_gpu,2889,1,1,381485,128,0,0,0,0,1,48830000
nn_kernel_gpu_mem,56254,1,1,381485,128,390640000,195320000,195320000,390640000,1,48830000
nn_kernel_cpu,27126,0,1,1,64,0,0,0,0,1,48840000
nn_kernel_gpu,2924,1,1,381563,128,0,0,0,0,1,48840000
nn_kernel_gpu_mem,71756,1,1,381563,128,390720000,195360000,195360000,390720000,1,48840000
nn_kernel_cpu,24059,0,1,1,64,0,0,0,0,1,48850000
nn_kernel_gpu,2876,1,1,381641,128,0,0,0,0,1,48850000
nn_kernel_gpu_mem,71707,1,1,381641,128,390800000,195400000,195400000,390800000,1,48850000
nn_kernel_cpu,27988,0,1,1,64,0,0,0,0,1,48860000
nn_kernel_gpu,2877,1,1,381719,128,0,0,0,0,1,48860000
nn_kernel_gpu_mem,72391,1,1,381719,128,390880000,195440000,195440000,390880000,1,48860000
nn_kernel_cpu,30464,0,1,1,64,0,0,0,0,1,48870000
nn_kernel_gpu,2930,1,1,381797,128,0,0,0,0,1,48870000
nn_kernel_gpu_mem,60780,1,1,381797,128,390960000,195480000,195480000,390960000,1,48870000
nn_kernel_cpu,25797,0,1,1,64,0,0,0,0,1,48880000
nn_kernel_gpu,2885,1,1,381875,128,0,0,0,0,1,48880000
nn_kernel_gpu_mem,56193,1,1,381875,128,391040000,195520000,195520000,391040000,1,48880000
nn_kernel_cpu,21563,0,1,1,64,0,0,0,0,1,48890000
nn_kernel_gpu,2920,1,1,381954,128,0,0,0,0,1,48890000
nn_kernel_gpu_mem,60751,1,1,381954,128,391120000,195560000,195560000,391120000,1,48890000
nn_kernel_cpu,21858,0,1,1,64,0,0,0,0,1,48900000
nn_kernel_gpu,2873,1,1,382032,128,0,0,0,0,1,48900000
nn_kernel_gpu_mem,56055,1,1,382032,128,391200000,195600000,195600000,391200000,1,48900000
nn_kernel_cpu,6852,0,1,1,64,0,0,0,0,1,4890000
nn_kernel_gpu,346,1,1,38204,128,0,0,0,0,1,4890000
nn_kernel_gpu_mem,7000,1,1,38204,128,39120000,19560000,19560000,39120000,1,4890000
nn_kernel_cpu,25556,0,1,1,64,0,0,0,0,1,48910000
nn_kernel_gpu,2875,1,1,382110,128,0,0,0,0,1,48910000
nn_kernel_gpu_mem,67265,1,1,382110,128,391280000,195640000,195640000,391280000,1,48910000
nn_kernel_cpu,31268,0,1,1,64,0,0,0,0,1,48920000
nn_kernel_gpu,2877,1,1,382188,128,0,0,0,0,1,48920000
nn_kernel_gpu_mem,70718,1,1,382188,128,391360000,195680000,195680000,391360000,1,48920000
nn_kernel_cpu,28839,0,1,1,64,0,0,0,0,1,48930000
nn_kernel_gpu,2925,1,1,382266,128,0,0,0,0,1,48930000
nn_kernel_gpu_mem,61449,1,1,382266,128,391440000,195720000,195720000,391440000,1,48930000
nn_kernel_cpu,26212,0,1,1,64,0,0,0,0,1,48940000
nn_kernel_gpu,2918,1,1,382344,128,0,0,0,0,1,48940000
nn_kernel_gpu_mem,61083,1,1,382344,128,391520000,195760000,195760000,391520000,1,48940000
nn_kernel_cpu,25669,0,1,1,64,0,0,0,0,1,48950000
nn_kernel_gpu,2876,1,1,382422,128,0,0,0,0,1,48950000
nn_kernel_gpu_mem,61286,1,1,382422,128,391600000,195800000,195800000,391600000,1,48950000
nn_kernel_cpu,37757,0,1,1,64,0,0,0,0,1,48960000
nn_kernel_gpu,2889,1,1,382500,128,0,0,0,0,1,48960000
nn_kernel_gpu_mem,60312,1,1,382500,128,391680000,195840000,195840000,391680000,1,48960000
nn_kernel_cpu,23728,0,1,1,64,0,0,0,0,1,48970000
nn_kernel_gpu,2884,1,1,382579,128,0,0,0,0,1,48970000
nn_kernel_gpu_mem,61824,1,1,382579,128,391760000,195880000,195880000,391760000,1,48970000
nn_kernel_cpu,17410,0,1,1,64,0,0,0,0,1,48980000
nn_kernel_gpu,2887,1,1,382657,128,0,0,0,0,1,48980000
nn_kernel_gpu_mem,70599,1,1,382657,128,391840000,195920000,195920000,391840000,1,48980000
nn_kernel_cpu,19236,0,1,1,64,0,0,0,0,1,48990000
nn_kernel_gpu,2878,1,1,382735,128,0,0,0,0,1,48990000
nn_kernel_gpu_mem,72142,1,1,382735,128,391920000,195960000,195960000,391920000,1,48990000
nn_kernel_cpu,44406,0,1,1,64,0,0,0,0,1,49000000
nn_kernel_gpu,2942,1,1,382813,128,0,0,0,0,1,49000000
nn_kernel_gpu_mem,62032,1,1,382813,128,392000000,196000000,196000000,392000000,1,49000000
nn_kernel_cpu,27447,0,1,1,64,0,0,0,0,1,4900000
nn_kernel_gpu,328,1,1,38282,128,0,0,0,0,1,4900000
nn_kernel_gpu_mem,6738,1,1,38282,128,39200000,19600000,19600000,39200000,1,4900000
nn_kernel_cpu,12671,0,1,1,64,0,0,0,0,1,490000
nn_kernel_gpu,84,1,1,3829,128,0,0,0,0,1,490000
nn_kernel_gpu_mem,2809,1,1,3829,128,3920000,1960000,1960000,3920000,1,490000
nn_kernel_cpu,25810,0,1,1,64,0,0,0,0,1,49010000
nn_kernel_gpu,2897,1,1,382891,128,0,0,0,0,1,49010000
nn_kernel_gpu_mem,73687,1,1,382891,128,392080000,196040000,196040000,392080000,1,49010000
nn_kernel_cpu,27890,0,1,1,64,0,0,0,0,1,49020000
nn_kernel_gpu,2885,1,1,382969,128,0,0,0,0,1,49020000
nn_kernel_gpu_mem,63864,1,1,382969,128,392160000,196080000,196080000,392160000,1,49020000
nn_kernel_cpu,40777,0,1,1,64,0,0,0,0,1,49030000
nn_kernel_gpu,2872,1,1,383047,128,0,0,0,0,1,49030000
nn_kernel_gpu_mem,58480,1,1,383047,128,392240000,196120000,196120000,392240000,1,49030000
nn_kernel_cpu,33168,0,1,1,64,0,0,0,0,1,49040000
nn_kernel_gpu,2880,1,1,383125,128,0,0,0,0,1,49040000
nn_kernel_gpu_mem,72575,1,1,383125,128,392320000,196160000,196160000,392320000,1,49040000
nn_kernel_cpu,31257,0,1,1,64,0,0,0,0,1,49050000
nn_kernel_gpu,2878,1,1,383204,128,0,0,0,0,1,49050000
nn_kernel_gpu_mem,57958,1,1,383204,128,392400000,196200000,196200000,392400000,1,49050000
nn_kernel_cpu,26032,0,1,1,64,0,0,0,0,1,49060000
nn_kernel_gpu,2936,1,1,383282,128,0,0,0,0,1,49060000
nn_kernel_gpu_mem,61370,1,1,383282,128,392480000,196240000,196240000,392480000,1,49060000
nn_kernel_cpu,25197,0,1,1,64,0,0,0,0,1,49070000
nn_kernel_gpu,2939,1,1,383360,128,0,0,0,0,1,49070000
nn_kernel_gpu_mem,73789,1,1,383360,128,392560000,196280000,196280000,392560000,1,49070000
nn_kernel_cpu,26221,0,1,1,64,0,0,0,0,1,49080000
nn_kernel_gpu,2885,1,1,383438,128,0,0,0,0,1,49080000
nn_kernel_gpu_mem,73286,1,1,383438,128,392640000,196320000,196320000,392640000,1,49080000
nn_kernel_cpu,25216,0,1,1,64,0,0,0,0,1,49090000
nn_kernel_gpu,2903,1,1,383516,128,0,0,0,0,1,49090000
nn_kernel_gpu_mem,62564,1,1,383516,128,392720000,196360000,196360000,392720000,1,49090000
nn_kernel_cpu,25942,0,1,1,64,0,0,0,0,1,49100000
nn_kernel_gpu,2902,1,1,383594,128,0,0,0,0,1,49100000
nn_kernel_gpu_mem,67334,1,1,383594,128,392800000,196400000,196400000,392800000,1,49100000
nn_kernel_cpu,25566,0,1,1,64,0,0,0,0,1,4910000
nn_kernel_gpu,326,1,1,38360,128,0,0,0,0,1,4910000
nn_kernel_gpu_mem,7164,1,1,38360,128,39280000,19640000,19640000,39280000,1,4910000
nn_kernel_cpu,20451,0,1,1,64,0,0,0,0,1,49110000
nn_kernel_gpu,2884,1,1,383672,128,0,0,0,0,1,49110000
nn_kernel_gpu_mem,73276,1,1,383672,128,392880000,196440000,196440000,392880000,1,49110000
nn_kernel_cpu,29740,0,1,1,64,0,0,0,0,1,49120000
nn_kernel_gpu,2936,1,1,383750,128,0,0,0,0,1,49120000
nn_kernel_gpu_mem,71641,1,1,383750,128,392960000,196480000,196480000,392960000,1,49120000
nn_kernel_cpu,28245,0,1,1,64,0,0,0,0,1,49130000
nn_kernel_gpu,2891,1,1,383829,128,0,0,0,0,1,49130000
nn_kernel_gpu_mem,63119,1,1,383829,128,393040000,196520000,196520000,393040000,1,49130000
nn_kernel_cpu,16644,0,1,1,64,0,0,0,0,1,49140000
nn_kernel_gpu,2903,1,1,383907,128,0,0,0,0,1,49140000
nn_kernel_gpu_mem,61559,1,1,383907,128,393120000,196560000,196560000,393120000,1,49140000
nn_kernel_cpu,17463,0,1,1,64,0,0,0,0,1,49150000
nn_kernel_gpu,2887,1,1,383985,128,0,0,0,0,1,49150000
nn_kernel_gpu_mem,67314,1,1,383985,128,393200000,196600000,196600000,393200000,1,49150000
nn_kernel_cpu,25374,0,1,1,64,0,0,0,0,1,49160000
nn_kernel_gpu,2895,1,1,384063,128,0,0,0,0,1,49160000
nn_kernel_gpu_mem,73109,1,1,384063,128,393280000,196640000,196640000,393280000,1,49160000
nn_kernel_cpu,17629,0,1,1,64,0,0,0,0,1,49170000
nn_kernel_gpu,2897,1,1,384141,128,0,0,0,0,1,49170000
nn_kernel_gpu_mem,70818,1,1,384141,128,393360000,196680000,196680000,393360000,1,49170000
nn_kernel_cpu,16018,0,1,1,64,0,0,0,0,1,49180000
nn_kernel_gpu,2936,1,1,384219,128,0,0,0,0,1,49180000
nn_kernel_gpu_mem,62087,1,1,384219,128,393440000,196720000,196720000,393440000,1,49180000
nn_kernel_cpu,24065,0,1,1,64,0,0,0,0,1,49190000
nn_kernel_gpu,2896,1,1,384297,128,0,0,0,0,1,49190000
nn_kernel_gpu_mem,61732,1,1,384297,128,393520000,196760000,196760000,393520000,1,49190000
nn_kernel_cpu,29057,0,1,1,64,0,0,0,0,1,49200000
nn_kernel_gpu,2893,1,1,384375,128,0,0,0,0,1,49200000
nn_kernel_gpu_mem,72443,1,1,384375,128,393600000,196800000,196800000,393600000,1,49200000
nn_kernel_cpu,8112,0,1,1,64,0,0,0,0,1,4920000
nn_kernel_gpu,327,1,1,38438,128,0,0,0,0,1,4920000
nn_kernel_gpu_mem,7378,1,1,38438,128,39360000,19680000,19680000,39360000,1,4920000
nn_kernel_cpu,28746,0,1,1,64,0,0,0,0,1,49210000
nn_kernel_gpu,2885,1,1,384454,128,0,0,0,0,1,49210000
nn_kernel_gpu_mem,58848,1,1,384454,128,393680000,196840000,196840000,393680000,1,49210000
nn_kernel_cpu,28274,0,1,1,64,0,0,0,0,1,49220000
nn_kernel_gpu,2885,1,1,384532,128,0,0,0,0,1,49220000
nn_kernel_gpu_mem,75097,1,1,384532,128,393760000,196880000,196880000,393760000,1,49220000
nn_kernel_cpu,21799,0,1,1,64,0,0,0,0,1,49230000
nn_kernel_gpu,2909,1,1,384610,128,0,0,0,0,1,49230000
nn_kernel_gpu_mem,74658,1,1,384610,128,393840000,196920000,196920000,393840000,1,49230000
nn_kernel_cpu,14720,0,1,1,64,0,0,0,0,1,49240000
nn_kernel_gpu,2955,1,1,384688,128,0,0,0,0,1,49240000
nn_kernel_gpu_mem,61474,1,1,384688,128,393920000,196960000,196960000,393920000,1,49240000
nn_kernel_cpu,22168,0,1,1,64,0,0,0,0,1,49250000
nn_kernel_gpu,2910,1,1,384766,128,0,0,0,0,1,49250000
nn_kernel_gpu_mem,72508,1,1,384766,128,394000000,197000000,197000000,394000000,1,49250000
nn_kernel_cpu,27244,0,1,1,64,0,0,0,0,1,49260000
nn_kernel_gpu,2949,1,1,384844,128,0,0,0,0,1,49260000
nn_kernel_gpu_mem,73367,1,1,384844,128,394080000,197040000,197040000,394080000,1,49260000
nn_kernel_cpu,22460,0,1,1,64,0,0,0,0,1,49270000
nn_kernel_gpu,2923,1,1,384922,128,0,0,0,0,1,49270000
nn_kernel_gpu_mem,63615,1,1,384922,128,394160000,197080000,197080000,394160000,1,49270000
nn_kernel_cpu,17465,0,1,1,64,0,0,0,0,1,49280000
nn_kernel_gpu,2911,1,1,385000,128,0,0,0,0,1,49280000
nn_kernel_gpu_mem,71897,1,1,385000,128,394240000,197120000,197120000,394240000,1,49280000
nn_kernel_cpu,27439,0,1,1,64,0,0,0,0,1,49290000
nn_kernel_gpu,2889,1,1,385079,128,0,0,0,0,1,49290000
nn_kernel_gpu_mem,61998,1,1,385079,128,394320000,197160000,197160000,394320000,1,49290000
nn_kernel_cpu,21393,0,1,1,64,0,0,0,0,1,49300000
nn_kernel_gpu,2890,1,1,385157,128,0,0,0,0,1,49300000
nn_kernel_gpu_mem,72638,1,1,385157,128,394400000,197200000,197200000,394400000,1,49300000
nn_kernel_cpu,10395,0,1,1,64,0,0,0,0,1,4930000
nn_kernel_gpu,373,1,1,38516,128,0,0,0,0,1,4930000
nn_kernel_gpu_mem,10814,1,1,38516,128,39440000,19720000,19720000,39440000,1,4930000
nn_kernel_cpu,24687,0,1,1,64,0,0,0,0,1,49310000
nn_kernel_gpu,2951,1,1,385235,128,0,0,0,0,1,49310000
nn_kernel_gpu_mem,73638,1,1,385235,128,394480000,197240000,197240000,394480000,1,49310000
nn_kernel_cpu,29998,0,1,1,64,0,0,0,0,1,49320000
nn_kernel_gpu,2888,1,1,385313,128,0,0,0,0,1,49320000
nn_kernel_gpu_mem,59205,1,1,385313,128,394560000,197280000,197280000,394560000,1,49320000
nn_kernel_cpu,16688,0,1,1,64,0,0,0,0,1,49330000
nn_kernel_gpu,2937,1,1,385391,128,0,0,0,0,1,49330000
nn_kernel_gpu_mem,62118,1,1,385391,128,394640000,197320000,197320000,394640000,1,49330000
nn_kernel_cpu,31270,0,1,1,64,0,0,0,0,1,49340000
nn_kernel_gpu,2924,1,1,385469,128,0,0,0,0,1,49340000
nn_kernel_gpu_mem,56419,1,1,385469,128,394720000,197360000,197360000,394720000,1,49340000
nn_kernel_cpu,27918,0,1,1,64,0,0,0,0,1,49350000
nn_kernel_gpu,2929,1,1,385547,128,0,0,0,0,1,49350000
nn_kernel_gpu_mem,75195,1,1,385547,128,394800000,197400000,197400000,394800000,1,49350000
nn_kernel_cpu,19699,0,1,1,64,0,0,0,0,1,49360000
nn_kernel_gpu,2895,1,1,385625,128,0,0,0,0,1,49360000
nn_kernel_gpu_mem,70624,1,1,385625,128,394880000,197440000,197440000,394880000,1,49360000
nn_kernel_cpu,24615,0,1,1,64,0,0,0,0,1,49370000
nn_kernel_gpu,2949,1,1,385704,128,0,0,0,0,1,49370000
nn_kernel_gpu_mem,74539,1,1,385704,128,394960000,197480000,197480000,394960000,1,49370000
nn_kernel_cpu,20793,0,1,1,64,0,0,0,0,1,49380000
nn_kernel_gpu,2949,1,1,385782,128,0,0,0,0,1,49380000
nn_kernel_gpu_mem,62873,1,1,385782,128,395040000,197520000,197520000,395040000,1,49380000
nn_kernel_cpu,30430,0,1,1,64,0,0,0,0,1,49390000
nn_kernel_gpu,2933,1,1,385860,128,0,0,0,0,1,49390000
nn_kernel_gpu_mem,74538,1,1,385860,128,395120000,197560000,197560000,395120000,1,49390000
nn_kernel_cpu,23399,0,1,1,64,0,0,0,0,1,49400000
nn_kernel_gpu,2929,1,1,385938,128,0,0,0,0,1,49400000
nn_kernel_gpu_mem,58450,1,1,385938,128,395200000,197600000,197600000,395200000,1,49400000
nn_kernel_cpu,8590,0,1,1,64,0,0,0,0,1,4940000
nn_kernel_gpu,343,1,1,38594,128,0,0,0,0,1,4940000
nn_kernel_gpu_mem,7337,1,1,38594,128,39520000,19760000,19760000,39520000,1,4940000
nn_kernel_cpu,25526,0,1,1,64,0,0,0,0,1,49410000
nn_kernel_gpu,2945,1,1,386016,128,0,0,0,0,1,49410000
nn_kernel_gpu_mem,73519,1,1,386016,128,395280000,197640000,197640000,395280000,1,49410000
nn_kernel_cpu,34351,0,1,1,64,0,0,0,0,1,49420000
nn_kernel_gpu,2898,1,1,386094,128,0,0,0,0,1,49420000
nn_kernel_gpu_mem,64313,1,1,386094,128,395360000,197680000,197680000,395360000,1,49420000
nn_kernel_cpu,12870,0,1,1,64,0,0,0,0,1,49430000
nn_kernel_gpu,2898,1,1,386172,128,0,0,0,0,1,49430000
nn_kernel_gpu_mem,68442,1,1,386172,128,395440000,197720000,197720000,395440000,1,49430000
nn_kernel_cpu,35579,0,1,1,64,0,0,0,0,1,49440000
nn_kernel_gpu,2906,1,1,386250,128,0,0,0,0,1,49440000
nn_kernel_gpu_mem,73099,1,1,386250,128,395520000,197760000,197760000,395520000,1,49440000
nn_kernel_cpu,35641,0,1,1,64,0,0,0,0,1,49450000
nn_kernel_gpu,2919,1,1,386329,128,0,0,0,0,1,49450000
nn_kernel_gpu_mem,73425,1,1,386329,128,395600000,197800000,197800000,395600000,1,49450000
nn_kernel_cpu,19903,0,1,1,64,0,0,0,0,1,49460000
nn_kernel_gpu,2943,1,1,386407,128,0,0,0,0,1,49460000
nn_kernel_gpu_mem,63648,1,1,386407,128,395680000,197840000,197840000,395680000,1,49460000
nn_kernel_cpu,33350,0,1,1,64,0,0,0,0,1,49470000
nn_kernel_gpu,2900,1,1,386485,128,0,0,0,0,1,49470000
nn_kernel_gpu_mem,58874,1,1,386485,128,395760000,197880000,197880000,395760000,1,49470000
nn_kernel_cpu,25789,0,1,1,64,0,0,0,0,1,49480000
nn_kernel_gpu,2891,1,1,386563,128,0,0,0,0,1,49480000
nn_kernel_gpu_mem,72178,1,1,386563,128,395840000,197920000,197920000,395840000,1,49480000
nn_kernel_cpu,29380,0,1,1,64,0,0,0,0,1,49490000
nn_kernel_gpu,2897,1,1,386641,128,0,0,0,0,1,49490000
nn_kernel_gpu_mem,61937,1,1,386641,128,395920000,197960000,197960000,395920000,1,49490000
nn_kernel_cpu,27683,0,1,1,64,0,0,0,0,1,49500000
nn_kernel_gpu,2902,1,1,386719,128,0,0,0,0,1,49500000
nn_kernel_gpu_mem,67806,1,1,386719,128,396000000,198000000,198000000,396000000,1,49500000
nn_kernel_cpu,13306,0,1,1,64,0,0,0,0,1,4950000
nn_kernel_gpu,344,1,1,38672,128,0,0,0,0,1,4950000
nn_kernel_gpu_mem,8047,1,1,38672,128,39600000,19800000,19800000,39600000,1,4950000
nn_kernel_cpu,34098,0,1,1,64,0,0,0,0,1,49510000
nn_kernel_gpu,2907,1,1,386797,128,0,0,0,0,1,49510000
nn_kernel_gpu_mem,59628,1,1,386797,128,396080000,198040000,198040000,396080000,1,49510000
nn_kernel_cpu,14084,0,1,1,64,0,0,0,0,1,49520000
nn_kernel_gpu,2903,1,1,386875,128,0,0,0,0,1,49520000
nn_kernel_gpu_mem,57205,1,1,386875,128,396160000,198080000,198080000,396160000,1,49520000
nn_kernel_cpu,16060,0,1,1,64,0,0,0,0,1,49530000
nn_kernel_gpu,2904,1,1,386954,128,0,0,0,0,1,49530000
nn_kernel_gpu_mem,71993,1,1,386954,128,396240000,198120000,198120000,396240000,1,49530000
nn_kernel_cpu,23683,0,1,1,64,0,0,0,0,1,49540000
nn_kernel_gpu,2946,1,1,387032,128,0,0,0,0,1,49540000
nn_kernel_gpu_mem,71948,1,1,387032,128,396320000,198160000,198160000,396320000,1,49540000
nn_kernel_cpu,18770,0,1,1,64,0,0,0,0,1,49550000
nn_kernel_gpu,2902,1,1,387110,128,0,0,0,0,1,49550000
nn_kernel_gpu_mem,74130,1,1,387110,128,396400000,198200000,198200000,396400000,1,49550000
nn_kernel_cpu,21299,0,1,1,64,0,0,0,0,1,49560000
nn_kernel_gpu,2920,1,1,387188,128,0,0,0,0,1,49560000
nn_kernel_gpu_mem,58251,1,1,387188,128,396480000,198240000,198240000,396480000,1,49560000
nn_kernel_cpu,18275,0,1,1,64,0,0,0,0,1,49570000
nn_kernel_gpu,2897,1,1,387266,128,0,0,0,0,1,49570000
nn_kernel_gpu_mem,60727,1,1,387266,128,396560000,198280000,198280000,396560000,1,49570000
nn_kernel_cpu,26190,0,1,1,64,0,0,0,0,1,49580000
nn_kernel_gpu,2954,1,1,387344,128,0,0,0,0,1,49580000
nn_kernel_gpu_mem,73582,1,1,387344,128,396640000,198320000,198320000,396640000,1,49580000
nn_kernel_cpu,24600,0,1,1,64,0,0,0,0,1,49590000
nn_kernel_gpu,2909,1,1,387422,128,0,0,0,0,1,49590000
nn_kernel_gpu_mem,71590,1,1,387422,128,396720000,198360000,198360000,396720000,1,49590000
nn_kernel_cpu,21166,0,1,1,64,0,0,0,0,1,49600000
nn_kernel_gpu,2953,1,1,387500,128,0,0,0,0,1,49600000
nn_kernel_gpu_mem,73354,1,1,387500,128,396800000,198400000,198400000,396800000,1,49600000
nn_kernel_cpu,3392,0,1,1,64,0,0,0,0,1,4960000
nn_kernel_gpu,345,1,1,38750,128,0,0,0,0,1,4960000
nn_kernel_gpu_mem,8114,1,1,38750,128,39680000,19840000,19840000,39680000,1,4960000
nn_kernel_cpu,30097,0,1,1,64,0,0,0,0,1,49610000
nn_kernel_gpu,2920,1,1,387579,128,0,0,0,0,1,49610000
nn_kernel_gpu_mem,63769,1,1,387579,128,396880000,198440000,198440000,396880000,1,49610000
nn_kernel_cpu,29960,0,1,1,64,0,0,0,0,1,49620000
nn_kernel_gpu,2954,1,1,387657,128,0,0,0,0,1,49620000
nn_kernel_gpu_mem,59377,1,1,387657,128,396960000,198480000,198480000,396960000,1,49620000
nn_kernel_cpu,14162,0,1,1,64,0,0,0,0,1,49630000
nn_kernel_gpu,2969,1,1,387735,128,0,0,0,0,1,49630000
nn_kernel_gpu_mem,73017,1,1,387735,128,397040000,198520000,198520000,397040000,1,49630000
nn_kernel_cpu,27785,0,1,1,64,0,0,0,0,1,49640000
nn_kernel_gpu,2921,1,1,387813,128,0,0,0,0,1,49640000
nn_kernel_gpu_mem,57053,1,1,387813,128,397120000,198560000,198560000,397120000,1,49640000
nn_kernel_cpu,38958,0,1,1,64,0,0,0,0,1,49650000
nn_kernel_gpu,2915,1,1,387891,128,0,0,0,0,1,49650000
nn_kernel_gpu_mem,74379,1,1,387891,128,397200000,198600000,198600000,397200000,1,49650000
nn_kernel_cpu,28334,0,1,1,64,0,0,0,0,1,49660000
nn_kernel_gpu,2911,1,1,387969,128,0,0,0,0,1,49660000
nn_kernel_gpu_mem,73146,1,1,387969,128,397280000,198640000,198640000,397280000,1,49660000
nn_kernel_cpu,25988,0,1,1,64,0,0,0,0,1,49670000
nn_kernel_gpu,2962,1,1,388047,128,0,0,0,0,1,49670000
nn_kernel_gpu_mem,63819,1,1,388047,128,397360000,198680000,198680000,397360000,1,49670000
nn_kernel_cpu,31794,0,1,1,64,0,0,0,0,1,49680000
nn_kernel_gpu,2958,1,1,388125,128,0,0,0,0,1,49680000
nn_kernel_gpu_mem,73063,1,1,388125,128,397440000,198720000,198720000,397440000,1,49680000
nn_kernel_cpu,26321,0,1,1,64,0,0,0,0,1,49690000
nn_kernel_gpu,2926,1,1,388204,128,0,0,0,0,1,49690000
nn_kernel_gpu_mem,57047,1,1,388204,128,397520000,198760000,198760000,397520000,1,49690000
nn_kernel_cpu,26995,0,1,1,64,0,0,0,0,1,49700000
nn_kernel_gpu,2926,1,1,388282,128,0,0,0,0,1,49700000
nn_kernel_gpu_mem,57798,1,1,388282,128,397600000,198800000,198800000,397600000,1,49700000
nn_kernel_cpu,14715,0,1,1,64,0,0,0,0,1,4970000
nn_kernel_gpu,349,1,1,38829,128,0,0,0,0,1,4970000
nn_kernel_gpu_mem,15157,1,1,38829,128,39760000,19880000,19880000,39760000,1,4970000
nn_kernel_cpu,25223,0,1,1,64,0,0,0,0,1,49710000
nn_kernel_gpu,2929,1,1,388360,128,0,0,0,0,1,49710000
nn_kernel_gpu_mem,63773,1,1,388360,128,397680000,198840000,198840000,397680000,1,49710000
nn_kernel_cpu,27513,0,1,1,64,0,0,0,0,1,49720000
nn_kernel_gpu,2975,1,1,388438,128,0,0,0,0,1,49720000
nn_kernel_gpu_mem,62165,1,1,388438,128,397760000,198880000,198880000,397760000,1,49720000
nn_kernel_cpu,23460,0,1,1,64,0,0,0,0,1,49730000
nn_kernel_gpu,2917,1,1,388516,128,0,0,0,0,1,49730000
nn_kernel_gpu_mem,58796,1,1,388516,128,397840000,198920000,198920000,397840000,1,49730000
nn_kernel_cpu,24567,0,1,1,64,0,0,0,0,1,49740000
nn_kernel_gpu,2926,1,1,388594,128,0,0,0,0,1,49740000
nn_kernel_gpu_mem,60883,1,1,388594,128,397920000,198960000,198960000,397920000,1,49740000
nn_kernel_cpu,29745,0,1,1,64,0,0,0,0,1,49750000
nn_kernel_gpu,2922,1,1,388672,128,0,0,0,0,1,49750000
nn_kernel_gpu_mem,59111,1,1,388672,128,398000000,199000000,199000000,398000000,1,49750000
nn_kernel_cpu,26693,0,1,1,64,0,0,0,0,1,49760000
nn_kernel_gpu,2932,1,1,388750,128,0,0,0,0,1,49760000
nn_kernel_gpu_mem,68586,1,1,388750,128,398080000,199040000,199040000,398080000,1,49760000
nn_kernel_cpu,17133,0,1,1,64,0,0,0,0,1,49770000
nn_kernel_gpu,2935,1,1,388829,128,0,0,0,0,1,49770000
nn_kernel_gpu_mem,61469,1,1,388829,128,398160000,199080000,199080000,398160000,1,49770000
nn_kernel_cpu,20688,0,1,1,64,0,0,0,0,1,49780000
nn_kernel_gpu,2964,1,1,388907,128,0,0,0,0,1,49780000
nn_kernel_gpu_mem,63855,1,1,388907,128,398240000,199120000,199120000,398240000,1,49780000
nn_kernel_cpu,42044,0,1,1,64,0,0,0,0,1,49790000
nn_kernel_gpu,2911,1,1,388985,128,0,0,0,0,1,49790000
nn_kernel_gpu_mem,58555,1,1,388985,128,398320000,199160000,199160000,398320000,1,49790000
nn_kernel_cpu,21736,0,1,1,64,0,0,0,0,1,49800000
nn_kernel_gpu,2961,1,1,389063,128,0,0,0,0,1,49800000
nn_kernel_gpu_mem,58605,1,1,389063,128,398400000,199200000,199200000,398400000,1,49800000
nn_kernel_cpu,36409,0,1,1,64,0,0,0,0,1,4980000
nn_kernel_gpu,347,1,1,38907,128,0,0,0,0,1,4980000
nn_kernel_gpu_mem,8194,1,1,38907,128,39840000,19920000,19920000,39840000,1,4980000
nn_kernel_cpu,26285,0,1,1,64,0,0,0,0,1,49810000
nn_kernel_gpu,2958,1,1,389141,128,0,0,0,0,1,49810000
nn_kernel_gpu_mem,62324,1,1,389141,128,398480000,199240000,199240000,398480000,1,49810000
nn_kernel_cpu,34308,0,1,1,64,0,0,0,0,1,49820000
nn_kernel_gpu,2954,1,1,389219,128,0,0,0,0,1,49820000
nn_kernel_gpu_mem,63100,1,1,389219,128,398560000,199280000,199280000,398560000,1,49820000
nn_kernel_cpu,26407,0,1,1,64,0,0,0,0,1,49830000
nn_kernel_gpu,2966,1,1,389297,128,0,0,0,0,1,49830000
nn_kernel_gpu_mem,64736,1,1,389297,128,398640000,199320000,199320000,398640000,1,49830000
nn_kernel_cpu,26351,0,1,1,64,0,0,0,0,1,49840000
nn_kernel_gpu,2994,1,1,389375,128,0,0,0,0,1,49840000
nn_kernel_gpu_mem,64143,1,1,389375,128,398720000,199360000,199360000,398720000,1,49840000
nn_kernel_cpu,25434,0,1,1,64,0,0,0,0,1,49850000
nn_kernel_gpu,2941,1,1,389454,128,0,0,0,0,1,49850000
nn_kernel_gpu_mem,58222,1,1,389454,128,398800000,199400000,199400000,398800000,1,49850000
nn_kernel_cpu,22720,0,1,1,64,0,0,0,0,1,49860000
nn_kernel_gpu,3016,1,1,389532,128,0,0,0,0,1,49860000
nn_kernel_gpu_mem,76974,1,1,389532,128,398880000,199440000,199440000,398880000,1,49860000
nn_kernel_cpu,20390,0,1,1,64,0,0,0,0,1,49870000
nn_kernel_gpu,3010,1,1,389610,128,0,0,0,0,1,49870000
nn_kernel_gpu_mem,72268,1,1,389610,128,398960000,199480000,199480000,398960000,1,49870000
nn_kernel_cpu,21170,0,1,1,64,0,0,0,0,1,49880000
nn_kernel_gpu,2972,1,1,389688,128,0,0,0,0,1,49880000
nn_kernel_gpu_mem,72906,1,1,389688,128,399040000,199520000,199520000,399040000,1,49880000
nn_kernel_cpu,24895,0,1,1,64,0,0,0,0,1,49890000
nn_kernel_gpu,2970,1,1,389766,128,0,0,0,0,1,49890000
nn_kernel_gpu_mem,58813,1,1,389766,128,399120000,199560000,199560000,399120000,1,49890000
nn_kernel_cpu,25523,0,1,1,64,0,0,0,0,1,49900000
nn_kernel_gpu,2962,1,1,389844,128,0,0,0,0,1,49900000
nn_kernel_gpu_mem,57970,1,1,389844,128,399200000,199600000,199600000,399200000,1,49900000
nn_kernel_cpu,23580,0,1,1,64,0,0,0,0,1,4990000
nn_kernel_gpu,332,1,1,38985,128,0,0,0,0,1,4990000
nn_kernel_gpu_mem,7235,1,1,38985,128,39920000,19960000,19960000,39920000,1,4990000
nn_kernel_cpu,28718,0,1,1,64,0,0,0,0,1,49910000
nn_kernel_gpu,2958,1,1,389922,128,0,0,0,0,1,49910000
nn_kernel_gpu_mem,72924,1,1,389922,128,399280000,199640000,199640000,399280000,1,49910000
nn_kernel_cpu,23916,0,1,1,64,0,0,0,0,1,49920000
nn_kernel_gpu,2960,1,1,390000,128,0,0,0,0,1,49920000
nn_kernel_gpu_mem,72496,1,1,390000,128,399360000,199680000,199680000,399360000,1,49920000
nn_kernel_cpu,13638,0,1,1,64,0,0,0,0,1,49930000
nn_kernel_gpu,2954,1,1,390079,128,0,0,0,0,1,49930000
nn_kernel_gpu_mem,63895,1,1,390079,128,399440000,199720000,199720000,399440000,1,49930000
nn_kernel_cpu,25167,0,1,1,64,0,0,0,0,1,49940000
nn_kernel_gpu,2972,1,1,390157,128,0,0,0,0,1,49940000
nn_kernel_gpu_mem,59279,1,1,390157,128,399520000,199760000,199760000,399520000,1,49940000
nn_kernel_cpu,24730,0,1,1,64,0,0,0,0,1,49950000
nn_kernel_gpu,2991,1,1,390235,128,0,0,0,0,1,49950000
nn_kernel_gpu_mem,58205,1,1,390235,128,399600000,199800000,199800000,399600000,1,49950000
nn_kernel_cpu,25397,0,1,1,64,0,0,0,0,1,49960000
nn_kernel_gpu,2964,1,1,390313,128,0,0,0,0,1,49960000
nn_kernel_gpu_mem,74227,1,1,390313,128,399680000,199840000,199840000,399680000,1,49960000
nn_kernel_cpu,24117,0,1,1,64,0,0,0,0,1,49970000
nn_kernel_gpu,2988,1,1,390391,128,0,0,0,0,1,49970000
nn_kernel_gpu_mem,57871,1,1,390391,128,399760000,199880000,199880000,399760000,1,49970000
nn_kernel_cpu,31724,0,1,1,64,0,0,0,0,1,49980000
nn_kernel_gpu,3005,1,1,390469,128,0,0,0,0,1,49980000
nn_kernel_gpu_mem,81988,1,1,390469,128,399840000,199920000,199920000,399840000,1,49980000
nn_kernel_cpu,36818,0,1,1,64,0,0,0,0,1,49990000
nn_kernel_gpu,2965,1,1,390547,128,0,0,0,0,1,49990000
nn_kernel_gpu_mem,60763,1,1,390547,128,399920000,199960000,199960000,399920000,1,49990000
nn_kernel_cpu,25528,0,1,1,64,0,0,0,0,1,50000000
nn_kernel_gpu,2982,1,1,390625,128,0,0,0,0,1,50000000
nn_kernel_gpu_mem,72018,1,1,390625,128,400000000,200000000,200000000,400000000,1,50000000
nn_kernel_cpu,16852,0,1,1,64,0,0,0,0,1,5000000
nn_kernel_gpu,345,1,1,39063,128,0,0,0,0,1,5000000
nn_kernel_gpu_mem,7637,1,1,39063,128,40000000,20000000,20000000,40000000,1,5000000
nn_kernel_cpu,23307,0,1,1,64,0,0,0,0,1,500000
nn_kernel_gpu,77,1,1,3907,128,0,0,0,0,1,500000
nn_kernel_gpu_mem,1052,1,1,3907,128,4000000,2000000,2000000,4000000,1,500000
nn_kernel_cpu,35943,0,1,1,64,0,0,0,0,1,50000
nn_kernel_gpu,42,1,1,391,128,0,0,0,0,1,50000
nn_kernel_gpu_mem,117,1,1,391,128,400000,200000,200000,400000,1,50000
nn_kernel_cpu,32276,0,1,1,64,0,0,0,0,1,5010000
nn_kernel_gpu,357,1,1,39141,128,0,0,0,0,1,5010000
nn_kernel_gpu_mem,7004,1,1,39141,128,40080000,20040000,20040000,40080000,1,5010000
nn_kernel_cpu,3696,0,1,1,64,0,0,0,0,1,5020000
nn_kernel_gpu,355,1,1,39219,128,0,0,0,0,1,5020000
nn_kernel_gpu_mem,7449,1,1,39219,128,40160000,20080000,20080000,40160000,1,5020000
nn_kernel_cpu,34076,0,1,1,64,0,0,0,0,1,5030000
nn_kernel_gpu,352,1,1,39297,128,0,0,0,0,1,5030000
nn_kernel_gpu_mem,6525,1,1,39297,128,40240000,20120000,20120000,40240000,1,5030000
nn_kernel_cpu,23309,0,1,1,64,0,0,0,0,1,5040000
nn_kernel_gpu,352,1,1,39375,128,0,0,0,0,1,5040000
nn_kernel_gpu_mem,7362,1,1,39375,128,40320000,20160000,20160000,40320000,1,5040000
nn_kernel_cpu,30270,0,1,1,64,0,0,0,0,1,5050000
nn_kernel_gpu,350,1,1,39454,128,0,0,0,0,1,5050000
nn_kernel_gpu_mem,8347,1,1,39454,128,40400000,20200000,20200000,40400000,1,5050000
nn_kernel_cpu,22733,0,1,1,64,0,0,0,0,1,5060000
nn_kernel_gpu,350,1,1,39532,128,0,0,0,0,1,5060000
nn_kernel_gpu_mem,7593,1,1,39532,128,40480000,20240000,20240000,40480000,1,5060000
nn_kernel_cpu,29739,0,1,1,64,0,0,0,0,1,5070000
nn_kernel_gpu,352,1,1,39610,128,0,0,0,0,1,5070000
nn_kernel_gpu_mem,8045,1,1,39610,128,40560000,20280000,20280000,40560000,1,5070000
nn_kernel_cpu,23902,0,1,1,64,0,0,0,0,1,5080000
nn_kernel_gpu,349,1,1,39688,128,0,0,0,0,1,5080000
nn_kernel_gpu_mem,7811,1,1,39688,128,40640000,20320000,20320000,40640000,1,5080000
nn_kernel_cpu,15124,0,1,1,64,0,0,0,0,1,5090000
nn_kernel_gpu,345,1,1,39766,128,0,0,0,0,1,5090000
nn_kernel_gpu_mem,7265,1,1,39766,128,40720000,20360000,20360000,40720000,1,5090000
nn_kernel_cpu,36024,0,1,1,64,0,0,0,0,1,5100000
nn_kernel_gpu,364,1,1,39844,128,0,0,0,0,1,5100000
nn_kernel_gpu_mem,7356,1,1,39844,128,40800000,20400000,20400000,40800000,1,5100000
nn_kernel_cpu,1479,0,1,1,64,0,0,0,0,1,510000
nn_kernel_gpu,81,1,1,3985,128,0,0,0,0,1,510000
nn_kernel_gpu_mem,3291,1,1,3985,128,4080000,2040000,2040000,4080000,1,510000
nn_kernel_cpu,23264,0,1,1,64,0,0,0,0,1,5110000
nn_kernel_gpu,360,1,1,39922,128,0,0,0,0,1,5110000
nn_kernel_gpu_mem,7676,1,1,39922,128,40880000,20440000,20440000,40880000,1,5110000
nn_kernel_cpu,5223,0,1,1,64,0,0,0,0,1,5120000
nn_kernel_gpu,340,1,1,40000,128,0,0,0,0,1,5120000
nn_kernel_gpu_mem,8093,1,1,40000,128,40960000,20480000,20480000,40960000,1,5120000
nn_kernel_cpu,12048,0,1,1,64,0,0,0,0,1,5130000
nn_kernel_gpu,360,1,1,40079,128,0,0,0,0,1,5130000
nn_kernel_gpu_mem,7331,1,1,40079,128,41040000,20520000,20520000,41040000,1,5130000
nn_kernel_cpu,12668,0,1,1,64,0,0,0,0,1,5140000
nn_kernel_gpu,361,1,1,40157,128,0,0,0,0,1,5140000
nn_kernel_gpu_mem,8252,1,1,40157,128,41120000,20560000,20560000,41120000,1,5140000
nn_kernel_cpu,7263,0,1,1,64,0,0,0,0,1,5150000
nn_kernel_gpu,357,1,1,40235,128,0,0,0,0,1,5150000
nn_kernel_gpu_mem,7584,1,1,40235,128,41200000,20600000,20600000,41200000,1,5150000
nn_kernel_cpu,9226,0,1,1,64,0,0,0,0,1,5160000
nn_kernel_gpu,356,1,1,40313,128,0,0,0,0,1,5160000
nn_kernel_gpu_mem,8436,1,1,40313,128,41280000,20640000,20640000,41280000,1,5160000
nn_kernel_cpu,16061,0,1,1,64,0,0,0,0,1,5170000
nn_kernel_gpu,361,1,1,40391,128,0,0,0,0,1,5170000
nn_kernel_gpu_mem,7510,1,1,40391,128,41360000,20680000,20680000,41360000,1,5170000
nn_kernel_cpu,15266,0,1,1,64,0,0,0,0,1,5180000
nn_kernel_gpu,363,1,1,40469,128,0,0,0,0,1,5180000
nn_kernel_gpu_mem,7613,1,1,40469,128,41440000,20720000,20720000,41440000,1,5180000
nn_kernel_cpu,22543,0,1,1,64,0,0,0,0,1,5190000
nn_kernel_gpu,365,1,1,40547,128,0,0,0,0,1,5190000
nn_kernel_gpu_mem,7444,1,1,40547,128,41520000,20760000,20760000,41520000,1,5190000
nn_kernel_cpu,5310,0,1,1,64,0,0,0,0,1,5200000
nn_kernel_gpu,364,1,1,40625,128,0,0,0,0,1,5200000
nn_kernel_gpu_mem,8240,1,1,40625,128,41600000,20800000,20800000,41600000,1,5200000
nn_kernel_cpu,5559,0,1,1,64,0,0,0,0,1,520000
nn_kernel_gpu,76,1,1,4063,128,0,0,0,0,1,520000
nn_kernel_gpu_mem,1654,1,1,4063,128,4160000,2080000,2080000,4160000,1,520000
nn_kernel_cpu,13197,0,1,1,64,0,0,0,0,1,5210000
nn_kernel_gpu,347,1,1,40704,128,0,0,0,0,1,5210000
nn_kernel_gpu_mem,8505,1,1,40704,128,41680000,20840000,20840000,41680000,1,5210000
nn_kernel_cpu,7572,0,1,1,64,0,0,0,0,1,5220000
nn_kernel_gpu,345,1,1,40782,128,0,0,0,0,1,5220000
nn_kernel_gpu_mem,7229,1,1,40782,128,41760000,20880000,20880000,41760000,1,5220000
nn_kernel_cpu,22898,0,1,1,64,0,0,0,0,1,5230000
nn_kernel_gpu,370,1,1,40860,128,0,0,0,0,1,5230000
nn_kernel_gpu_mem,7474,1,1,40860,128,41840000,20920000,20920000,41840000,1,5230000
nn_kernel_cpu,23114,0,1,1,64,0,0,0,0,1,5240000
nn_kernel_gpu,367,1,1,40938,128,0,0,0,0,1,5240000
nn_kernel_gpu_mem,7826,1,1,40938,128,41920000,20960000,20960000,41920000,1,5240000
nn_kernel_cpu,16745,0,1,1,64,0,0,0,0,1,5250000
nn_kernel_gpu,368,1,1,41016,128,0,0,0,0,1,5250000
nn_kernel_gpu_mem,7704,1,1,41016,128,42000000,21000000,21000000,42000000,1,5250000
nn_kernel_cpu,26314,0,1,1,64,0,0,0,0,1,5260000
nn_kernel_gpu,369,1,1,41094,128,0,0,0,0,1,5260000
nn_kernel_gpu_mem,9162,1,1,41094,128,42080000,21040000,21040000,42080000,1,5260000
nn_kernel_cpu,8043,0,1,1,64,0,0,0,0,1,5270000
nn_kernel_gpu,359,1,1,41172,128,0,0,0,0,1,5270000
nn_kernel_gpu_mem,8859,1,1,41172,128,42160000,21080000,21080000,42160000,1,5270000
nn_kernel_cpu,4477,0,1,1,64,0,0,0,0,1,5280000
nn_kernel_gpu,362,1,1,41250,128,0,0,0,0,1,5280000
nn_kernel_gpu_mem,7954,1,1,41250,128,42240000,21120000,21120000,42240000,1,5280000
nn_kernel_cpu,6974,0,1,1,64,0,0,0,0,1,5290000
nn_kernel_gpu,344,1,1,41329,128,0,0,0,0,1,5290000
nn_kernel_gpu_mem,9042,1,1,41329,128,42320000,21160000,21160000,42320000,1,5290000
nn_kernel_cpu,7804,0,1,1,64,0,0,0,0,1,5300000
nn_kernel_gpu,372,1,1,41407,128,0,0,0,0,1,5300000
nn_kernel_gpu_mem,7946,1,1,41407,128,42400000,21200000,21200000,42400000,1,5300000
nn_kernel_cpu,685,0,1,1,64,0,0,0,0,1,530000
nn_kernel_gpu,90,1,1,4141,128,0,0,0,0,1,530000
nn_kernel_gpu_mem,1846,1,1,4141,128,4240000,2120000,2120000,4240000,1,530000
nn_kernel_cpu,32581,0,1,1,64,0,0,0,0,1,5310000
nn_kernel_gpu,372,1,1,41485,128,0,0,0,0,1,5310000
nn_kernel_gpu_mem,7670,1,1,41485,128,42480000,21240000,21240000,42480000,1,5310000
nn_kernel_cpu,19557,0,1,1,64,0,0,0,0,1,5320000
nn_kernel_gpu,364,1,1,41563,128,0,0,0,0,1,5320000
nn_kernel_gpu_mem,7852,1,1,41563,128,42560000,21280000,21280000,42560000,1,5320000
nn_kernel_cpu,16988,0,1,1,64,0,0,0,0,1,5330000
nn_kernel_gpu,352,1,1,41641,128,0,0,0,0,1,5330000
nn_kernel_gpu_mem,8646,1,1,41641,128,42640000,21320000,21320000,42640000,1,5330000
nn_kernel_cpu,9613,0,1,1,64,0,0,0,0,1,5340000
nn_kernel_gpu,357,1,1,41719,128,0,0,0,0,1,5340000
nn_kernel_gpu_mem,8336,1,1,41719,128,42720000,21360000,21360000,42720000,1,5340000
nn_kernel_cpu,5294,0,1,1,64,0,0,0,0,1,5350000
nn_kernel_gpu,365,1,1,41797,128,0,0,0,0,1,5350000
nn_kernel_gpu_mem,7918,1,1,41797,128,42800000,21400000,21400000,42800000,1,5350000
nn_kernel_cpu,7093,0,1,1,64,0,0,0,0,1,5360000
nn_kernel_gpu,351,1,1,41875,128,0,0,0,0,1,5360000
nn_kernel_gpu_mem,8454,1,1,41875,128,42880000,21440000,21440000,42880000,1,5360000
nn_kernel_cpu,15881,0,1,1,64,0,0,0,0,1,5370000
nn_kernel_gpu,363,1,1,41954,128,0,0,0,0,1,5370000
nn_kernel_gpu_mem,7299,1,1,41954,128,42960000,21480000,21480000,42960000,1,5370000
nn_kernel_cpu,4760,0,1,1,64,0,0,0,0,1,5380000
nn_kernel_gpu,353,1,1,42032,128,0,0,0,0,1,5380000
nn_kernel_gpu_mem,7856,1,1,42032,128,43040000,21520000,21520000,43040000,1,5380000
nn_kernel_cpu,5003,0,1,1,64,0,0,0,0,1,5390000
nn_kernel_gpu,368,1,1,42110,128,0,0,0,0,1,5390000
nn_kernel_gpu_mem,7854,1,1,42110,128,43120000,21560000,21560000,43120000,1,5390000
nn_kernel_cpu,12132,0,1,1,64,0,0,0,0,1,5400000
nn_kernel_gpu,369,1,1,42188,128,0,0,0,0,1,5400000
nn_kernel_gpu_mem,8154,1,1,42188,128,43200000,21600000,21600000,43200000,1,5400000
nn_kernel_cpu,23599,0,1,1,64,0,0,0,0,1,540000
nn_kernel_gpu,84,1,1,4219,128,0,0,0,0,1,540000
nn_kernel_gpu_mem,1189,1,1,4219,128,4320000,2160000,2160000,4320000,1,540000
nn_kernel_cpu,27872,0,1,1,64,0,0,0,0,1,5410000
nn_kernel_gpu,360,1,1,42266,128,0,0,0,0,1,5410000
nn_kernel_gpu_mem,8854,1,1,42266,128,43280000,21640000,21640000,43280000,1,5410000
nn_kernel_cpu,23355,0,1,1,64,0,0,0,0,1,5420000
nn_kernel_gpu,357,1,1,42344,128,0,0,0,0,1,5420000
nn_kernel_gpu_mem,8081,1,1,42344,128,43360000,21680000,21680000,43360000,1,5420000
nn_kernel_cpu,16583,0,1,1,64,0,0,0,0,1,5430000
nn_kernel_gpu,374,1,1,42422,128,0,0,0,0,1,5430000
nn_kernel_gpu_mem,9191,1,1,42422,128,43440000,21720000,21720000,43440000,1,5430000
nn_kernel_cpu,17361,0,1,1,64,0,0,0,0,1,5440000
nn_kernel_gpu,376,1,1,42500,128,0,0,0,0,1,5440000
nn_kernel_gpu_mem,7847,1,1,42500,128,43520000,21760000,21760000,43520000,1,5440000
nn_kernel_cpu,16559,0,1,1,64,0,0,0,0,1,5450000
nn_kernel_gpu,359,1,1,42579,128,0,0,0,0,1,5450000
nn_kernel_gpu_mem,8238,1,1,42579,128,43600000,21800000,21800000,43600000,1,5450000
nn_kernel_cpu,12457,0,1,1,64,0,0,0,0,1,5460000
nn_kernel_gpu,378,1,1,42657,128,0,0,0,0,1,5460000
nn_kernel_gpu_mem,8180,1,1,42657,128,43680000,21840000,21840000,43680000,1,5460000
nn_kernel_cpu,7956,0,1,1,64,0,0,0,0,1,5470000
nn_kernel_gpu,365,1,1,42735,128,0,0,0,0,1,5470000
nn_kernel_gpu_mem,7924,1,1,42735,128,43760000,21880000,21880000,43760000,1,5470000
nn_kernel_cpu,5616,0,1,1,64,0,0,0,0,1,5480000
nn_kernel_gpu,379,1,1,42813,128,0,0,0,0,1,5480000
nn_kernel_gpu_mem,8083,1,1,42813,128,43840000,21920000,21920000,43840000,1,5480000
nn_kernel_cpu,6154,0,1,1,64,0,0,0,0,1,5490000
nn_kernel_gpu,374,1,1,42891,128,0,0,0,0,1,5490000
nn_kernel_gpu_mem,8673,1,1,42891,128,43920000,21960000,21960000,43920000,1,5490000
nn_kernel_cpu,13308,0,1,1,64,0,0,0,0,1,5500000
nn_kernel_gpu,362,1,1,42969,128,0,0,0,0,1,5500000
nn_kernel_gpu_mem,6378,1,1,42969,128,44000000,22000000,22000000,44000000,1,5500000
nn_kernel_cpu,17748,0,1,1,64,0,0,0,0,1,550000
nn_kernel_gpu,88,1,1,4297,128,0,0,0,0,1,550000
nn_kernel_gpu_mem,1906,1,1,4297,128,4400000,2200000,2200000,4400000,1,550000
nn_kernel_cpu,4776,0,1,1,64,0,0,0,0,1,5510000
nn_kernel_gpu,376,1,1,43047,128,0,0,0,0,1,5510000
nn_kernel_gpu_mem,8559,1,1,43047,128,44080000,22040000,22040000,44080000,1,5510000
nn_kernel_cpu,24311,0,1,1,64,0,0,0,0,1,5520000
nn_kernel_gpu,368,1,1,43125,128,0,0,0,0,1,5520000
nn_kernel_gpu_mem,8628,1,1,43125,128,44160000,22080000,22080000,44160000,1,5520000
nn_kernel_cpu,23482,0,1,1,64,0,0,0,0,1,5530000
nn_kernel_gpu,372,1,1,43204,128,0,0,0,0,1,5530000
nn_kernel_gpu_mem,8382,1,1,43204,128,44240000,22120000,22120000,44240000,1,5530000
nn_kernel_cpu,9169,0,1,1,64,0,0,0,0,1,5540000
nn_kernel_gpu,378,1,1,43282,128,0,0,0,0,1,5540000
nn_kernel_gpu_mem,8798,1,1,43282,128,44320000,22160000,22160000,44320000,1,5540000
nn_kernel_cpu,11814,0,1,1,64,0,0,0,0,1,5550000
nn_kernel_gpu,375,1,1,43360,128,0,0,0,0,1,5550000
nn_kernel_gpu_mem,8114,1,1,43360,128,44400000,22200000,22200000,44400000,1,5550000
nn_kernel_cpu,10227,0,1,1,64,0,0,0,0,1,5560000
nn_kernel_gpu,385,1,1,43438,128,0,0,0,0,1,5560000
nn_kernel_gpu_mem,8047,1,1,43438,128,44480000,22240000,22240000,44480000,1,5560000
nn_kernel_cpu,17582,0,1,1,64,0,0,0,0,1,5570000
nn_kernel_gpu,382,1,1,43516,128,0,0,0,0,1,5570000
nn_kernel_gpu_mem,9189,1,1,43516,128,44560000,22280000,22280000,44560000,1,5570000
nn_kernel_cpu,8778,0,1,1,64,0,0,0,0,1,5580000
nn_kernel_gpu,369,1,1,43594,128,0,0,0,0,1,5580000
nn_kernel_gpu_mem,9568,1,1,43594,128,44640000,22320000,22320000,44640000,1,5580000
nn_kernel_cpu,5915,0,1,1,64,0,0,0,0,1,5590000
nn_kernel_gpu,397,1,1,43672,128,0,0,0,0,1,5590000
nn_kernel_gpu_mem,8123,1,1,43672,128,44720000,22360000,22360000,44720000,1,5590000
nn_kernel_cpu,5859,0,1,1,64,0,0,0,0,1,5600000
nn_kernel_gpu,373,1,1,43750,128,0,0,0,0,1,5600000
nn_kernel_gpu_mem,8923,1,1,43750,128,44800000,22400000,22400000,44800000,1,5600000
nn_kernel_cpu,24078,0,1,1,64,0,0,0,0,1,560000
nn_kernel_gpu,76,1,1,4375,128,0,0,0,0,1,560000
nn_kernel_gpu_mem,1915,1,1,4375,128,4480000,2240000,2240000,4480000,1,560000
nn_kernel_cpu,7498,0,1,1,64,0,0,0,0,1,5610000
nn_kernel_gpu,388,1,1,43829,128,0,0,0,0,1,5610000
nn_kernel_gpu_mem,8326,1,1,43829,128,44880000,22440000,22440000,44880000,1,5610000
nn_kernel_cpu,13397,0,1,1,64,0,0,0,0,1,5620000
nn_kernel_gpu,386,1,1,43907,128,0,0,0,0,1,5620000
nn_kernel_gpu_mem,10044,1,1,43907,128,44960000,22480000,22480000,44960000,1,5620000
nn_kernel_cpu,11912,0,1,1,64,0,0,0,0,1,5630000
nn_kernel_gpu,367,1,1,43985,128,0,0,0,0,1,5630000
nn_kernel_gpu_mem,9327,1,1,43985,128,45040000,22520000,22520000,45040000,1,5630000
nn_kernel_cpu,26966,0,1,1,64,0,0,0,0,1,5640000
nn_kernel_gpu,398,1,1,44063,128,0,0,0,0,1,5640000
nn_kernel_gpu_mem,8034,1,1,44063,128,45120000,22560000,22560000,45120000,1,5640000
nn_kernel_cpu,24251,0,1,1,64,0,0,0,0,1,5650000
nn_kernel_gpu,383,1,1,44141,128,0,0,0,0,1,5650000
nn_kernel_gpu_mem,8326,1,1,44141,128,45200000,22600000,22600000,45200000,1,5650000
nn_kernel_cpu,6896,0,1,1,64,0,0,0,0,1,5660000
nn_kernel_gpu,387,1,1,44219,128,0,0,0,0,1,5660000
nn_kernel_gpu_mem,8370,1,1,44219,128,45280000,22640000,22640000,45280000,1,5660000
nn_kernel_cpu,22949,0,1,1,64,0,0,0,0,1,5670000
nn_kernel_gpu,378,1,1,44297,128,0,0,0,0,1,5670000
nn_kernel_gpu_mem,8866,1,1,44297,128,45360000,22680000,22680000,45360000,1,5670000
nn_kernel_cpu,3929,0,1,1,64,0,0,0,0,1,5680000
nn_kernel_gpu,386,1,1,44375,128,0,0,0,0,1,5680000
nn_kernel_gpu_mem,9481,1,1,44375,128,45440000,22720000,22720000,45440000,1,5680000
nn_kernel_cpu,10242,0,1,1,64,0,0,0,0,1,5690000
nn_kernel_gpu,389,1,1,44454,128,0,0,0,0,1,5690000
nn_kernel_gpu_mem,9844,1,1,44454,128,45520000,22760000,22760000,45520000,1,5690000
nn_kernel_cpu,21679,0,1,1,64,0,0,0,0,1,5700000
nn_kernel_gpu,368,1,1,44532,128,0,0,0,0,1,5700000
nn_kernel_gpu_mem,8416,1,1,44532,128,45600000,22800000,22800000,45600000,1,5700000
nn_kernel_cpu,2630,0,1,1,64,0,0,0,0,1,570000
nn_kernel_gpu,90,1,1,4454,128,0,0,0,0,1,570000
nn_kernel_gpu_mem,1935,1,1,4454,128,4560000,2280000,2280000,4560000,1,570000
nn_kernel_cpu,8584,0,1,1,64,0,0,0,0,1,5710000
nn_kernel_gpu,389,1,1,44610,128,0,0,0,0,1,5710000
nn_kernel_gpu_mem,9112,1,1,44610,128,45680000,22840000,22840000,45680000,1,5710000
nn_kernel_cpu,7374,0,1,1,64,0,0,0,0,1,5720000
nn_kernel_gpu,395,1,1,44688,128,0,0,0,0,1,5720000
nn_kernel_gpu_mem,8304,1,1,44688,128,45760000,22880000,22880000,45760000,1,5720000
nn_kernel_cpu,5812,0,1,1,64,0,0,0,0,1,5730000
nn_kernel_gpu,399,1,1,44766,128,0,0,0,0,1,5730000
nn_kernel_gpu_mem,8355,1,1,44766,128,45840000,22920000,22920000,45840000,1,5730000
nn_kernel_cpu,7293,0,1,1,64,0,0,0,0,1,5740000
nn_kernel_gpu,380,1,1,44844,128,0,0,0,0,1,5740000
nn_kernel_gpu_mem,8609,1,1,44844,128,45920000,22960000,22960000,45920000,1,5740000
nn_kernel_cpu,22972,0,1,1,64,0,0,0,0,1,5750000
nn_kernel_gpu,392,1,1,44922,128,0,0,0,0,1,5750000
nn_kernel_gpu_mem,8337,1,1,44922,128,46000000,23000000,23000000,46000000,1,5750000
nn_kernel_cpu,4678,0,1,1,64,0,0,0,0,1,5760000
nn_kernel_gpu,374,1,1,45000,128,0,0,0,0,1,5760000
nn_kernel_gpu_mem,9476,1,1,45000,128,46080000,23040000,23040000,46080000,1,5760000
nn_kernel_cpu,4205,0,1,1,64,0,0,0,0,1,5770000
nn_kernel_gpu,392,1,1,45079,128,0,0,0,0,1,5770000
nn_kernel_gpu_mem,9388,1,1,45079,128,46160000,23080000,23080000,46160000,1,5770000
nn_kernel_cpu,23737,0,1,1,64,0,0,0,0,1,5780000
nn_kernel_gpu,396,1,1,45157,128,0,0,0,0,1,5780000
nn_kernel_gpu_mem,8620,1,1,45157,128,46240000,23120000,23120000,46240000,1,5780000
nn_kernel_cpu,9675,0,1,1,64,0,0,0,0,1,5790000
nn_kernel_gpu,385,1,1,45235,128,0,0,0,0,1,5790000
nn_kernel_gpu_mem,8277,1,1,45235,128,46320000,23160000,23160000,46320000,1,5790000
nn_kernel_cpu,5996,0,1,1,64,0,0,0,0,1,5800000
nn_kernel_gpu,392,1,1,45313,128,0,0,0,0,1,5800000
nn_kernel_gpu_mem,9283,1,1,45313,128,46400000,23200000,23200000,46400000,1,5800000
nn_kernel_cpu,7202,0,1,1,64,0,0,0,0,1,580000
nn_kernel_gpu,93,1,1,4532,128,0,0,0,0,1,580000
nn_kernel_gpu_mem,1315,1,1,4532,128,4640000,2320000,2320000,4640000,1,580000
nn_kernel_cpu,20917,0,1,1,64,0,0,0,0,1,5810000
nn_kernel_gpu,379,1,1,45391,128,0,0,0,0,1,5810000
nn_kernel_gpu_mem,9245,1,1,45391,128,46480000,23240000,23240000,46480000,1,5810000
nn_kernel_cpu,8283,0,1,1,64,0,0,0,0,1,5820000
nn_kernel_gpu,376,1,1,45469,128,0,0,0,0,1,5820000
nn_kernel_gpu_mem,9807,1,1,45469,128,46560000,23280000,23280000,46560000,1,5820000
nn_kernel_cpu,6077,0,1,1,64,0,0,0,0,1,5830000
nn_kernel_gpu,401,1,1,45547,128,0,0,0,0,1,5830000
nn_kernel_gpu_mem,8245,1,1,45547,128,46640000,23320000,23320000,46640000,1,5830000
nn_kernel_cpu,35175,0,1,1,64,0,0,0,0,1,5840000
nn_kernel_gpu,401,1,1,45625,128,0,0,0,0,1,5840000
nn_kernel_gpu_mem,8524,1,1,45625,128,46720000,23360000,23360000,46720000,1,5840000
nn_kernel_cpu,8838,0,1,1,64,0,0,0,0,1,5850000
nn_kernel_gpu,378,1,1,45704,128,0,0,0,0,1,5850000
nn_kernel_gpu_mem,10173,1,1,45704,128,46800000,23400000,23400000,46800000,1,5850000
nn_kernel_cpu,17698,0,1,1,64,0,0,0,0,1,5860000
nn_kernel_gpu,389,1,1,45782,128,0,0,0,0,1,5860000
nn_kernel_gpu_mem,8359,1,1,45782,128,46880000,23440000,23440000,46880000,1,5860000
nn_kernel_cpu,18586,0,1,1,64,0,0,0,0,1,5870000
nn_kernel_gpu,396,1,1,45860,128,0,0,0,0,1,5870000
nn_kernel_gpu_mem,9305,1,1,45860,128,46960000,23480000,23480000,46960000,1,5870000
nn_kernel_cpu,23640,0,1,1,64,0,0,0,0,1,5880000
nn_kernel_gpu,403,1,1,45938,128,0,0,0,0,1,5880000
nn_kernel_gpu_mem,8386,1,1,45938,128,47040000,23520000,23520000,47040000,1,5880000
nn_kernel_cpu,15932,0,1,1,64,0,0,0,0,1,5890000
nn_kernel_gpu,393,1,1,46016,128,0,0,0,0,1,5890000
nn_kernel_gpu_mem,9322,1,1,46016,128,47120000,23560000,23560000,47120000,1,5890000
nn_kernel_cpu,23356,0,1,1,64,0,0,0,0,1,5900000
nn_kernel_gpu,396,1,1,46094,128,0,0,0,0,1,5900000
nn_kernel_gpu_mem,8615,1,1,46094,128,47200000,23600000,23600000,47200000,1,5900000
nn_kernel_cpu,27084,0,1,1,64,0,0,0,0,1,590000
nn_kernel_gpu,93,1,1,4610,128,0,0,0,0,1,590000
nn_kernel_gpu_mem,1321,1,1,4610,128,4720000,2360000,2360000,4720000,1,590000
nn_kernel_cpu,28456,0,1,1,64,0,0,0,0,1,5910000
nn_kernel_gpu,384,1,1,46172,128,0,0,0,0,1,5910000
nn_kernel_gpu_mem,8768,1,1,46172,128,47280000,23640000,23640000,47280000,1,5910000
nn_kernel_cpu,24015,0,1,1,64,0,0,0,0,1,5920000
nn_kernel_gpu,391,1,1,46250,128,0,0,0,0,1,5920000
nn_kernel_gpu_mem,6940,1,1,46250,128,47360000,23680000,23680000,47360000,1,5920000
nn_kernel_cpu,6212,0,1,1,64,0,0,0,0,1,5930000
nn_kernel_gpu,406,1,1,46329,128,0,0,0,0,1,5930000
nn_kernel_gpu_mem,8595,1,1,46329,128,47440000,23720000,23720000,47440000,1,5930000
nn_kernel_cpu,22933,0,1,1,64,0,0,0,0,1,5940000
nn_kernel_gpu,412,1,1,46407,128,0,0,0,0,1,5940000
nn_kernel_gpu_mem,10290,1,1,46407,128,47520000,23760000,23760000,47520000,1,5940000
nn_kernel_cpu,34291,0,1,1,64,0,0,0,0,1,5950000
nn_kernel_gpu,400,1,1,46485,128,0,0,0,0,1,5950000
nn_kernel_gpu_mem,9031,1,1,46485,128,47600000,23800000,23800000,47600000,1,5950000
nn_kernel_cpu,21859,0,1,1,64,0,0,0,0,1,5960000
nn_kernel_gpu,412,1,1,46563,128,0,0,0,0,1,5960000
nn_kernel_gpu_mem,10792,1,1,46563,128,47680000,23840000,23840000,47680000,1,5960000
nn_kernel_cpu,28203,0,1,1,64,0,0,0,0,1,5970000
nn_kernel_gpu,408,1,1,46641,128,0,0,0,0,1,5970000
nn_kernel_gpu_mem,11209,1,1,46641,128,47760000,23880000,23880000,47760000,1,5970000
nn_kernel_cpu,28349,0,1,1,64,0,0,0,0,1,5980000
nn_kernel_gpu,406,1,1,46719,128,0,0,0,0,1,5980000
nn_kernel_gpu_mem,10507,1,1,46719,128,47840000,23920000,23920000,47840000,1,5980000
nn_kernel_cpu,11879,0,1,1,64,0,0,0,0,1,5990000
nn_kernel_gpu,396,1,1,46797,128,0,0,0,0,1,5990000
nn_kernel_gpu_mem,7362,1,1,46797,128,47920000,23960000,23960000,47920000,1,5990000
nn_kernel_cpu,9402,0,1,1,64,0,0,0,0,1,6000000
nn_kernel_gpu,409,1,1,46875,128,0,0,0,0,1,6000000
nn_kernel_gpu_mem,8074,1,1,46875,128,48000000,24000000,24000000,48000000,1,6000000
nn_kernel_cpu,26147,0,1,1,64,0,0,0,0,1,600000
nn_kernel_gpu,87,1,1,4688,128,0,0,0,0,1,600000
nn_kernel_gpu_mem,1235,1,1,4688,128,4800000,2400000,2400000,4800000,1,600000
nn_kernel_cpu,413,0,1,1,64,0,0,0,0,1,60000
nn_kernel_gpu,39,1,1,469,128,0,0,0,0,1,60000
nn_kernel_gpu_mem,141,1,1,469,128,480000,240000,240000,480000,1,60000
nn_kernel_cpu,36129,0,1,1,64,0,0,0,0,1,6010000
nn_kernel_gpu,409,1,1,46954,128,0,0,0,0,1,6010000
nn_kernel_gpu_mem,7794,1,1,46954,128,48080000,24040000,24040000,48080000,1,6010000
nn_kernel_cpu,16512,0,1,1,64,0,0,0,0,1,6020000
nn_kernel_gpu,401,1,1,47032,128,0,0,0,0,1,6020000
nn_kernel_gpu_mem,10705,1,1,47032,128,48160000,24080000,24080000,48160000,1,6020000
nn_kernel_cpu,35636,0,1,1,64,0,0,0,0,1,6030000
nn_kernel_gpu,403,1,1,47110,128,0,0,0,0,1,6030000
nn_kernel_gpu_mem,10855,1,1,47110,128,48240000,24120000,24120000,48240000,1,6030000
nn_kernel_cpu,31809,0,1,1,64,0,0,0,0,1,6040000
nn_kernel_gpu,392,1,1,47188,128,0,0,0,0,1,6040000
nn_kernel_gpu_mem,7272,1,1,47188,128,48320000,24160000,24160000,48320000,1,6040000
nn_kernel_cpu,35862,0,1,1,64,0,0,0,0,1,6050000
nn_kernel_gpu,410,1,1,47266,128,0,0,0,0,1,6050000
nn_kernel_gpu_mem,8888,1,1,47266,128,48400000,24200000,24200000,48400000,1,6050000
nn_kernel_cpu,27413,0,1,1,64,0,0,0,0,1,6060000
nn_kernel_gpu,412,1,1,47344,128,0,0,0,0,1,6060000
nn_kernel_gpu_mem,7419,1,1,47344,128,48480000,24240000,24240000,48480000,1,6060000
nn_kernel_cpu,21801,0,1,1,64,0,0,0,0,1,6070000
nn_kernel_gpu,409,1,1,47422,128,0,0,0,0,1,6070000
nn_kernel_gpu_mem,7748,1,1,47422,128,48560000,24280000,24280000,48560000,1,6070000
nn_kernel_cpu,18219,0,1,1,64,0,0,0,0,1,6080000
nn_kernel_gpu,407,1,1,47500,128,0,0,0,0,1,6080000
nn_kernel_gpu_mem,11088,1,1,47500,128,48640000,24320000,24320000,48640000,1,6080000
nn_kernel_cpu,26105,0,1,1,64,0,0,0,0,1,6090000
nn_kernel_gpu,411,1,1,47579,128,0,0,0,0,1,6090000
nn_kernel_gpu_mem,7583,1,1,47579,128,48720000,24360000,24360000,48720000,1,6090000
nn_kernel_cpu,16470,0,1,1,64,0,0,0,0,1,6100000
nn_kernel_gpu,410,1,1,47657,128,0,0,0,0,1,6100000
nn_kernel_gpu_mem,7428,1,1,47657,128,48800000,24400000,24400000,48800000,1,6100000
nn_kernel_cpu,23811,0,1,1,64,0,0,0,0,1,610000
nn_kernel_gpu,76,1,1,4766,128,0,0,0,0,1,610000
nn_kernel_gpu_mem,1258,1,1,4766,128,4880000,2440000,2440000,4880000,1,610000
nn_kernel_cpu,15203,0,1,1,64,0,0,0,0,1,6110000
nn_kernel_gpu,419,1,1,47735,128,0,0,0,0,1,6110000
nn_kernel_gpu_mem,10727,1,1,47735,128,48880000,24440000,24440000,48880000,1,6110000
nn_kernel_cpu,36167,0,1,1,64,0,0,0,0,1,6120000
nn_kernel_gpu,402,1,1,47813,128,0,0,0,0,1,6120000
nn_kernel_gpu_mem,7427,1,1,47813,128,48960000,24480000,24480000,48960000,1,6120000
nn_kernel_cpu,19916,0,1,1,64,0,0,0,0,1,6130000
nn_kernel_gpu,411,1,1,47891,128,0,0,0,0,1,6130000
nn_kernel_gpu_mem,8623,1,1,47891,128,49040000,24520000,24520000,49040000,1,6130000
nn_kernel_cpu,37592,0,1,1,64,0,0,0,0,1,6140000
nn_kernel_gpu,420,1,1,47969,128,0,0,0,0,1,6140000
nn_kernel_gpu_mem,10490,1,1,47969,128,49120000,24560000,24560000,49120000,1,6140000
nn_kernel_cpu,21864,0,1,1,64,0,0,0,0,1,6150000
nn_kernel_gpu,409,1,1,48047,128,0,0,0,0,1,6150000
nn_kernel_gpu_mem,7638,1,1,48047,128,49200000,24600000,24600000,49200000,1,6150000
nn_kernel_cpu,3903,0,1,1,64,0,0,0,0,1,6160000
nn_kernel_gpu,413,1,1,48125,128,0,0,0,0,1,6160000
nn_kernel_gpu_mem,8502,1,1,48125,128,49280000,24640000,24640000,49280000,1,6160000
nn_kernel_cpu,8056,0,1,1,64,0,0,0,0,1,6170000
nn_kernel_gpu,421,1,1,48204,128,0,0,0,0,1,6170000
nn_kernel_gpu_mem,9399,1,1,48204,128,49360000,24680000,24680000,49360000,1,6170000
nn_kernel_cpu,23545,0,1,1,64,0,0,0,0,1,6180000
nn_kernel_gpu,412,1,1,48282,128,0,0,0,0,1,6180000
nn_kernel_gpu_mem,7552,1,1,48282,128,49440000,24720000,24720000,49440000,1,6180000
nn_kernel_cpu,4506,0,1,1,64,0,0,0,0,1,6190000
nn_kernel_gpu,407,1,1,48360,128,0,0,0,0,1,6190000
nn_kernel_gpu_mem,10124,1,1,48360,128,49520000,24760000,24760000,49520000,1,6190000
nn_kernel_cpu,35948,0,1,1,64,0,0,0,0,1,6200000
nn_kernel_gpu,408,1,1,48438,128,0,0,0,0,1,6200000
nn_kernel_gpu_mem,7791,1,1,48438,128,49600000,24800000,24800000,49600000,1,6200000
nn_kernel_cpu,39831,0,1,1,64,0,0,0,0,1,620000
nn_kernel_gpu,89,1,1,4844,128,0,0,0,0,1,620000
nn_kernel_gpu_mem,1620,1,1,4844,128,4960000,2480000,2480000,4960000,1,620000
nn_kernel_cpu,23399,0,1,1,64,0,0,0,0,1,6210000
nn_kernel_gpu,424,1,1,48516,128,0,0,0,0,1,6210000
nn_kernel_gpu_mem,11246,1,1,48516,128,49680000,24840000,24840000,49680000,1,6210000
nn_kernel_cpu,20543,0,1,1,64,0,0,0,0,1,6220000
nn_kernel_gpu,416,1,1,48594,128,0,0,0,0,1,6220000
nn_kernel_gpu_mem,8360,1,1,48594,128,49760000,24880000,24880000,49760000,1,6220000
nn_kernel_cpu,22815,0,1,1,64,0,0,0,0,1,6230000
nn_kernel_gpu,420,1,1,48672,128,0,0,0,0,1,6230000
nn_kernel_gpu_mem,8062,1,1,48672,128,49840000,24920000,24920000,49840000,1,6230000
nn_kernel_cpu,25592,0,1,1,64,0,0,0,0,1,6240000
nn_kernel_gpu,421,1,1,48750,128,0,0,0,0,1,6240000
nn_kernel_gpu_mem,11112,1,1,48750,128,49920000,24960000,24960000,49920000,1,6240000
nn_kernel_cpu,23738,0,1,1,64,0,0,0,0,1,6250000
nn_kernel_gpu,400,1,1,48829,128,0,0,0,0,1,6250000
nn_kernel_gpu_mem,7616,1,1,48829,128,50000000,25000000,25000000,50000000,1,6250000
nn_kernel_cpu,19162,0,1,1,64,0,0,0,0,1,6260000
nn_kernel_gpu,415,1,1,48907,128,0,0,0,0,1,6260000
nn_kernel_gpu_mem,11040,1,1,48907,128,50080000,25040000,25040000,50080000,1,6260000
nn_kernel_cpu,27855,0,1,1,64,0,0,0,0,1,6270000
nn_kernel_gpu,417,1,1,48985,128,0,0,0,0,1,6270000
nn_kernel_gpu_mem,10177,1,1,48985,128,50160000,25080000,25080000,50160000,1,6270000
nn_kernel_cpu,25110,0,1,1,64,0,0,0,0,1,6280000
nn_kernel_gpu,404,1,1,49063,128,0,0,0,0,1,6280000
nn_kernel_gpu_mem,7897,1,1,49063,128,50240000,25120000,25120000,50240000,1,6280000
nn_kernel_cpu,16463,0,1,1,64,0,0,0,0,1,6290000
nn_kernel_gpu,422,1,1,49141,128,0,0,0,0,1,6290000
nn_kernel_gpu_mem,11210,1,1,49141,128,50320000,25160000,25160000,50320000,1,6290000
nn_kernel_cpu,24618,0,1,1,64,0,0,0,0,1,6300000
nn_kernel_gpu,463,1,1,49219,128,0,0,0,0,1,6300000
nn_kernel_gpu_mem,11293,1,1,49219,128,50400000,25200000,25200000,50400000,1,6300000
nn_kernel_cpu,18815,0,1,1,64,0,0,0,0,1,630000
nn_kernel_gpu,88,1,1,4922,128,0,0,0,0,1,630000
nn_kernel_gpu_mem,1857,1,1,4922,128,5040000,2520000,2520000,5040000,1,630000
nn_kernel_cpu,25655,0,1,1,64,0,0,0,0,1,6310000
nn_kernel_gpu,422,1,1,49297,128,0,0,0,0,1,6310000
nn_kernel_gpu_mem,11445,1,1,49297,128,50480000,25240000,25240000,50480000,1,6310000
nn_kernel_cpu,25056,0,1,1,64,0,0,0,0,1,6320000
nn_kernel_gpu,417,1,1,49375,128,0,0,0,0,1,6320000
nn_kernel_gpu_mem,7367,1,1,49375,128,50560000,25280000,25280000,50560000,1,6320000
nn_kernel_cpu,4126,0,1,1,64,0,0,0,0,1,6330000
nn_kernel_gpu,412,1,1,49454,128,0,0,0,0,1,6330000
nn_kernel_gpu_mem,10411,1,1,49454,128,50640000,25320000,25320000,50640000,1,6330000
nn_kernel_cpu,15869,0,1,1,64,0,0,0,0,1,6340000
nn_kernel_gpu,424,1,1,49532,128,0,0,0,0,1,6340000
nn_kernel_gpu_mem,11839,1,1,49532,128,50720000,25360000,25360000,50720000,1,6340000
nn_kernel_cpu,8678,0,1,1,64,0,0,0,0,1,6350000
nn_kernel_gpu,426,1,1,49610,128,0,0,0,0,1,6350000
nn_kernel_gpu_mem,10218,1,1,49610,128,50800000,25400000,25400000,50800000,1,6350000
nn_kernel_cpu,14453,0,1,1,64,0,0,0,0,1,6360000
nn_kernel_gpu,408,1,1,49688,128,0,0,0,0,1,6360000
nn_kernel_gpu_mem,8965,1,1,49688,128,50880000,25440000,25440000,50880000,1,6360000
nn_kernel_cpu,23964,0,1,1,64,0,0,0,0,1,6370000
nn_kernel_gpu,405,1,1,49766,128,0,0,0,0,1,6370000
nn_kernel_gpu_mem,10243,1,1,49766,128,50960000,25480000,25480000,50960000,1,6370000
nn_kernel_cpu,23307,0,1,1,64,0,0,0,0,1,6380000
nn_kernel_gpu,409,1,1,49844,128,0,0,0,0,1,6380000
nn_kernel_gpu_mem,10442,1,1,49844,128,51040000,25520000,25520000,51040000,1,6380000
nn_kernel_cpu,23136,0,1,1,64,0,0,0,0,1,6390000
nn_kernel_gpu,419,1,1,49922,128,0,0,0,0,1,6390000
nn_kernel_gpu_mem,9274,1,1,49922,128,51120000,25560000,25560000,51120000,1,6390000
nn_kernel_cpu,25556,0,1,1,64,0,0,0,0,1,6400000
nn_kernel_gpu,428,1,1,50000,128,0,0,0,0,1,6400000
nn_kernel_gpu_mem,10385,1,1,50000,128,51200000,25600000,25600000,51200000,1,6400000
nn_kernel_cpu,29485,0,1,1,64,0,0,0,0,1,640000
nn_kernel_gpu,89,1,1,5000,128,0,0,0,0,1,640000
nn_kernel_gpu_mem,1373,1,1,5000,128,5120000,2560000,2560000,5120000,1,640000
nn_kernel_cpu,14373,0,1,1,64,0,0,0,0,1,6410000
nn_kernel_gpu,427,1,1,50079,128,0,0,0,0,1,6410000
nn_kernel_gpu_mem,9056,1,1,50079,128,51280000,25640000,25640000,51280000,1,6410000
nn_kernel_cpu,11074,0,1,1,64,0,0,0,0,1,6420000
nn_kernel_gpu,411,1,1,50157,128,0,0,0,0,1,6420000
nn_kernel_gpu_mem,9168,1,1,50157,128,51360000,25680000,25680000,51360000,1,6420000
nn_kernel_cpu,8941,0,1,1,64,0,0,0,0,1,6430000
nn_kernel_gpu,435,1,1,50235,128,0,0,0,0,1,6430000
nn_kernel_gpu_mem,9171,1,1,50235,128,51440000,25720000,25720000,51440000,1,6430000
nn_kernel_cpu,10243,0,1,1,64,0,0,0,0,1,6440000
nn_kernel_gpu,427,1,1,50313,128,0,0,0,0,1,6440000
nn_kernel_gpu_mem,10555,1,1,50313,128,51520000,25760000,25760000,51520000,1,6440000
nn_kernel_cpu,5478,0,1,1,64,0,0,0,0,1,6450000
nn_kernel_gpu,430,1,1,50391,128,0,0,0,0,1,6450000
nn_kernel_gpu_mem,8792,1,1,50391,128,51600000,25800000,25800000,51600000,1,6450000
nn_kernel_cpu,6289,0,1,1,64,0,0,0,0,1,6460000
nn_kernel_gpu,435,1,1,50469,128,0,0,0,0,1,6460000
nn_kernel_gpu_mem,9303,1,1,50469,128,51680000,25840000,25840000,51680000,1,6460000
nn_kernel_cpu,5269,0,1,1,64,0,0,0,0,1,6470000
nn_kernel_gpu,426,1,1,50547,128,0,0,0,0,1,6470000
nn_kernel_gpu_mem,11060,1,1,50547,128,51760000,25880000,25880000,51760000,1,6470000
nn_kernel_cpu,6769,0,1,1,64,0,0,0,0,1,6480000
nn_kernel_gpu,435,1,1,50625,128,0,0,0,0,1,6480000
nn_kernel_gpu_mem,9421,1,1,50625,128,51840000,25920000,25920000,51840000,1,6480000
nn_kernel_cpu,6684,0,1,1,64,0,0,0,0,1,6490000
nn_kernel_gpu,430,1,1,50704,128,0,0,0,0,1,6490000
nn_kernel_gpu_mem,11425,1,1,50704,128,51920000,25960000,25960000,51920000,1,6490000
nn_kernel_cpu,5066,0,1,1,64,0,0,0,0,1,6500000
nn_kernel_gpu,445,1,1,50782,128,0,0,0,0,1,6500000
nn_kernel_gpu_mem,9280,1,1,50782,128,52000000,26000000,26000000,52000000,1,6500000
nn_kernel_cpu,16074,0,1,1,64,0,0,0,0,1,650000
nn_kernel_gpu,98,1,1,5079,128,0,0,0,0,1,650000
nn_kernel_gpu_mem,1396,1,1,5079,128,5200000,2600000,2600000,5200000,1,650000
nn_kernel_cpu,22717,0,1,1,64,0,0,0,0,1,6510000
nn_kernel_gpu,433,1,1,50860,128,0,0,0,0,1,6510000
nn_kernel_gpu_mem,10935,1,1,50860,128,52080000,26040000,26040000,52080000,1,6510000
nn_kernel_cpu,8088,0,1,1,64,0,0,0,0,1,6520000
nn_kernel_gpu,432,1,1,50938,128,0,0,0,0,1,6520000
nn_kernel_gpu_mem,9479,1,1,50938,128,52160000,26080000,26080000,52160000,1,6520000
nn_kernel_cpu,14691,0,1,1,64,0,0,0,0,1,6530000
nn_kernel_gpu,437,1,1,51016,128,0,0,0,0,1,6530000
nn_kernel_gpu_mem,9251,1,1,51016,128,52240000,26120000,26120000,52240000,1,6530000
nn_kernel_cpu,4916,0,1,1,64,0,0,0,0,1,6540000
nn_kernel_gpu,430,1,1,51094,128,0,0,0,0,1,6540000
nn_kernel_gpu_mem,9497,1,1,51094,128,52320000,26160000,26160000,52320000,1,6540000
nn_kernel_cpu,7958,0,1,1,64,0,0,0,0,1,6550000
nn_kernel_gpu,438,1,1,51172,128,0,0,0,0,1,6550000
nn_kernel_gpu_mem,10600,1,1,51172,128,52400000,26200000,26200000,52400000,1,6550000
nn_kernel_cpu,22717,0,1,1,64,0,0,0,0,1,6560000
nn_kernel_gpu,440,1,1,51250,128,0,0,0,0,1,6560000
nn_kernel_gpu_mem,9459,1,1,51250,128,52480000,26240000,26240000,52480000,1,6560000
nn_kernel_cpu,15015,0,1,1,64,0,0,0,0,1,6570000
nn_kernel_gpu,439,1,1,51329,128,0,0,0,0,1,6570000
nn_kernel_gpu_mem,9500,1,1,51329,128,52560000,26280000,26280000,52560000,1,6570000
nn_kernel_cpu,4369,0,1,1,64,0,0,0,0,1,6580000
nn_kernel_gpu,435,1,1,51407,128,0,0,0,0,1,6580000
nn_kernel_gpu_mem,9630,1,1,51407,128,52640000,26320000,26320000,52640000,1,6580000
nn_kernel_cpu,35998,0,1,1,64,0,0,0,0,1,6590000
nn_kernel_gpu,435,1,1,51485,128,0,0,0,0,1,6590000
nn_kernel_gpu_mem,9886,1,1,51485,128,52720000,26360000,26360000,52720000,1,6590000
nn_kernel_cpu,6652,0,1,1,64,0,0,0,0,1,6600000
nn_kernel_gpu,425,1,1,51563,128,0,0,0,0,1,6600000
nn_kernel_gpu_mem,11467,1,1,51563,128,52800000,26400000,26400000,52800000,1,6600000
nn_kernel_cpu,16174,0,1,1,64,0,0,0,0,1,660000
nn_kernel_gpu,90,1,1,5157,128,0,0,0,0,1,660000
nn_kernel_gpu_mem,1349,1,1,5157,128,5280000,2640000,2640000,5280000,1,660000
nn_kernel_cpu,18173,0,1,1,64,0,0,0,0,1,6610000
nn_kernel_gpu,435,1,1,51641,128,0,0,0,0,1,6610000
nn_kernel_gpu_mem,9712,1,1,51641,128,52880000,26440000,26440000,52880000,1,6610000
nn_kernel_cpu,5433,0,1,1,64,0,0,0,0,1,6620000
nn_kernel_gpu,422,1,1,51719,128,0,0,0,0,1,6620000
nn_kernel_gpu_mem,10998,1,1,51719,128,52960000,26480000,26480000,52960000,1,6620000
nn_kernel_cpu,10028,0,1,1,64,0,0,0,0,1,6630000
nn_kernel_gpu,439,1,1,51797,128,0,0,0,0,1,6630000
nn_kernel_gpu_mem,12570,1,1,51797,128,53040000,26520000,26520000,53040000,1,6630000
nn_kernel_cpu,21151,0,1,1,64,0,0,0,0,1,6640000
nn_kernel_gpu,437,1,1,51875,128,0,0,0,0,1,6640000
nn_kernel_gpu_mem,10256,1,1,51875,128,53120000,26560000,26560000,53120000,1,6640000
nn_kernel_cpu,24201,0,1,1,64,0,0,0,0,1,6650000
nn_kernel_gpu,442,1,1,51954,128,0,0,0,0,1,6650000
nn_kernel_gpu_mem,9539,1,1,51954,128,53200000,26600000,26600000,53200000,1,6650000
nn_kernel_cpu,12628,0,1,1,64,0,0,0,0,1,6660000
nn_kernel_gpu,451,1,1,52032,128,0,0,0,0,1,6660000
nn_kernel_gpu_mem,15009,1,1,52032,128,53280000,26640000,26640000,53280000,1,6660000
nn_kernel_cpu,9870,0,1,1,64,0,0,0,0,1,6670000
nn_kernel_gpu,451,1,1,52110,128,0,0,0,0,1,6670000
nn_kernel_gpu_mem,9888,1,1,52110,128,53360000,26680000,26680000,53360000,1,6670000
nn_kernel_cpu,23253,0,1,1,64,0,0,0,0,1,6680000
nn_kernel_gpu,440,1,1,52188,128,0,0,0,0,1,6680000
nn_kernel_gpu_mem,10060,1,1,52188,128,53440000,26720000,26720000,53440000,1,6680000
nn_kernel_cpu,5276,0,1,1,64,0,0,0,0,1,6690000
nn_kernel_gpu,427,1,1,52266,128,0,0,0,0,1,6690000
nn_kernel_gpu_mem,10420,1,1,52266,128,53520000,26760000,26760000,53520000,1,6690000
nn_kernel_cpu,6855,0,1,1,64,0,0,0,0,1,6700000
nn_kernel_gpu,449,1,1,52344,128,0,0,0,0,1,6700000
nn_kernel_gpu_mem,9925,1,1,52344,128,53600000,26800000,26800000,53600000,1,6700000
nn_kernel_cpu,18921,0,1,1,64,0,0,0,0,1,670000
nn_kernel_gpu,82,1,1,5235,128,0,0,0,0,1,670000
nn_kernel_gpu_mem,1469,1,1,5235,128,5360000,2680000,2680000,5360000,1,670000
nn_kernel_cpu,8753,0,1,1,64,0,0,0,0,1,6710000
nn_kernel_gpu,428,1,1,52422,128,0,0,0,0,1,6710000
nn_kernel_gpu_mem,10818,1,1,52422,128,53680000,26840000,26840000,53680000,1,6710000
nn_kernel_cpu,4741,0,1,1,64,0,0,0,0,1,6720000
nn_kernel_gpu,430,1,1,52500,128,0,0,0,0,1,6720000
nn_kernel_gpu_mem,10642,1,1,52500,128,53760000,26880000,26880000,53760000,1,6720000
nn_kernel_cpu,18568,0,1,1,64,0,0,0,0,1,6730000
nn_kernel_gpu,449,1,1,52579,128,0,0,0,0,1,6730000
nn_kernel_gpu_mem,11854,1,1,52579,128,53840000,26920000,26920000,53840000,1,6730000
nn_kernel_cpu,8921,0,1,1,64,0,0,0,0,1,6740000
nn_kernel_gpu,458,1,1,52657,128,0,0,0,0,1,6740000
nn_kernel_gpu_mem,10042,1,1,52657,128,53920000,26960000,26960000,53920000,1,6740000
nn_kernel_cpu,29901,0,1,1,64,0,0,0,0,1,6750000
nn_kernel_gpu,449,1,1,52735,128,0,0,0,0,1,6750000
nn_kernel_gpu_mem,11708,1,1,52735,128,54000000,27000000,27000000,54000000,1,6750000
nn_kernel_cpu,23585,0,1,1,64,0,0,0,0,1,6760000
nn_kernel_gpu,440,1,1,52813,128,0,0,0,0,1,6760000
nn_kernel_gpu_mem,11611,1,1,52813,128,54080000,27040000,27040000,54080000,1,6760000
nn_kernel_cpu,8616,0,1,1,64,0,0,0,0,1,6770000
nn_kernel_gpu,444,1,1,52891,128,0,0,0,0,1,6770000
nn_kernel_gpu_mem,13199,1,1,52891,128,54160000,27080000,27080000,54160000,1,6770000
nn_kernel_cpu,7977,0,1,1,64,0,0,0,0,1,6780000
nn_kernel_gpu,447,1,1,52969,128,0,0,0,0,1,6780000
nn_kernel_gpu_mem,9952,1,1,52969,128,54240000,27120000,27120000,54240000,1,6780000
nn_kernel_cpu,35315,0,1,1,64,0,0,0,0,1,6790000
nn_kernel_gpu,436,1,1,53047,128,0,0,0,0,1,6790000
nn_kernel_gpu_mem,11048,1,1,53047,128,54320000,27160000,27160000,54320000,1,6790000
nn_kernel_cpu,30594,0,1,1,64,0,0,0,0,1,6800000
nn_kernel_gpu,449,1,1,53125,128,0,0,0,0,1,6800000
nn_kernel_gpu_mem,11997,1,1,53125,128,54400000,27200000,27200000,54400000,1,6800000
nn_kernel_cpu,947,0,1,1,64,0,0,0,0,1,680000
nn_kernel_gpu,99,1,1,5313,128,0,0,0,0,1,680000
nn_kernel_gpu_mem,1478,1,1,5313,128,5440000,2720000,2720000,5440000,1,680000
nn_kernel_cpu,12081,0,1,1,64,0,0,0,0,1,6810000
nn_kernel_gpu,444,1,1,53204,128,0,0,0,0,1,6810000
nn_kernel_gpu_mem,10492,1,1,53204,128,54480000,27240000,27240000,54480000,1,6810000
nn_kernel_cpu,11052,0,1,1,64,0,0,0,0,1,6820000
nn_kernel_gpu,445,1,1,53282,128,0,0,0,0,1,6820000
nn_kernel_gpu_mem,13428,1,1,53282,128,54560000,27280000,27280000,54560000,1,6820000
nn_kernel_cpu,24533,0,1,1,64,0,0,0,0,1,6830000
nn_kernel_gpu,439,1,1,53360,128,0,0,0,0,1,6830000
nn_kernel_gpu_mem,12166,1,1,53360,128,54640000,27320000,27320000,54640000,1,6830000
nn_kernel_cpu,12335,0,1,1,64,0,0,0,0,1,6840000
nn_kernel_gpu,441,1,1,53438,128,0,0,0,0,1,6840000
nn_kernel_gpu_mem,10016,1,1,53438,128,54720000,27360000,27360000,54720000,1,6840000
nn_kernel_cpu,23792,0,1,1,64,0,0,0,0,1,6850000
nn_kernel_gpu,443,1,1,53516,128,0,0,0,0,1,6850000
nn_kernel_gpu_mem,10081,1,1,53516,128,54800000,27400000,27400000,54800000,1,6850000
nn_kernel_cpu,4130,0,1,1,64,0,0,0,0,1,6860000
nn_kernel_gpu,458,1,1,53594,128,0,0,0,0,1,6860000
nn_kernel_gpu_mem,10050,1,1,53594,128,54880000,27440000,27440000,54880000,1,6860000
nn_kernel_cpu,26475,0,1,1,64,0,0,0,0,1,6870000
nn_kernel_gpu,453,1,1,53672,128,0,0,0,0,1,6870000
nn_kernel_gpu_mem,10263,1,1,53672,128,54960000,27480000,27480000,54960000,1,6870000
nn_kernel_cpu,18881,0,1,1,64,0,0,0,0,1,6880000
nn_kernel_gpu,449,1,1,53750,128,0,0,0,0,1,6880000
nn_kernel_gpu_mem,9003,1,1,53750,128,55040000,27520000,27520000,55040000,1,6880000
nn_kernel_cpu,24087,0,1,1,64,0,0,0,0,1,6890000
nn_kernel_gpu,441,1,1,53829,128,0,0,0,0,1,6890000
nn_kernel_gpu_mem,8441,1,1,53829,128,55120000,27560000,27560000,55120000,1,6890000
nn_kernel_cpu,32708,0,1,1,64,0,0,0,0,1,6900000
nn_kernel_gpu,449,1,1,53907,128,0,0,0,0,1,6900000
nn_kernel_gpu_mem,11152,1,1,53907,128,55200000,27600000,27600000,55200000,1,6900000
nn_kernel_cpu,23874,0,1,1,64,0,0,0,0,1,690000
nn_kernel_gpu,93,1,1,5391,128,0,0,0,0,1,690000
nn_kernel_gpu_mem,1553,1,1,5391,128,5520000,2760000,2760000,5520000,1,690000
nn_kernel_cpu,38702,0,1,1,64,0,0,0,0,1,6910000
nn_kernel_gpu,462,1,1,53985,128,0,0,0,0,1,6910000
nn_kernel_gpu_mem,10313,1,1,53985,128,55280000,27640000,27640000,55280000,1,6910000
nn_kernel_cpu,20375,0,1,1,64,0,0,0,0,1,6920000
nn_kernel_gpu,463,1,1,54063,128,0,0,0,0,1,6920000
nn_kernel_gpu_mem,10618,1,1,54063,128,55360000,27680000,27680000,55360000,1,6920000
nn_kernel_cpu,23322,0,1,1,64,0,0,0,0,1,6930000
nn_kernel_gpu,462,1,1,54141,128,0,0,0,0,1,6930000
nn_kernel_gpu_mem,10065,1,1,54141,128,55440000,27720000,27720000,55440000,1,6930000
nn_kernel_cpu,11708,0,1,1,64,0,0,0,0,1,6940000
nn_kernel_gpu,452,1,1,54219,128,0,0,0,0,1,6940000
nn_kernel_gpu_mem,11392,1,1,54219,128,55520000,27760000,27760000,55520000,1,6940000
nn_kernel_cpu,7612,0,1,1,64,0,0,0,0,1,6950000
nn_kernel_gpu,461,1,1,54297,128,0,0,0,0,1,6950000
nn_kernel_gpu_mem,11214,1,1,54297,128,55600000,27800000,27800000,55600000,1,6950000
nn_kernel_cpu,8392,0,1,1,64,0,0,0,0,1,6960000
nn_kernel_gpu,448,1,1,54375,128,0,0,0,0,1,6960000
nn_kernel_gpu_mem,11543,1,1,54375,128,55680000,27840000,27840000,55680000,1,6960000
nn_kernel_cpu,9381,0,1,1,64,0,0,0,0,1,6970000
nn_kernel_gpu,470,1,1,54454,128,0,0,0,0,1,6970000
nn_kernel_gpu_mem,9918,1,1,54454,128,55760000,27880000,27880000,55760000,1,6970000
nn_kernel_cpu,7850,0,1,1,64,0,0,0,0,1,6980000
nn_kernel_gpu,459,1,1,54532,128,0,0,0,0,1,6980000
nn_kernel_gpu_mem,10368,1,1,54532,128,55840000,27920000,27920000,55840000,1,6980000
nn_kernel_cpu,23097,0,1,1,64,0,0,0,0,1,6990000
nn_kernel_gpu,463,1,1,54610,128,0,0,0,0,1,6990000
nn_kernel_gpu_mem,14123,1,1,54610,128,55920000,27960000,27960000,55920000,1,6990000
nn_kernel_cpu,23588,0,1,1,64,0,0,0,0,1,7000000
nn_kernel_gpu,460,1,1,54688,128,0,0,0,0,1,7000000
nn_kernel_gpu_mem,10772,1,1,54688,128,56000000,28000000,28000000,56000000,1,7000000
nn_kernel_cpu,31719,0,1,1,64,0,0,0,0,1,700000
nn_kernel_gpu,97,1,1,5469,128,0,0,0,0,1,700000
nn_kernel_gpu_mem,2679,1,1,5469,128,5600000,2800000,2800000,5600000,1,700000
nn_kernel_cpu,14320,0,1,1,64,0,0,0,0,1,70000
nn_kernel_gpu,44,1,1,547,128,0,0,0,0,1,70000
nn_kernel_gpu_mem,221,1,1,547,128,560000,280000,280000,560000,1,70000
nn_kernel_cpu,15763,0,1,1,64,0,0,0,0,1,7010000
nn_kernel_gpu,463,1,1,54766,128,0,0,0,0,1,7010000
nn_kernel_gpu_mem,10360,1,1,54766,128,56080000,28040000,28040000,56080000,1,7010000
nn_kernel_cpu,6681,0,1,1,64,0,0,0,0,1,7020000
nn_kernel_gpu,449,1,1,54844,128,0,0,0,0,1,7020000
nn_kernel_gpu_mem,10888,1,1,54844,128,56160000,28080000,28080000,56160000,1,7020000
nn_kernel_cpu,18624,0,1,1,64,0,0,0,0,1,7030000
nn_kernel_gpu,448,1,1,54922,128,0,0,0,0,1,7030000
nn_kernel_gpu_mem,10928,1,1,54922,128,56240000,28120000,28120000,56240000,1,7030000
nn_kernel_cpu,11622,0,1,1,64,0,0,0,0,1,7040000
nn_kernel_gpu,462,1,1,55000,128,0,0,0,0,1,7040000
nn_kernel_gpu_mem,10093,1,1,55000,128,56320000,28160000,28160000,56320000,1,7040000
nn_kernel_cpu,24288,0,1,1,64,0,0,0,0,1,7050000
nn_kernel_gpu,464,1,1,55079,128,0,0,0,0,1,7050000
nn_kernel_gpu_mem,13060,1,1,55079,128,56400000,28200000,28200000,56400000,1,7050000
nn_kernel_cpu,4160,0,1,1,64,0,0,0,0,1,7060000
nn_kernel_gpu,459,1,1,55157,128,0,0,0,0,1,7060000
nn_kernel_gpu_mem,10789,1,1,55157,128,56480000,28240000,28240000,56480000,1,7060000
nn_kernel_cpu,7051,0,1,1,64,0,0,0,0,1,7070000
nn_kernel_gpu,458,1,1,55235,128,0,0,0,0,1,7070000
nn_kernel_gpu_mem,12422,1,1,55235,128,56560000,28280000,28280000,56560000,1,7070000
nn_kernel_cpu,5488,0,1,1,64,0,0,0,0,1,7080000
nn_kernel_gpu,454,1,1,55313,128,0,0,0,0,1,7080000
nn_kernel_gpu_mem,14887,1,1,55313,128,56640000,28320000,28320000,56640000,1,7080000
nn_kernel_cpu,13948,0,1,1,64,0,0,0,0,1,7090000
nn_kernel_gpu,462,1,1,55391,128,0,0,0,0,1,7090000
nn_kernel_gpu_mem,14464,1,1,55391,128,56720000,28360000,28360000,56720000,1,7090000
nn_kernel_cpu,29388,0,1,1,64,0,0,0,0,1,7100000
nn_kernel_gpu,475,1,1,55469,128,0,0,0,0,1,7100000
nn_kernel_gpu_mem,10837,1,1,55469,128,56800000,28400000,28400000,56800000,1,7100000
nn_kernel_cpu,27088,0,1,1,64,0,0,0,0,1,710000
nn_kernel_gpu,90,1,1,5547,128,0,0,0,0,1,710000
nn_kernel_gpu_mem,1572,1,1,5547,128,5680000,2840000,2840000,5680000,1,710000
nn_kernel_cpu,16043,0,1,1,64,0,0,0,0,1,7110000
nn_kernel_gpu,480,1,1,55547,128,0,0,0,0,1,7110000
nn_kernel_gpu_mem,10239,1,1,55547,128,56880000,28440000,28440000,56880000,1,7110000
nn_kernel_cpu,5275,0,1,1,64,0,0,0,0,1,7120000
nn_kernel_gpu,470,1,1,55625,128,0,0,0,0,1,7120000
nn_kernel_gpu_mem,10207,1,1,55625,128,56960000,28480000,28480000,56960000,1,7120000
nn_kernel_cpu,23068,0,1,1,64,0,0,0,0,1,7130000
nn_kernel_gpu,478,1,1,55704,128,0,0,0,0,1,7130000
nn_kernel_gpu_mem,10377,1,1,55704,128,57040000,28520000,28520000,57040000,1,7130000
nn_kernel_cpu,35513,0,1,1,64,0,0,0,0,1,7140000
nn_kernel_gpu,478,1,1,55782,128,0,0,0,0,1,7140000
nn_kernel_gpu_mem,12783,1,1,55782,128,57120000,28560000,28560000,57120000,1,7140000
nn_kernel_cpu,17959,0,1,1,64,0,0,0,0,1,7150000
nn_kernel_gpu,457,1,1,55860,128,0,0,0,0,1,7150000
nn_kernel_gpu_mem,8791,1,1,55860,128,57200000,28600000,28600000,57200000,1,7150000
nn_kernel_cpu,16642,0,1,1,64,0,0,0,0,1,7160000
nn_kernel_gpu,476,1,1,55938,128,0,0,0,0,1,7160000
nn_kernel_gpu_mem,13069,1,1,55938,128,57280000,28640000,28640000,57280000,1,7160000
nn_kernel_cpu,34705,0,1,1,64,0,0,0,0,1,7170000
nn_kernel_gpu,462,1,1,56016,128,0,0,0,0,1,7170000
nn_kernel_gpu_mem,8675,1,1,56016,128,57360000,28680000,28680000,57360000,1,7170000
nn_kernel_cpu,23827,0,1,1,64,0,0,0,0,1,7180000
nn_kernel_gpu,465,1,1,56094,128,0,0,0,0,1,7180000
nn_kernel_gpu_mem,9302,1,1,56094,128,57440000,28720000,28720000,57440000,1,7180000
nn_kernel_cpu,11199,0,1,1,64,0,0,0,0,1,7190000
nn_kernel_gpu,458,1,1,56172,128,0,0,0,0,1,7190000
nn_kernel_gpu_mem,22944,1,1,56172,128,57520000,28760000,28760000,57520000,1,7190000
nn_kernel_cpu,15222,0,1,1,64,0,0,0,0,1,7200000
nn_kernel_gpu,471,1,1,56250,128,0,0,0,0,1,7200000
nn_kernel_gpu_mem,8064,1,1,56250,128,57600000,28800000,28800000,57600000,1,7200000
nn_kernel_cpu,4144,0,1,1,64,0,0,0,0,1,720000
nn_kernel_gpu,82,1,1,5625,128,0,0,0,0,1,720000
nn_kernel_gpu_mem,1266,1,1,5625,128,5760000,2880000,2880000,5760000,1,720000
nn_kernel_cpu,36011,0,1,1,64,0,0,0,0,1,7210000
nn_kernel_gpu,468,1,1,56329,128,0,0,0,0,1,7210000
nn_kernel_gpu_mem,8830,1,1,56329,128,57680000,28840000,28840000,57680000,1,7210000
nn_kernel_cpu,25242,0,1,1,64,0,0,0,0,1,7220000
nn_kernel_gpu,473,1,1,56407,128,0,0,0,0,1,7220000
nn_kernel_gpu_mem,8133,1,1,56407,128,57760000,28880000,28880000,57760000,1,7220000
nn_kernel_cpu,16333,0,1,1,64,0,0,0,0,1,7230000
nn_kernel_gpu,469,1,1,56485,128,0,0,0,0,1,7230000
nn_kernel_gpu_mem,8464,1,1,56485,128,57840000,28920000,28920000,57840000,1,7230000
nn_kernel_cpu,15481,0,1,1,64,0,0,0,0,1,7240000
nn_kernel_gpu,473,1,1,56563,128,0,0,0,0,1,7240000
nn_kernel_gpu_mem,8643,1,1,56563,128,57920000,28960000,28960000,57920000,1,7240000
nn_kernel_cpu,20611,0,1,1,64,0,0,0,0,1,7250000
nn_kernel_gpu,462,1,1,56641,128,0,0,0,0,1,7250000
nn_kernel_gpu_mem,8668,1,1,56641,128,58000000,29000000,29000000,58000000,1,7250000
nn_kernel_cpu,28737,0,1,1,64,0,0,0,0,1,7260000
nn_kernel_gpu,482,1,1,56719,128,0,0,0,0,1,7260000
nn_kernel_gpu_mem,12854,1,1,56719,128,58080000,29040000,29040000,58080000,1,7260000
nn_kernel_cpu,10313,0,1,1,64,0,0,0,0,1,7270000
nn_kernel_gpu,472,1,1,56797,128,0,0,0,0,1,7270000
nn_kernel_gpu_mem,11404,1,1,56797,128,58160000,29080000,29080000,58160000,1,7270000
nn_kernel_cpu,17983,0,1,1,64,0,0,0,0,1,7280000
nn_kernel_gpu,467,1,1,56875,128,0,0,0,0,1,7280000
nn_kernel_gpu_mem,8105,1,1,56875,128,58240000,29120000,29120000,58240000,1,7280000
nn_kernel_cpu,23028,0,1,1,64,0,0,0,0,1,7290000
nn_kernel_gpu,478,1,1,56954,128,0,0,0,0,1,7290000
nn_kernel_gpu_mem,8602,1,1,56954,128,58320000,29160000,29160000,58320000,1,7290000
nn_kernel_cpu,22755,0,1,1,64,0,0,0,0,1,7300000
nn_kernel_gpu,465,1,1,57032,128,0,0,0,0,1,7300000
nn_kernel_gpu_mem,8892,1,1,57032,128,58400000,29200000,29200000,58400000,1,7300000
nn_kernel_cpu,16034,0,1,1,64,0,0,0,0,1,730000
nn_kernel_gpu,101,1,1,5704,128,0,0,0,0,1,730000
nn_kernel_gpu_mem,4325,1,1,5704,128,5840000,2920000,2920000,5840000,1,730000
nn_kernel_cpu,35942,0,1,1,64,0,0,0,0,1,7310000
nn_kernel_gpu,480,1,1,57110,128,0,0,0,0,1,7310000
nn_kernel_gpu_mem,9221,1,1,57110,128,58480000,29240000,29240000,58480000,1,7310000
nn_kernel_cpu,31608,0,1,1,64,0,0,0,0,1,7320000
nn_kernel_gpu,477,1,1,57188,128,0,0,0,0,1,7320000
nn_kernel_gpu_mem,19786,1,1,57188,128,58560000,29280000,29280000,58560000,1,7320000
nn_kernel_cpu,29419,0,1,1,64,0,0,0,0,1,7330000
nn_kernel_gpu,481,1,1,57266,128,0,0,0,0,1,7330000
nn_kernel_gpu_mem,8257,1,1,57266,128,58640000,29320000,29320000,58640000,1,7330000
nn_kernel_cpu,26926,0,1,1,64,0,0,0,0,1,7340000
nn_kernel_gpu,483,1,1,57344,128,0,0,0,0,1,7340000
nn_kernel_gpu_mem,9378,1,1,57344,128,58720000,29360000,29360000,58720000,1,7340000
nn_kernel_cpu,24880,0,1,1,64,0,0,0,0,1,7350000
nn_kernel_gpu,482,1,1,57422,128,0,0,0,0,1,7350000
nn_kernel_gpu_mem,9416,1,1,57422,128,58800000,29400000,29400000,58800000,1,7350000
nn_kernel_cpu,16626,0,1,1,64,0,0,0,0,1,7360000
nn_kernel_gpu,481,1,1,57500,128,0,0,0,0,1,7360000
nn_kernel_gpu_mem,12827,1,1,57500,128,58880000,29440000,29440000,58880000,1,7360000
nn_kernel_cpu,19262,0,1,1,64,0,0,0,0,1,7370000
nn_kernel_gpu,474,1,1,57579,128,0,0,0,0,1,7370000
nn_kernel_gpu_mem,9059,1,1,57579,128,58960000,29480000,29480000,58960000,1,7370000
nn_kernel_cpu,9456,0,1,1,64,0,0,0,0,1,7380000
nn_kernel_gpu,488,1,1,57657,128,0,0,0,0,1,7380000
nn_kernel_gpu_mem,14594,1,1,57657,128,59040000,29520000,29520000,59040000,1,7380000
nn_kernel_cpu,13652,0,1,1,64,0,0,0,0,1,7390000
nn_kernel_gpu,479,1,1,57735,128,0,0,0,0,1,7390000
nn_kernel_gpu_mem,12796,1,1,57735,128,59120000,29560000,29560000,59120000,1,7390000
nn_kernel_cpu,15902,0,1,1,64,0,0,0,0,1,7400000
nn_kernel_gpu,489,1,1,57813,128,0,0,0,0,1,7400000
nn_kernel_gpu_mem,10457,1,1,57813,128,59200000,29600000,29600000,59200000,1,7400000
nn_kernel_cpu,24399,0,1,1,64,0,0,0,0,1,740000
nn_kernel_gpu,92,1,1,5782,128,0,0,0,0,1,740000
nn_kernel_gpu_mem,1601,1,1,5782,128,5920000,2960000,2960000,5920000,1,740000
nn_kernel_cpu,23703,0,1,1,64,0,0,0,0,1,7410000
nn_kernel_gpu,478,1,1,57891,128,0,0,0,0,1,7410000
nn_kernel_gpu_mem,12194,1,1,57891,128,59280000,29640000,29640000,59280000,1,7410000
nn_kernel_cpu,8209,0,1,1,64,0,0,0,0,1,7420000
nn_kernel_gpu,486,1,1,57969,128,0,0,0,0,1,7420000
nn_kernel_gpu_mem,17452,1,1,57969,128,59360000,29680000,29680000,59360000,1,7420000
nn_kernel_cpu,6615,0,1,1,64,0,0,0,0,1,7430000
nn_kernel_gpu,485,1,1,58047,128,0,0,0,0,1,7430000
nn_kernel_gpu_mem,10805,1,1,58047,128,59440000,29720000,29720000,59440000,1,7430000
nn_kernel_cpu,7244,0,1,1,64,0,0,0,0,1,7440000
nn_kernel_gpu,496,1,1,58125,128,0,0,0,0,1,7440000
nn_kernel_gpu_mem,10469,1,1,58125,128,59520000,29760000,29760000,59520000,1,7440000
nn_kernel_cpu,22398,0,1,1,64,0,0,0,0,1,7450000
nn_kernel_gpu,483,1,1,58204,128,0,0,0,0,1,7450000
nn_kernel_gpu_mem,9521,1,1,58204,128,59600000,29800000,29800000,59600000,1,7450000
nn_kernel_cpu,15832,0,1,1,64,0,0,0,0,1,7460000
nn_kernel_gpu,470,1,1,58282,128,0,0,0,0,1,7460000
nn_kernel_gpu_mem,12545,1,1,58282,128,59680000,29840000,29840000,59680000,1,7460000
nn_kernel_cpu,28509,0,1,1,64,0,0,0,0,1,7470000
nn_kernel_gpu,491,1,1,58360,128,0,0,0,0,1,7470000
nn_kernel_gpu_mem,10641,1,1,58360,128,59760000,29880000,29880000,59760000,1,7470000
nn_kernel_cpu,22467,0,1,1,64,0,0,0,0,1,7480000
nn_kernel_gpu,473,1,1,58438,128,0,0,0,0,1,7480000
nn_kernel_gpu_mem,11805,1,1,58438,128,59840000,29920000,29920000,59840000,1,7480000
nn_kernel_cpu,17271,0,1,1,64,0,0,0,0,1,7490000
nn_kernel_gpu,495,1,1,58516,128,0,0,0,0,1,7490000
nn_kernel_gpu_mem,10982,1,1,58516,128,59920000,29960000,29960000,59920000,1,7490000
nn_kernel_cpu,8649,0,1,1,64,0,0,0,0,1,7500000
nn_kernel_gpu,500,1,1,58594,128,0,0,0,0,1,7500000
nn_kernel_gpu_mem,10869,1,1,58594,128,60000000,30000000,30000000,60000000,1,7500000
nn_kernel_cpu,5359,0,1,1,64,0,0,0,0,1,750000
nn_kernel_gpu,95,1,1,5860,128,0,0,0,0,1,750000
nn_kernel_gpu_mem,3471,1,1,5860,128,6000000,3000000,3000000,6000000,1,750000
nn_kernel_cpu,6025,0,1,1,64,0,0,0,0,1,7510000
nn_kernel_gpu,494,1,1,58672,128,0,0,0,0,1,7510000
nn_kernel_gpu_mem,22866,1,1,58672,128,60080000,30040000,30040000,60080000,1,7510000
nn_kernel_cpu,6283,0,1,1,64,0,0,0,0,1,7520000
nn_kernel_gpu,484,1,1,58750,128,0,0,0,0,1,7520000
nn_kernel_gpu_mem,12672,1,1,58750,128,60160000,30080000,30080000,60160000,1,7520000
nn_kernel_cpu,18724,0,1,1,64,0,0,0,0,1,7530000
nn_kernel_gpu,493,1,1,58829,128,0,0,0,0,1,7530000
nn_kernel_gpu_mem,13020,1,1,58829,128,60240000,30120000,30120000,60240000,1,7530000
nn_kernel_cpu,8672,0,1,1,64,0,0,0,0,1,7540000
nn_kernel_gpu,478,1,1,58907,128,0,0,0,0,1,7540000
nn_kernel_gpu_mem,10624,1,1,58907,128,60320000,30160000,30160000,60320000,1,7540000
nn_kernel_cpu,5957,0,1,1,64,0,0,0,0,1,7550000
nn_kernel_gpu,488,1,1,58985,128,0,0,0,0,1,7550000
nn_kernel_gpu_mem,11406,1,1,58985,128,60400000,30200000,30200000,60400000,1,7550000
nn_kernel_cpu,17756,0,1,1,64,0,0,0,0,1,7560000
nn_kernel_gpu,499,1,1,59063,128,0,0,0,0,1,7560000
nn_kernel_gpu_mem,11277,1,1,59063,128,60480000,30240000,30240000,60480000,1,7560000
nn_kernel_cpu,9647,0,1,1,64,0,0,0,0,1,7570000
nn_kernel_gpu,485,1,1,59141,128,0,0,0,0,1,7570000
nn_kernel_gpu_mem,12877,1,1,59141,128,60560000,30280000,30280000,60560000,1,7570000
nn_kernel_cpu,18493,0,1,1,64,0,0,0,0,1,7580000
nn_kernel_gpu,492,1,1,59219,128,0,0,0,0,1,7580000
nn_kernel_gpu_mem,10518,1,1,59219,128,60640000,30320000,30320000,60640000,1,7580000
nn_kernel_cpu,6437,0,1,1,64,0,0,0,0,1,7590000
nn_kernel_gpu,483,1,1,59297,128,0,0,0,0,1,7590000
nn_kernel_gpu_mem,11208,1,1,59297,128,60720000,30360000,30360000,60720000,1,7590000
nn_kernel_cpu,22319,0,1,1,64,0,0,0,0,1,7600000
nn_kernel_gpu,495,1,1,59375,128,0,0,0,0,1,7600000
nn_kernel_gpu_mem,11219,1,1,59375,128,60800000,30400000,30400000,60800000,1,7600000
nn_kernel_cpu,2392,0,1,1,64,0,0,0,0,1,760000
nn_kernel_gpu,107,1,1,5938,128,0,0,0,0,1,760000
nn_kernel_gpu_mem,2534,1,1,5938,128,6080000,3040000,3040000,6080000,1,760000
nn_kernel_cpu,23669,0,1,1,64,0,0,0,0,1,7610000
nn_kernel_gpu,504,1,1,59454,128,0,0,0,0,1,7610000
nn_kernel_gpu_mem,12114,1,1,59454,128,60880000,30440000,30440000,60880000,1,7610000
nn_kernel_cpu,11982,0,1,1,64,0,0,0,0,1,7620000
nn_kernel_gpu,500,1,1,59532,128,0,0,0,0,1,7620000
nn_kernel_gpu_mem,28737,1,1,59532,128,60960000,30480000,30480000,60960000,1,7620000
nn_kernel_cpu,29976,0,1,1,64,0,0,0,0,1,7630000
nn_kernel_gpu,491,1,1,59610,128,0,0,0,0,1,7630000
nn_kernel_gpu_mem,11918,1,1,59610,128,61040000,30520000,30520000,61040000,1,7630000
nn_kernel_cpu,7941,0,1,1,64,0,0,0,0,1,7640000
nn_kernel_gpu,484,1,1,59688,128,0,0,0,0,1,7640000
nn_kernel_gpu_mem,11217,1,1,59688,128,61120000,30560000,30560000,61120000,1,7640000
nn_kernel_cpu,4893,0,1,1,64,0,0,0,0,1,7650000
nn_kernel_gpu,497,1,1,59766,128,0,0,0,0,1,7650000
nn_kernel_gpu_mem,11120,1,1,59766,128,61200000,30600000,30600000,61200000,1,7650000
nn_kernel_cpu,18678,0,1,1,64,0,0,0,0,1,7660000
nn_kernel_gpu,507,1,1,59844,128,0,0,0,0,1,7660000
nn_kernel_gpu_mem,10991,1,1,59844,128,61280000,30640000,30640000,61280000,1,7660000
nn_kernel_cpu,36135,0,1,1,64,0,0,0,0,1,7670000
nn_kernel_gpu,502,1,1,59922,128,0,0,0,0,1,7670000
nn_kernel_gpu_mem,18798,1,1,59922,128,61360000,30680000,30680000,61360000,1,7670000
nn_kernel_cpu,57374,0,1,1,64,0,0,0,0,1,7680000
nn_kernel_gpu,495,1,1,60000,128,0,0,0,0,1,7680000
nn_kernel_gpu_mem,15957,1,1,60000,128,61440000,30720000,30720000,61440000,1,7680000
nn_kernel_cpu,13947,0,1,1,64,0,0,0,0,1,7690000
nn_kernel_gpu,497,1,1,60079,128,0,0,0,0,1,7690000
nn_kernel_gpu_mem,11139,1,1,60079,128,61520000,30760000,30760000,61520000,1,7690000
nn_kernel_cpu,4560,0,1,1,64,0,0,0,0,1,7700000
nn_kernel_gpu,487,1,1,60157,128,0,0,0,0,1,7700000
nn_kernel_gpu_mem,10668,1,1,60157,128,61600000,30800000,30800000,61600000,1,7700000
nn_kernel_cpu,9116,0,1,1,64,0,0,0,0,1,770000
nn_kernel_gpu,100,1,1,6016,128,0,0,0,0,1,770000
nn_kernel_gpu_mem,5754,1,1,6016,128,6160000,3080000,3080000,6160000,1,770000
nn_kernel_cpu,9640,0,1,1,64,0,0,0,0,1,7710000
nn_kernel_gpu,485,1,1,60235,128,0,0,0,0,1,7710000
nn_kernel_gpu_mem,12551,1,1,60235,128,61680000,30840000,30840000,61680000,1,7710000
nn_kernel_cpu,10653,0,1,1,64,0,0,0,0,1,7720000
nn_kernel_gpu,492,1,1,60313,128,0,0,0,0,1,7720000
nn_kernel_gpu_mem,12820,1,1,60313,128,61760000,30880000,30880000,61760000,1,7720000
nn_kernel_cpu,14082,0,1,1,64,0,0,0,0,1,7730000
nn_kernel_gpu,508,1,1,60391,128,0,0,0,0,1,7730000
nn_kernel_gpu_mem,11678,1,1,60391,128,61840000,30920000,30920000,61840000,1,7730000
nn_kernel_cpu,15116,0,1,1,64,0,0,0,0,1,7740000
nn_kernel_gpu,505,1,1,60469,128,0,0,0,0,1,7740000
nn_kernel_gpu_mem,11868,1,1,60469,128,61920000,30960000,30960000,61920000,1,7740000
nn_kernel_cpu,8286,0,1,1,64,0,0,0,0,1,7750000
nn_kernel_gpu,500,1,1,60547,128,0,0,0,0,1,7750000
nn_kernel_gpu_mem,11204,1,1,60547,128,62000000,31000000,31000000,62000000,1,7750000
nn_kernel_cpu,5703,0,1,1,64,0,0,0,0,1,7760000
nn_kernel_gpu,501,1,1,60625,128,0,0,0,0,1,7760000
nn_kernel_gpu_mem,13091,1,1,60625,128,62080000,31040000,31040000,62080000,1,7760000
nn_kernel_cpu,8592,0,1,1,64,0,0,0,0,1,7770000
nn_kernel_gpu,489,1,1,60704,128,0,0,0,0,1,7770000
nn_kernel_gpu_mem,13260,1,1,60704,128,62160000,31080000,31080000,62160000,1,7770000
nn_kernel_cpu,8493,0,1,1,64,0,0,0,0,1,7780000
nn_kernel_gpu,497,1,1,60782,128,0,0,0,0,1,7780000
nn_kernel_gpu_mem,21636,1,1,60782,128,62240000,31120000,31120000,62240000,1,7780000
nn_kernel_cpu,7897,0,1,1,64,0,0,0,0,1,7790000
nn_kernel_gpu,492,1,1,60860,128,0,0,0,0,1,7790000
nn_kernel_gpu_mem,12019,1,1,60860,128,62320000,31160000,31160000,62320000,1,7790000
nn_kernel_cpu,7861,0,1,1,64,0,0,0,0,1,7800000
nn_kernel_gpu,495,1,1,60938,128,0,0,0,0,1,7800000
nn_kernel_gpu_mem,12736,1,1,60938,128,62400000,31200000,31200000,62400000,1,7800000
nn_kernel_cpu,23713,0,1,1,64,0,0,0,0,1,780000
nn_kernel_gpu,98,1,1,6094,128,0,0,0,0,1,780000
nn_kernel_gpu_mem,1625,1,1,6094,128,6240000,3120000,3120000,6240000,1,780000
nn_kernel_cpu,31659,0,1,1,64,0,0,0,0,1,7810000
nn_kernel_gpu,492,1,1,61016,128,0,0,0,0,1,7810000
nn_kernel_gpu_mem,22035,1,1,61016,128,62480000,31240000,31240000,62480000,1,7810000
nn_kernel_cpu,16711,0,1,1,64,0,0,0,0,1,7820000
nn_kernel_gpu,510,1,1,61094,128,0,0,0,0,1,7820000
nn_kernel_gpu_mem,11509,1,1,61094,128,62560000,31280000,31280000,62560000,1,7820000
nn_kernel_cpu,15683,0,1,1,64,0,0,0,0,1,7830000
nn_kernel_gpu,504,1,1,61172,128,0,0,0,0,1,7830000
nn_kernel_gpu_mem,9710,1,1,61172,128,62640000,31320000,31320000,62640000,1,7830000
nn_kernel_cpu,21124,0,1,1,64,0,0,0,0,1,7840000
nn_kernel_gpu,506,1,1,61250,128,0,0,0,0,1,7840000
nn_kernel_gpu_mem,14729,1,1,61250,128,62720000,31360000,31360000,62720000,1,7840000
nn_kernel_cpu,10646,0,1,1,64,0,0,0,0,1,7850000
nn_kernel_gpu,494,1,1,61329,128,0,0,0,0,1,7850000
nn_kernel_gpu_mem,10907,1,1,61329,128,62800000,31400000,31400000,62800000,1,7850000
nn_kernel_cpu,22230,0,1,1,64,0,0,0,0,1,7860000
nn_kernel_gpu,518,1,1,61407,128,0,0,0,0,1,7860000
nn_kernel_gpu_mem,11346,1,1,61407,128,62880000,31440000,31440000,62880000,1,7860000
nn_kernel_cpu,6590,0,1,1,64,0,0,0,0,1,7870000
nn_kernel_gpu,537,1,1,61485,128,0,0,0,0,1,7870000
nn_kernel_gpu_mem,16916,1,1,61485,128,62960000,31480000,31480000,62960000,1,7870000
nn_kernel_cpu,12518,0,1,1,64,0,0,0,0,1,7880000
nn_kernel_gpu,511,1,1,61563,128,0,0,0,0,1,7880000
nn_kernel_gpu_mem,11624,1,1,61563,128,63040000,31520000,31520000,63040000,1,7880000
nn_kernel_cpu,21130,0,1,1,64,0,0,0,0,1,7890000
nn_kernel_gpu,516,1,1,61641,128,0,0,0,0,1,7890000
nn_kernel_gpu_mem,23135,1,1,61641,128,63120000,31560000,31560000,63120000,1,7890000
nn_kernel_cpu,7497,0,1,1,64,0,0,0,0,1,7900000
nn_kernel_gpu,513,1,1,61719,128,0,0,0,0,1,7900000
nn_kernel_gpu_mem,11688,1,1,61719,128,63200000,31600000,31600000,63200000,1,7900000
nn_kernel_cpu,2167,0,1,1,64,0,0,0,0,1,790000
nn_kernel_gpu,89,1,1,6172,128,0,0,0,0,1,790000
nn_kernel_gpu_mem,2478,1,1,6172,128,6320000,3160000,3160000,6320000,1,790000
nn_kernel_cpu,26704,0,1,1,64,0,0,0,0,1,7910000
nn_kernel_gpu,517,1,1,61797,128,0,0,0,0,1,7910000
nn_kernel_gpu_mem,17823,1,1,61797,128,63280000,31640000,31640000,63280000,1,7910000
nn_kernel_cpu,11377,0,1,1,64,0,0,0,0,1,7920000
nn_kernel_gpu,525,1,1,61875,128,0,0,0,0,1,7920000
nn_kernel_gpu_mem,11490,1,1,61875,128,63360000,31680000,31680000,63360000,1,7920000
nn_kernel_cpu,17260,0,1,1,64,0,0,0,0,1,7930000
nn_kernel_gpu,509,1,1,61954,128,0,0,0,0,1,7930000
nn_kernel_gpu_mem,12174,1,1,61954,128,63440000,31720000,31720000,63440000,1,7930000
nn_kernel_cpu,5683,0,1,1,64,0,0,0,0,1,7940000
nn_kernel_gpu,503,1,1,62032,128,0,0,0,0,1,7940000
nn_kernel_gpu_mem,12844,1,1,62032,128,63520000,31760000,31760000,63520000,1,7940000
nn_kernel_cpu,8769,0,1,1,64,0,0,0,0,1,7950000
nn_kernel_gpu,518,1,1,62110,128,0,0,0,0,1,7950000
nn_kernel_gpu_mem,17158,1,1,62110,128,63600000,31800000,31800000,63600000,1,7950000
nn_kernel_cpu,11127,0,1,1,64,0,0,0,0,1,7960000
nn_kernel_gpu,530,1,1,62188,128,0,0,0,0,1,7960000
nn_kernel_gpu_mem,11210,1,1,62188,128,63680000,31840000,31840000,63680000,1,7960000
nn_kernel_cpu,32067,0,1,1,64,0,0,0,0,1,7970000
nn_kernel_gpu,518,1,1,62266,128,0,0,0,0,1,7970000
nn_kernel_gpu_mem,18357,1,1,62266,128,63760000,31880000,31880000,63760000,1,7970000
nn_kernel_cpu,6200,0,1,1,64,0,0,0,0,1,7980000
nn_kernel_gpu,524,1,1,62344,128,0,0,0,0,1,7980000
nn_kernel_gpu_mem,12000,1,1,62344,128,63840000,31920000,31920000,63840000,1,7980000
nn_kernel_cpu,11755,0,1,1,64,0,0,0,0,1,7990000
nn_kernel_gpu,521,1,1,62422,128,0,0,0,0,1,7990000
nn_kernel_gpu_mem,11355,1,1,62422,128,63920000,31960000,31960000,63920000,1,7990000
nn_kernel_cpu,20784,0,1,1,64,0,0,0,0,1,8000000
nn_kernel_gpu,532,1,1,62500,128,0,0,0,0,1,8000000
nn_kernel_gpu_mem,11626,1,1,62500,128,64000000,32000000,32000000,64000000,1,8000000
nn_kernel_cpu,46707,0,1,1,64,0,0,0,0,1,800000
nn_kernel_gpu,91,1,1,6250,128,0,0,0,0,1,800000
nn_kernel_gpu_mem,4647,1,1,6250,128,6400000,3200000,3200000,6400000,1,800000
nn_kernel_cpu,20594,0,1,1,64,0,0,0,0,1,80000
nn_kernel_gpu,34,1,1,625,128,0,0,0,0,1,80000
nn_kernel_gpu_mem,161,1,1,625,128,640000,320000,320000,640000,1,80000
nn_kernel_cpu,5057,0,1,1,64,0,0,0,0,1,8010000
nn_kernel_gpu,516,1,1,62579,128,0,0,0,0,1,8010000
nn_kernel_gpu_mem,19534,1,1,62579,128,64080000,32040000,32040000,64080000,1,8010000
nn_kernel_cpu,51904,0,1,1,64,0,0,0,0,1,8020000
nn_kernel_gpu,525,1,1,62657,128,0,0,0,0,1,8020000
nn_kernel_gpu_mem,11857,1,1,62657,128,64160000,32080000,32080000,64160000,1,8020000
nn_kernel_cpu,10241,0,1,1,64,0,0,0,0,1,8030000
nn_kernel_gpu,529,1,1,62735,128,0,0,0,0,1,8030000
nn_kernel_gpu_mem,11501,1,1,62735,128,64240000,32120000,32120000,64240000,1,8030000
nn_kernel_cpu,9138,0,1,1,64,0,0,0,0,1,8040000
nn_kernel_gpu,522,1,1,62813,128,0,0,0,0,1,8040000
nn_kernel_gpu_mem,18002,1,1,62813,128,64320000,32160000,32160000,64320000,1,8040000
nn_kernel_cpu,4941,0,1,1,64,0,0,0,0,1,8050000
nn_kernel_gpu,520,1,1,62891,128,0,0,0,0,1,8050000
nn_kernel_gpu_mem,18890,1,1,62891,128,64400000,32200000,32200000,64400000,1,8050000
nn_kernel_cpu,15220,0,1,1,64,0,0,0,0,1,8060000
nn_kernel_gpu,512,1,1,62969,128,0,0,0,0,1,8060000
nn_kernel_gpu_mem,12122,1,1,62969,128,64480000,32240000,32240000,64480000,1,8060000
nn_kernel_cpu,6279,0,1,1,64,0,0,0,0,1,8070000
nn_kernel_gpu,507,1,1,63047,128,0,0,0,0,1,8070000
nn_kernel_gpu_mem,12137,1,1,63047,128,64560000,32280000,32280000,64560000,1,8070000
nn_kernel_cpu,15640,0,1,1,64,0,0,0,0,1,8080000
nn_kernel_gpu,516,1,1,63125,128,0,0,0,0,1,8080000
nn_kernel_gpu_mem,11937,1,1,63125,128,64640000,32320000,32320000,64640000,1,8080000
nn_kernel_cpu,28504,0,1,1,64,0,0,0,0,1,8090000
nn_kernel_gpu,527,1,1,63204,128,0,0,0,0,1,8090000
nn_kernel_gpu_mem,9739,1,1,63204,128,64720000,32360000,32360000,64720000,1,8090000
nn_kernel_cpu,28466,0,1,1,64,0,0,0,0,1,8100000
nn_kernel_gpu,512,1,1,63282,128,0,0,0,0,1,8100000
nn_kernel_gpu_mem,10219,1,1,63282,128,64800000,32400000,32400000,64800000,1,8100000
nn_kernel_cpu,13670,0,1,1,64,0,0,0,0,1,810000
nn_kernel_gpu,105,1,1,6329,128,0,0,0,0,1,810000
nn_kernel_gpu_mem,1621,1,1,6329,128,6480000,3240000,3240000,6480000,1,810000
nn_kernel_cpu,20721,0,1,1,64,0,0,0,0,1,8110000
nn_kernel_gpu,534,1,1,63360,128,0,0,0,0,1,8110000
nn_kernel_gpu_mem,14209,1,1,63360,128,64880000,32440000,32440000,64880000,1,8110000
nn_kernel_cpu,22092,0,1,1,64,0,0,0,0,1,8120000
nn_kernel_gpu,533,1,1,63438,128,0,0,0,0,1,8120000
nn_kernel_gpu_mem,10490,1,1,63438,128,64960000,32480000,32480000,64960000,1,8120000
nn_kernel_cpu,17023,0,1,1,64,0,0,0,0,1,8130000
nn_kernel_gpu,544,1,1,63516,128,0,0,0,0,1,8130000
nn_kernel_gpu_mem,14054,1,1,63516,128,65040000,32520000,32520000,65040000,1,8130000
nn_kernel_cpu,24216,0,1,1,64,0,0,0,0,1,8140000
nn_kernel_gpu,523,1,1,63594,128,0,0,0,0,1,8140000
nn_kernel_gpu_mem,9842,1,1,63594,128,65120000,32560000,32560000,65120000,1,8140000
nn_kernel_cpu,28099,0,1,1,64,0,0,0,0,1,8150000
nn_kernel_gpu,524,1,1,63672,128,0,0,0,0,1,8150000
nn_kernel_gpu_mem,13993,1,1,63672,128,65200000,32600000,32600000,65200000,1,8150000
nn_kernel_cpu,15637,0,1,1,64,0,0,0,0,1,8160000
nn_kernel_gpu,516,1,1,63750,128,0,0,0,0,1,8160000
nn_kernel_gpu_mem,9784,1,1,63750,128,65280000,32640000,32640000,65280000,1,8160000
nn_kernel_cpu,23529,0,1,1,64,0,0,0,0,1,8170000
nn_kernel_gpu,522,1,1,63829,128,0,0,0,0,1,8170000
nn_kernel_gpu_mem,10229,1,1,63829,128,65360000,32680000,32680000,65360000,1,8170000
nn_kernel_cpu,21735,0,1,1,64,0,0,0,0,1,8180000
nn_kernel_gpu,534,1,1,63907,128,0,0,0,0,1,8180000
nn_kernel_gpu_mem,9872,1,1,63907,128,65440000,32720000,32720000,65440000,1,8180000
nn_kernel_cpu,29229,0,1,1,64,0,0,0,0,1,8190000
nn_kernel_gpu,519,1,1,63985,128,0,0,0,0,1,8190000
nn_kernel_gpu_mem,10030,1,1,63985,128,65520000,32760000,32760000,65520000,1,8190000
nn_kernel_cpu,20938,0,1,1,64,0,0,0,0,1,8200000
nn_kernel_gpu,521,1,1,64063,128,0,0,0,0,1,8200000
nn_kernel_gpu_mem,10055,1,1,64063,128,65600000,32800000,32800000,65600000,1,8200000
nn_kernel_cpu,21620,0,1,1,64,0,0,0,0,1,820000
nn_kernel_gpu,100,1,1,6407,128,0,0,0,0,1,820000
nn_kernel_gpu_mem,1871,1,1,6407,128,6560000,3280000,3280000,6560000,1,820000
nn_kernel_cpu,22798,0,1,1,64,0,0,0,0,1,8210000
nn_kernel_gpu,527,1,1,64141,128,0,0,0,0,1,8210000
nn_kernel_gpu_mem,9137,1,1,64141,128,65680000,32840000,32840000,65680000,1,8210000
nn_kernel_cpu,52000,0,1,1,64,0,0,0,0,1,8220000
nn_kernel_gpu,527,1,1,64219,128,0,0,0,0,1,8220000
nn_kernel_gpu_mem,10379,1,1,64219,128,65760000,32880000,32880000,65760000,1,8220000
nn_kernel_cpu,19306,0,1,1,64,0,0,0,0,1,8230000
nn_kernel_gpu,520,1,1,64297,128,0,0,0,0,1,8230000
nn_kernel_gpu_mem,10319,1,1,64297,128,65840000,32920000,32920000,65840000,1,8230000
nn_kernel_cpu,35993,0,1,1,64,0,0,0,0,1,8240000
nn_kernel_gpu,543,1,1,64375,128,0,0,0,0,1,8240000
nn_kernel_gpu_mem,9142,1,1,64375,128,65920000,32960000,32960000,65920000,1,8240000
nn_kernel_cpu,27628,0,1,1,64,0,0,0,0,1,8250000
nn_kernel_gpu,531,1,1,64454,128,0,0,0,0,1,8250000
nn_kernel_gpu_mem,14348,1,1,64454,128,66000000,33000000,33000000,66000000,1,8250000
nn_kernel_cpu,22642,0,1,1,64,0,0,0,0,1,8260000
nn_kernel_gpu,523,1,1,64532,128,0,0,0,0,1,8260000
nn_kernel_gpu_mem,10199,1,1,64532,128,66080000,33040000,33040000,66080000,1,8260000
nn_kernel_cpu,18966,0,1,1,64,0,0,0,0,1,8270000
nn_kernel_gpu,540,1,1,64610,128,0,0,0,0,1,8270000
nn_kernel_gpu_mem,14146,1,1,64610,128,66160000,33080000,33080000,66160000,1,8270000
nn_kernel_cpu,24470,0,1,1,64,0,0,0,0,1,8280000
nn_kernel_gpu,520,1,1,64688,128,0,0,0,0,1,8280000
nn_kernel_gpu_mem,9920,1,1,64688,128,66240000,33120000,33120000,66240000,1,8280000
nn_kernel_cpu,28687,0,1,1,64,0,0,0,0,1,8290000
nn_kernel_gpu,539,1,1,64766,128,0,0,0,0,1,8290000
nn_kernel_gpu_mem,14800,1,1,64766,128,66320000,33160000,33160000,66320000,1,8290000
nn_kernel_cpu,35672,0,1,1,64,0,0,0,0,1,8300000
nn_kernel_gpu,535,1,1,64844,128,0,0,0,0,1,8300000
nn_kernel_gpu_mem,14092,1,1,64844,128,66400000,33200000,33200000,66400000,1,8300000
nn_kernel_cpu,16047,0,1,1,64,0,0,0,0,1,830000
nn_kernel_gpu,101,1,1,6485,128,0,0,0,0,1,830000
nn_kernel_gpu_mem,1531,1,1,6485,128,6640000,3320000,3320000,6640000,1,830000
nn_kernel_cpu,38458,0,1,1,64,0,0,0,0,1,8310000
nn_kernel_gpu,529,1,1,64922,128,0,0,0,0,1,8310000
nn_kernel_gpu_mem,10182,1,1,64922,128,66480000,33240000,33240000,66480000,1,8310000
nn_kernel_cpu,26065,0,1,1,64,0,0,0,0,1,8320000
nn_kernel_gpu,555,1,1,65000,128,0,0,0,0,1,8320000
nn_kernel_gpu_mem,10200,1,1,65000,128,66560000,33280000,33280000,66560000,1,8320000
nn_kernel_cpu,21168,0,1,1,64,0,0,0,0,1,8330000
nn_kernel_gpu,522,1,1,65079,128,0,0,0,0,1,8330000
nn_kernel_gpu_mem,9796,1,1,65079,128,66640000,33320000,33320000,66640000,1,8330000
nn_kernel_cpu,20674,0,1,1,64,0,0,0,0,1,8340000
nn_kernel_gpu,533,1,1,65157,128,0,0,0,0,1,8340000
nn_kernel_gpu_mem,11996,1,1,65157,128,66720000,33360000,33360000,66720000,1,8340000
nn_kernel_cpu,21917,0,1,1,64,0,0,0,0,1,8350000
nn_kernel_gpu,532,1,1,65235,128,0,0,0,0,1,8350000
nn_kernel_gpu_mem,9900,1,1,65235,128,66800000,33400000,33400000,66800000,1,8350000
nn_kernel_cpu,21982,0,1,1,64,0,0,0,0,1,8360000
nn_kernel_gpu,530,1,1,65313,128,0,0,0,0,1,8360000
nn_kernel_gpu_mem,10078,1,1,65313,128,66880000,33440000,33440000,66880000,1,8360000
nn_kernel_cpu,28362,0,1,1,64,0,0,0,0,1,8370000
nn_kernel_gpu,540,1,1,65391,128,0,0,0,0,1,8370000
nn_kernel_gpu_mem,13770,1,1,65391,128,66960000,33480000,33480000,66960000,1,8370000
nn_kernel_cpu,23397,0,1,1,64,0,0,0,0,1,8380000
nn_kernel_gpu,551,1,1,65469,128,0,0,0,0,1,8380000
nn_kernel_gpu_mem,14543,1,1,65469,128,67040000,33520000,33520000,67040000,1,8380000
nn_kernel_cpu,27682,0,1,1,64,0,0,0,0,1,8390000
nn_kernel_gpu,553,1,1,65547,128,0,0,0,0,1,8390000
nn_kernel_gpu_mem,9409,1,1,65547,128,67120000,33560000,33560000,67120000,1,8390000
nn_kernel_cpu,15838,0,1,1,64,0,0,0,0,1,8400000
nn_kernel_gpu,541,1,1,65625,128,0,0,0,0,1,8400000
nn_kernel_gpu_mem,20614,1,1,65625,128,67200000,33600000,33600000,67200000,1,8400000
nn_kernel_cpu,18436,0,1,1,64,0,0,0,0,1,840000
nn_kernel_gpu,94,1,1,6563,128,0,0,0,0,1,840000
nn_kernel_gpu_mem,2110,1,1,6563,128,6720000,3360000,3360000,6720000,1,840000
nn_kernel_cpu,32601,0,1,1,64,0,0,0,0,1,8410000
nn_kernel_gpu,578,1,1,65704,128,0,0,0,0,1,8410000
nn_kernel_gpu_mem,14518,1,1,65704,128,67280000,33640000,33640000,67280000,1,8410000
nn_kernel_cpu,28301,0,1,1,64,0,0,0,0,1,8420000
nn_kernel_gpu,582,1,1,65782,128,0,0,0,0,1,8420000
nn_kernel_gpu_mem,15129,1,1,65782,128,67360000,33680000,33680000,67360000,1,8420000
nn_kernel_cpu,7272,0,1,1,64,0,0,0,0,1,8430000
nn_kernel_gpu,546,1,1,65860,128,0,0,0,0,1,8430000
nn_kernel_gpu_mem,19523,1,1,65860,128,67440000,33720000,33720000,67440000,1,8430000
nn_kernel_cpu,22974,0,1,1,64,0,0,0,0,1,8440000
nn_kernel_gpu,548,1,1,65938,128,0,0,0,0,1,8440000
nn_kernel_gpu_mem,10409,1,1,65938,128,67520000,33760000,33760000,67520000,1,8440000
nn_kernel_cpu,23840,0,1,1,64,0,0,0,0,1,8450000
nn_kernel_gpu,540,1,1,66016,128,0,0,0,0,1,8450000
nn_kernel_gpu_mem,10553,1,1,66016,128,67600000,33800000,33800000,67600000,1,8450000
nn_kernel_cpu,16399,0,1,1,64,0,0,0,0,1,8460000
nn_kernel_gpu,556,1,1,66094,128,0,0,0,0,1,8460000
nn_kernel_gpu_mem,10577,1,1,66094,128,67680000,33840000,33840000,67680000,1,8460000
nn_kernel_cpu,21975,0,1,1,64,0,0,0,0,1,8470000
nn_kernel_gpu,532,1,1,66172,128,0,0,0,0,1,8470000
nn_kernel_gpu_mem,15100,1,1,66172,128,67760000,33880000,33880000,67760000,1,8470000
nn_kernel_cpu,23549,0,1,1,64,0,0,0,0,1,8480000
nn_kernel_gpu,563,1,1,66250,128,0,0,0,0,1,8480000
nn_kernel_gpu_mem,11160,1,1,66250,128,67840000,33920000,33920000,67840000,1,8480000
nn_kernel_cpu,15460,0,1,1,64,0,0,0,0,1,8490000
nn_kernel_gpu,569,1,1,66329,128,0,0,0,0,1,8490000
nn_kernel_gpu_mem,14686,1,1,66329,128,67920000,33960000,33960000,67920000,1,8490000
nn_kernel_cpu,23907,0,1,1,64,0,0,0,0,1,8500000
nn_kernel_gpu,542,1,1,66407,128,0,0,0,0,1,8500000
nn_kernel_gpu_mem,12683,1,1,66407,128,68000000,34000000,34000000,68000000,1,8500000
nn_kernel_cpu,23703,0,1,1,64,0,0,0,0,1,850000
nn_kernel_gpu,92,1,1,6641,128,0,0,0,0,1,850000
nn_kernel_gpu_mem,2352,1,1,6641,128,6800000,3400000,3400000,6800000,1,850000
nn_kernel_cpu,27992,0,1,1,64,0,0,0,0,1,8510000
nn_kernel_gpu,538,1,1,66485,128,0,0,0,0,1,8510000
nn_kernel_gpu_mem,10411,1,1,66485,128,68080000,34040000,34040000,68080000,1,8510000
nn_kernel_cpu,17147,0,1,1,64,0,0,0,0,1,8520000
nn_kernel_gpu,543,1,1,66563,128,0,0,0,0,1,8520000
nn_kernel_gpu_mem,10455,1,1,66563,128,68160000,34080000,34080000,68160000,1,8520000
nn_kernel_cpu,14064,0,1,1,64,0,0,0,0,1,8530000
nn_kernel_gpu,556,1,1,66641,128,0,0,0,0,1,8530000
nn_kernel_gpu_mem,10745,1,1,66641,128,68240000,34120000,34120000,68240000,1,8530000
nn_kernel_cpu,21762,0,1,1,64,0,0,0,0,1,8540000
nn_kernel_gpu,549,1,1,66719,128,0,0,0,0,1,8540000
nn_kernel_gpu_mem,15538,1,1,66719,128,68320000,34160000,34160000,68320000,1,8540000
nn_kernel_cpu,16483,0,1,1,64,0,0,0,0,1,8550000
nn_kernel_gpu,537,1,1,66797,128,0,0,0,0,1,8550000
nn_kernel_gpu_mem,13858,1,1,66797,128,68400000,34200000,34200000,68400000,1,8550000
nn_kernel_cpu,26162,0,1,1,64,0,0,0,0,1,8560000
nn_kernel_gpu,562,1,1,66875,128,0,0,0,0,1,8560000
nn_kernel_gpu_mem,10840,1,1,66875,128,68480000,34240000,34240000,68480000,1,8560000
nn_kernel_cpu,21827,0,1,1,64,0,0,0,0,1,8570000
nn_kernel_gpu,575,1,1,66954,128,0,0,0,0,1,8570000
nn_kernel_gpu_mem,12609,1,1,66954,128,68560000,34280000,34280000,68560000,1,8570000
nn_kernel_cpu,9565,0,1,1,64,0,0,0,0,1,8580000
nn_kernel_gpu,577,1,1,67032,128,0,0,0,0,1,8580000
nn_kernel_gpu_mem,12232,1,1,67032,128,68640000,34320000,34320000,68640000,1,8580000
nn_kernel_cpu,36220,0,1,1,64,0,0,0,0,1,8590000
nn_kernel_gpu,536,1,1,67110,128,0,0,0,0,1,8590000
nn_kernel_gpu_mem,12750,1,1,67110,128,68720000,34360000,34360000,68720000,1,8590000
nn_kernel_cpu,7067,0,1,1,64,0,0,0,0,1,8600000
nn_kernel_gpu,554,1,1,67188,128,0,0,0,0,1,8600000
nn_kernel_gpu_mem,12187,1,1,67188,128,68800000,34400000,34400000,68800000,1,8600000
nn_kernel_cpu,34922,0,1,1,64,0,0,0,0,1,860000
nn_kernel_gpu,100,1,1,6719,128,0,0,0,0,1,860000
nn_kernel_gpu_mem,2041,1,1,6719,128,6880000,3440000,3440000,6880000,1,860000
nn_kernel_cpu,7016,0,1,1,64,0,0,0,0,1,8610000
nn_kernel_gpu,558,1,1,67266,128,0,0,0,0,1,8610000
nn_kernel_gpu_mem,12121,1,1,67266,128,68880000,34440000,34440000,68880000,1,8610000
nn_kernel_cpu,7995,0,1,1,64,0,0,0,0,1,8620000
nn_kernel_gpu,549,1,1,67344,128,0,0,0,0,1,8620000
nn_kernel_gpu_mem,12219,1,1,67344,128,68960000,34480000,34480000,68960000,1,8620000
nn_kernel_cpu,4481,0,1,1,64,0,0,0,0,1,8630000
nn_kernel_gpu,549,1,1,67422,128,0,0,0,0,1,8630000
nn_kernel_gpu_mem,18794,1,1,67422,128,69040000,34520000,34520000,69040000,1,8630000
nn_kernel_cpu,42391,0,1,1,64,0,0,0,0,1,8640000
nn_kernel_gpu,543,1,1,67500,128,0,0,0,0,1,8640000
nn_kernel_gpu_mem,16633,1,1,67500,128,69120000,34560000,34560000,69120000,1,8640000
nn_kernel_cpu,8890,0,1,1,64,0,0,0,0,1,8650000
nn_kernel_gpu,544,1,1,67579,128,0,0,0,0,1,8650000
nn_kernel_gpu_mem,12400,1,1,67579,128,69200000,34600000,34600000,69200000,1,8650000
nn_kernel_cpu,26115,0,1,1,64,0,0,0,0,1,8660000
nn_kernel_gpu,551,1,1,67657,128,0,0,0,0,1,8660000
nn_kernel_gpu_mem,13698,1,1,67657,128,69280000,34640000,34640000,69280000,1,8660000
nn_kernel_cpu,6474,0,1,1,64,0,0,0,0,1,8670000
nn_kernel_gpu,550,1,1,67735,128,0,0,0,0,1,8670000
nn_kernel_gpu_mem,12123,1,1,67735,128,69360000,34680000,34680000,69360000,1,8670000
nn_kernel_cpu,26629,0,1,1,64,0,0,0,0,1,8680000
nn_kernel_gpu,575,1,1,67813,128,0,0,0,0,1,8680000
nn_kernel_gpu_mem,19168,1,1,67813,128,69440000,34720000,34720000,69440000,1,8680000
nn_kernel_cpu,6860,0,1,1,64,0,0,0,0,1,8690000
nn_kernel_gpu,559,1,1,67891,128,0,0,0,0,1,8690000
nn_kernel_gpu_mem,16897,1,1,67891,128,69520000,34760000,34760000,69520000,1,8690000
nn_kernel_cpu,9986,0,1,1,64,0,0,0,0,1,8700000
nn_kernel_gpu,560,1,1,67969,128,0,0,0,0,1,8700000
nn_kernel_gpu_mem,14440,1,1,67969,128,69600000,34800000,34800000,69600000,1,8700000
nn_kernel_cpu,58624,0,1,1,64,0,0,0,0,1,870000
nn_kernel_gpu,104,1,1,6797,128,0,0,0,0,1,870000
nn_kernel_gpu_mem,2659,1,1,6797,128,6960000,3480000,3480000,6960000,1,870000
nn_kernel_cpu,6211,0,1,1,64,0,0,0,0,1,8710000
nn_kernel_gpu,562,1,1,68047,128,0,0,0,0,1,8710000
nn_kernel_gpu_mem,12327,1,1,68047,128,69680000,34840000,34840000,69680000,1,8710000
nn_kernel_cpu,6944,0,1,1,64,0,0,0,0,1,8720000
nn_kernel_gpu,546,1,1,68125,128,0,0,0,0,1,8720000
nn_kernel_gpu_mem,20496,1,1,68125,128,69760000,34880000,34880000,69760000,1,8720000
nn_kernel_cpu,9708,0,1,1,64,0,0,0,0,1,8730000
nn_kernel_gpu,546,1,1,68204,128,0,0,0,0,1,8730000
nn_kernel_gpu_mem,13096,1,1,68204,128,69840000,34920000,34920000,69840000,1,8730000
nn_kernel_cpu,10398,0,1,1,64,0,0,0,0,1,8740000
nn_kernel_gpu,560,1,1,68282,128,0,0,0,0,1,8740000
nn_kernel_gpu_mem,12360,1,1,68282,128,69920000,34960000,34960000,69920000,1,8740000
nn_kernel_cpu,10396,0,1,1,64,0,0,0,0,1,8750000
nn_kernel_gpu,553,1,1,68360,128,0,0,0,0,1,8750000
nn_kernel_gpu_mem,12312,1,1,68360,128,70000000,35000000,35000000,70000000,1,8750000
nn_kernel_cpu,46080,0,1,1,64,0,0,0,0,1,8760000
nn_kernel_gpu,558,1,1,68438,128,0,0,0,0,1,8760000
nn_kernel_gpu_mem,13078,1,1,68438,128,70080000,35040000,35040000,70080000,1,8760000
nn_kernel_cpu,19975,0,1,1,64,0,0,0,0,1,8770000
nn_kernel_gpu,567,1,1,68516,128,0,0,0,0,1,8770000
nn_kernel_gpu_mem,12687,1,1,68516,128,70160000,35080000,35080000,70160000,1,8770000
nn_kernel_cpu,14858,0,1,1,64,0,0,0,0,1,8780000
nn_kernel_gpu,568,1,1,68594,128,0,0,0,0,1,8780000
nn_kernel_gpu_mem,12535,1,1,68594,128,70240000,35120000,35120000,70240000,1,8780000
nn_kernel_cpu,21872,0,1,1,64,0,0,0,0,1,8790000
nn_kernel_gpu,562,1,1,68672,128,0,0,0,0,1,8790000
nn_kernel_gpu_mem,15190,1,1,68672,128,70320000,35160000,35160000,70320000,1,8790000
nn_kernel_cpu,11288,0,1,1,64,0,0,0,0,1,8800000
nn_kernel_gpu,558,1,1,68750,128,0,0,0,0,1,8800000
nn_kernel_gpu_mem,13132,1,1,68750,128,70400000,35200000,35200000,70400000,1,8800000
nn_kernel_cpu,35883,0,1,1,64,0,0,0,0,1,880000
nn_kernel_gpu,122,1,1,6875,128,0,0,0,0,1,880000
nn_kernel_gpu_mem,1679,1,1,6875,128,7040000,3520000,3520000,7040000,1,880000
nn_kernel_cpu,28066,0,1,1,64,0,0,0,0,1,8810000
nn_kernel_gpu,563,1,1,68829,128,0,0,0,0,1,8810000
nn_kernel_gpu_mem,12768,1,1,68829,128,70480000,35240000,35240000,70480000,1,8810000
nn_kernel_cpu,8263,0,1,1,64,0,0,0,0,1,8820000
nn_kernel_gpu,568,1,1,68907,128,0,0,0,0,1,8820000
nn_kernel_gpu_mem,13447,1,1,68907,128,70560000,35280000,35280000,70560000,1,8820000
nn_kernel_cpu,24003,0,1,1,64,0,0,0,0,1,8830000
nn_kernel_gpu,565,1,1,68985,128,0,0,0,0,1,8830000
nn_kernel_gpu_mem,12855,1,1,68985,128,70640000,35320000,35320000,70640000,1,8830000
nn_kernel_cpu,6050,0,1,1,64,0,0,0,0,1,8840000
nn_kernel_gpu,562,1,1,69063,128,0,0,0,0,1,8840000
nn_kernel_gpu_mem,12906,1,1,69063,128,70720000,35360000,35360000,70720000,1,8840000
nn_kernel_cpu,20994,0,1,1,64,0,0,0,0,1,8850000
nn_kernel_gpu,567,1,1,69141,128,0,0,0,0,1,8850000
nn_kernel_gpu_mem,13208,1,1,69141,128,70800000,35400000,35400000,70800000,1,8850000
nn_kernel_cpu,11107,0,1,1,64,0,0,0,0,1,8860000
nn_kernel_gpu,566,1,1,69219,128,0,0,0,0,1,8860000
nn_kernel_gpu_mem,12804,1,1,69219,128,70880000,35440000,35440000,70880000,1,8860000
nn_kernel_cpu,10593,0,1,1,64,0,0,0,0,1,8870000
nn_kernel_gpu,576,1,1,69297,128,0,0,0,0,1,8870000
nn_kernel_gpu_mem,18207,1,1,69297,128,70960000,35480000,35480000,70960000,1,8870000
nn_kernel_cpu,16519,0,1,1,64,0,0,0,0,1,8880000
nn_kernel_gpu,568,1,1,69375,128,0,0,0,0,1,8880000
nn_kernel_gpu_mem,13002,1,1,69375,128,71040000,35520000,35520000,71040000,1,8880000
nn_kernel_cpu,14822,0,1,1,64,0,0,0,0,1,8890000
nn_kernel_gpu,568,1,1,69454,128,0,0,0,0,1,8890000
nn_kernel_gpu_mem,13001,1,1,69454,128,71120000,35560000,35560000,71120000,1,8890000
nn_kernel_cpu,4311,0,1,1,64,0,0,0,0,1,8900000
nn_kernel_gpu,562,1,1,69532,128,0,0,0,0,1,8900000
nn_kernel_gpu_mem,12526,1,1,69532,128,71200000,35600000,35600000,71200000,1,8900000
nn_kernel_cpu,1030,0,1,1,64,0,0,0,0,1,890000
nn_kernel_gpu,104,1,1,6954,128,0,0,0,0,1,890000
nn_kernel_gpu_mem,1761,1,1,6954,128,7120000,3560000,3560000,7120000,1,890000
nn_kernel_cpu,7916,0,1,1,64,0,0,0,0,1,8910000
nn_kernel_gpu,564,1,1,69610,128,0,0,0,0,1,8910000
nn_kernel_gpu_mem,12715,1,1,69610,128,71280000,35640000,35640000,71280000,1,8910000
nn_kernel_cpu,24638,0,1,1,64,0,0,0,0,1,8920000
nn_kernel_gpu,560,1,1,69688,128,0,0,0,0,1,8920000
nn_kernel_gpu_mem,13266,1,1,69688,128,71360000,35680000,35680000,71360000,1,8920000
nn_kernel_cpu,18634,0,1,1,64,0,0,0,0,1,8930000
nn_kernel_gpu,571,1,1,69766,128,0,0,0,0,1,8930000
nn_kernel_gpu_mem,12732,1,1,69766,128,71440000,35720000,35720000,71440000,1,8930000
nn_kernel_cpu,7528,0,1,1,64,0,0,0,0,1,8940000
nn_kernel_gpu,560,1,1,69844,128,0,0,0,0,1,8940000
nn_kernel_gpu_mem,12684,1,1,69844,128,71520000,35760000,35760000,71520000,1,8940000
nn_kernel_cpu,10574,0,1,1,64,0,0,0,0,1,8950000
nn_kernel_gpu,586,1,1,69922,128,0,0,0,0,1,8950000
nn_kernel_gpu_mem,21636,1,1,69922,128,71600000,35800000,35800000,71600000,1,8950000
nn_kernel_cpu,29339,0,1,1,64,0,0,0,0,1,8960000
nn_kernel_gpu,604,1,1,70000,128,0,0,0,0,1,8960000
nn_kernel_gpu_mem,12835,1,1,70000,128,71680000,35840000,35840000,71680000,1,8960000
nn_kernel_cpu,13816,0,1,1,64,0,0,0,0,1,8970000
nn_kernel_gpu,573,1,1,70079,128,0,0,0,0,1,8970000
nn_kernel_gpu_mem,13150,1,1,70079,128,71760000,35880000,35880000,71760000,1,8970000
nn_kernel_cpu,24139,0,1,1,64,0,0,0,0,1,8980000
nn_kernel_gpu,569,1,1,70157,128,0,0,0,0,1,8980000
nn_kernel_gpu_mem,12575,1,1,70157,128,71840000,35920000,35920000,71840000,1,8980000
nn_kernel_cpu,10722,0,1,1,64,0,0,0,0,1,8990000
nn_kernel_gpu,560,1,1,70235,128,0,0,0,0,1,8990000
nn_kernel_gpu_mem,14690,1,1,70235,128,71920000,35960000,35960000,71920000,1,8990000
nn_kernel_cpu,11086,0,1,1,64,0,0,0,0,1,9000000
nn_kernel_gpu,567,1,1,70313,128,0,0,0,0,1,9000000
nn_kernel_gpu_mem,15775,1,1,70313,128,72000000,36000000,36000000,72000000,1,9000000
nn_kernel_cpu,3197,0,1,1,64,0,0,0,0,1,900000
nn_kernel_gpu,104,1,1,7032,128,0,0,0,0,1,900000
nn_kernel_gpu_mem,1775,1,1,7032,128,7200000,3600000,3600000,7200000,1,900000
nn_kernel_cpu,1310,0,1,1,64,0,0,0,0,1,90000
nn_kernel_gpu,51,1,1,704,128,0,0,0,0,1,90000
nn_kernel_gpu_mem,184,1,1,704,128,720000,360000,360000,720000,1,90000
nn_kernel_cpu,8244,0,1,1,64,0,0,0,0,1,9010000
nn_kernel_gpu,567,1,1,70391,128,0,0,0,0,1,9010000
nn_kernel_gpu_mem,14094,1,1,70391,128,72080000,36040000,36040000,72080000,1,9010000
nn_kernel_cpu,11092,0,1,1,64,0,0,0,0,1,9020000
nn_kernel_gpu,562,1,1,70469,128,0,0,0,0,1,9020000
nn_kernel_gpu_mem,13547,1,1,70469,128,72160000,36080000,36080000,72160000,1,9020000
nn_kernel_cpu,12242,0,1,1,64,0,0,0,0,1,9030000
nn_kernel_gpu,569,1,1,70547,128,0,0,0,0,1,9030000
nn_kernel_gpu_mem,23562,1,1,70547,128,72240000,36120000,36120000,72240000,1,9030000
nn_kernel_cpu,8330,0,1,1,64,0,0,0,0,1,9040000
nn_kernel_gpu,567,1,1,70625,128,0,0,0,0,1,9040000
nn_kernel_gpu_mem,13160,1,1,70625,128,72320000,36160000,36160000,72320000,1,9040000
nn_kernel_cpu,11696,0,1,1,64,0,0,0,0,1,9050000
nn_kernel_gpu,579,1,1,70704,128,0,0,0,0,1,9050000
nn_kernel_gpu_mem,12911,1,1,70704,128,72400000,36200000,36200000,72400000,1,9050000
nn_kernel_cpu,9664,0,1,1,64,0,0,0,0,1,9060000
nn_kernel_gpu,571,1,1,70782,128,0,0,0,0,1,9060000
nn_kernel_gpu_mem,13751,1,1,70782,128,72480000,36240000,36240000,72480000,1,9060000
nn_kernel_cpu,13391,0,1,1,64,0,0,0,0,1,9070000
nn_kernel_gpu,608,1,1,70860,128,0,0,0,0,1,9070000
nn_kernel_gpu_mem,12840,1,1,70860,128,72560000,36280000,36280000,72560000,1,9070000
nn_kernel_cpu,24363,0,1,1,64,0,0,0,0,1,9080000
nn_kernel_gpu,579,1,1,70938,128,0,0,0,0,1,9080000
nn_kernel_gpu_mem,13667,1,1,70938,128,72640000,36320000,36320000,72640000,1,9080000
nn_kernel_cpu,36367,0,1,1,64,0,0,0,0,1,9090000
nn_kernel_gpu,572,1,1,71016,128,0,0,0,0,1,9090000
nn_kernel_gpu_mem,10397,1,1,71016,128,72720000,36360000,36360000,72720000,1,9090000
nn_kernel_cpu,10243,0,1,1,64,0,0,0,0,1,9100000
nn_kernel_gpu,577,1,1,71094,128,0,0,0,0,1,9100000
nn_kernel_gpu_mem,12713,1,1,71094,128,72800000,36400000,36400000,72800000,1,9100000
nn_kernel_cpu,35963,0,1,1,64,0,0,0,0,1,910000
nn_kernel_gpu,114,1,1,7110,128,0,0,0,0,1,910000
nn_kernel_gpu_mem,3166,1,1,7110,128,7280000,3640000,3640000,7280000,1,910000
nn_kernel_cpu,8088,0,1,1,64,0,0,0,0,1,9110000
nn_kernel_gpu,614,1,1,71172,128,0,0,0,0,1,9110000
nn_kernel_gpu_mem,12898,1,1,71172,128,72880000,36440000,36440000,72880000,1,9110000
nn_kernel_cpu,7315,0,1,1,64,0,0,0,0,1,9120000
nn_kernel_gpu,576,1,1,71250,128,0,0,0,0,1,9120000
nn_kernel_gpu_mem,13332,1,1,71250,128,72960000,36480000,36480000,72960000,1,9120000
nn_kernel_cpu,7703,0,1,1,64,0,0,0,0,1,9130000
nn_kernel_gpu,618,1,1,71329,128,0,0,0,0,1,9130000
nn_kernel_gpu_mem,12862,1,1,71329,128,73040000,36520000,36520000,73040000,1,9130000
nn_kernel_cpu,17051,0,1,1,64,0,0,0,0,1,9140000
nn_kernel_gpu,577,1,1,71407,128,0,0,0,0,1,9140000
nn_kernel_gpu_mem,16984,1,1,71407,128,73120000,36560000,36560000,73120000,1,9140000
nn_kernel_cpu,8007,0,1,1,64,0,0,0,0,1,9150000
nn_kernel_gpu,706,1,1,71485,128,0,0,0,0,1,9150000
nn_kernel_gpu_mem,12820,1,1,71485,128,73200000,36600000,36600000,73200000,1,9150000
nn_kernel_cpu,6523,0,1,1,64,0,0,0,0,1,9160000
nn_kernel_gpu,583,1,1,71563,128,0,0,0,0,1,9160000
nn_kernel_gpu_mem,13061,1,1,71563,128,73280000,36640000,36640000,73280000,1,9160000
nn_kernel_cpu,35682,0,1,1,64,0,0,0,0,1,9170000
nn_kernel_gpu,583,1,1,71641,128,0,0,0,0,1,9170000
nn_kernel_gpu_mem,13295,1,1,71641,128,73360000,36680000,36680000,73360000,1,9170000
nn_kernel_cpu,9341,0,1,1,64,0,0,0,0,1,9180000
nn_kernel_gpu,574,1,1,71719,128,0,0,0,0,1,9180000
nn_kernel_gpu_mem,12633,1,1,71719,128,73440000,36720000,36720000,73440000,1,9180000
nn_kernel_cpu,16549,0,1,1,64,0,0,0,0,1,9190000
nn_kernel_gpu,590,1,1,71797,128,0,0,0,0,1,9190000
nn_kernel_gpu_mem,13215,1,1,71797,128,73520000,36760000,36760000,73520000,1,9190000
nn_kernel_cpu,6939,0,1,1,64,0,0,0,0,1,9200000
nn_kernel_gpu,609,1,1,71875,128,0,0,0,0,1,9200000
nn_kernel_gpu_mem,17250,1,1,71875,128,73600000,36800000,36800000,73600000,1,9200000
nn_kernel_cpu,16123,0,1,1,64,0,0,0,0,1,920000
nn_kernel_gpu,115,1,1,7188,128,0,0,0,0,1,920000
nn_kernel_gpu_mem,1921,1,1,7188,128,7360000,3680000,3680000,7360000,1,920000
nn_kernel_cpu,7616,0,1,1,64,0,0,0,0,1,9210000
nn_kernel_gpu,586,1,1,71954,128,0,0,0,0,1,9210000
nn_kernel_gpu_mem,13116,1,1,71954,128,73680000,36840000,36840000,73680000,1,9210000
nn_kernel_cpu,27531,0,1,1,64,0,0,0,0,1,9220000
nn_kernel_gpu,587,1,1,72032,128,0,0,0,0,1,9220000
nn_kernel_gpu_mem,20522,1,1,72032,128,73760000,36880000,36880000,73760000,1,9220000
nn_kernel_cpu,25419,0,1,1,64,0,0,0,0,1,9230000
nn_kernel_gpu,582,1,1,72110,128,0,0,0,0,1,9230000
nn_kernel_gpu_mem,13833,1,1,72110,128,73840000,36920000,36920000,73840000,1,9230000
nn_kernel_cpu,7004,0,1,1,64,0,0,0,0,1,9240000
nn_kernel_gpu,586,1,1,72188,128,0,0,0,0,1,9240000
nn_kernel_gpu_mem,28702,1,1,72188,128,73920000,36960000,36960000,73920000,1,9240000
nn_kernel_cpu,22793,0,1,1,64,0,0,0,0,1,9250000
nn_kernel_gpu,594,1,1,72266,128,0,0,0,0,1,9250000
nn_kernel_gpu_mem,18790,1,1,72266,128,74000000,37000000,37000000,74000000,1,9250000
nn_kernel_cpu,10001,0,1,1,64,0,0,0,0,1,9260000
nn_kernel_gpu,593,1,1,72344,128,0,0,0,0,1,9260000
nn_kernel_gpu_mem,13267,1,1,72344,128,74080000,37040000,37040000,74080000,1,9260000
nn_kernel_cpu,21253,0,1,1,64,0,0,0,0,1,9270000
nn_kernel_gpu,586,1,1,72422,128,0,0,0,0,1,9270000
nn_kernel_gpu_mem,13173,1,1,72422,128,74160000,37080000,37080000,74160000,1,9270000
nn_kernel_cpu,11949,0,1,1,64,0,0,0,0,1,9280000
nn_kernel_gpu,591,1,1,72500,128,0,0,0,0,1,9280000
nn_kernel_gpu_mem,18465,1,1,72500,128,74240000,37120000,37120000,74240000,1,9280000
nn_kernel_cpu,23585,0,1,1,64,0,0,0,0,1,9290000
nn_kernel_gpu,625,1,1,72579,128,0,0,0,0,1,9290000
nn_kernel_gpu_mem,12818,1,1,72579,128,74320000,37160000,37160000,74320000,1,9290000
nn_kernel_cpu,13604,0,1,1,64,0,0,0,0,1,9300000
nn_kernel_gpu,584,1,1,72657,128,0,0,0,0,1,9300000
nn_kernel_gpu_mem,14068,1,1,72657,128,74400000,37200000,37200000,74400000,1,9300000
nn_kernel_cpu,2652,0,1,1,64,0,0,0,0,1,930000
nn_kernel_gpu,95,1,1,7266,128,0,0,0,0,1,930000
nn_kernel_gpu_mem,2785,1,1,7266,128,7440000,3720000,3720000,7440000,1,930000
nn_kernel_cpu,10690,0,1,1,64,0,0,0,0,1,9310000
nn_kernel_gpu,592,1,1,72735,128,0,0,0,0,1,9310000
nn_kernel_gpu_mem,20769,1,1,72735,128,74480000,37240000,37240000,74480000,1,9310000
nn_kernel_cpu,38843,0,1,1,64,0,0,0,0,1,9320000
nn_kernel_gpu,595,1,1,72813,128,0,0,0,0,1,9320000
nn_kernel_gpu_mem,19536,1,1,72813,128,74560000,37280000,37280000,74560000,1,9320000
nn_kernel_cpu,10658,0,1,1,64,0,0,0,0,1,9330000
nn_kernel_gpu,592,1,1,72891,128,0,0,0,0,1,9330000
nn_kernel_gpu_mem,13619,1,1,72891,128,74640000,37320000,37320000,74640000,1,9330000
nn_kernel_cpu,36011,0,1,1,64,0,0,0,0,1,9340000
nn_kernel_gpu,590,1,1,72969,128,0,0,0,0,1,9340000
nn_kernel_gpu_mem,13400,1,1,72969,128,74720000,37360000,37360000,74720000,1,9340000
nn_kernel_cpu,15271,0,1,1,64,0,0,0,0,1,9350000
nn_kernel_gpu,592,1,1,73047,128,0,0,0,0,1,9350000
nn_kernel_gpu_mem,13138,1,1,73047,128,74800000,37400000,37400000,74800000,1,9350000
nn_kernel_cpu,7522,0,1,1,64,0,0,0,0,1,9360000
nn_kernel_gpu,593,1,1,73125,128,0,0,0,0,1,9360000
nn_kernel_gpu_mem,13291,1,1,73125,128,74880000,37440000,37440000,74880000,1,9360000
nn_kernel_cpu,23434,0,1,1,64,0,0,0,0,1,9370000
nn_kernel_gpu,589,1,1,73204,128,0,0,0,0,1,9370000
nn_kernel_gpu_mem,21662,1,1,73204,128,74960000,37480000,37480000,74960000,1,9370000
nn_kernel_cpu,44228,0,1,1,64,0,0,0,0,1,9380000
nn_kernel_gpu,587,1,1,73282,128,0,0,0,0,1,9380000
nn_kernel_gpu_mem,12382,1,1,73282,128,75040000,37520000,37520000,75040000,1,9380000
nn_kernel_cpu,23703,0,1,1,64,0,0,0,0,1,9390000
nn_kernel_gpu,585,1,1,73360,128,0,0,0,0,1,9390000
nn_kernel_gpu_mem,13187,1,1,73360,128,75120000,37560000,37560000,75120000,1,9390000
nn_kernel_cpu,35976,0,1,1,64,0,0,0,0,1,9400000
nn_kernel_gpu,589,1,1,73438,128,0,0,0,0,1,9400000
nn_kernel_gpu_mem,15200,1,1,73438,128,75200000,37600000,37600000,75200000,1,9400000
nn_kernel_cpu,2616,0,1,1,64,0,0,0,0,1,940000
nn_kernel_gpu,102,1,1,7344,128,0,0,0,0,1,940000
nn_kernel_gpu_mem,1848,1,1,7344,128,7520000,3760000,3760000,7520000,1,940000
nn_kernel_cpu,13789,0,1,1,64,0,0,0,0,1,9410000
nn_kernel_gpu,597,1,1,73516,128,0,0,0,0,1,9410000
nn_kernel_gpu_mem,15042,1,1,73516,128,75280000,37640000,37640000,75280000,1,9410000
nn_kernel_cpu,18893,0,1,1,64,0,0,0,0,1,9420000
nn_kernel_gpu,588,1,1,73594,128,0,0,0,0,1,9420000
nn_kernel_gpu_mem,12711,1,1,73594,128,75360000,37680000,37680000,75360000,1,9420000
nn_kernel_cpu,38368,0,1,1,64,0,0,0,0,1,9430000
nn_kernel_gpu,586,1,1,73672,128,0,0,0,0,1,9430000
nn_kernel_gpu_mem,14051,1,1,73672,128,75440000,37720000,37720000,75440000,1,9430000
nn_kernel_cpu,14989,0,1,1,64,0,0,0,0,1,9440000
nn_kernel_gpu,585,1,1,73750,128,0,0,0,0,1,9440000
nn_kernel_gpu_mem,15137,1,1,73750,128,75520000,37760000,37760000,75520000,1,9440000
nn_kernel_cpu,55106,0,1,1,64,0,0,0,0,1,9450000
nn_kernel_gpu,619,1,1,73829,128,0,0,0,0,1,9450000
nn_kernel_gpu_mem,14367,1,1,73829,128,75600000,37800000,37800000,75600000,1,9450000
nn_kernel_cpu,10406,0,1,1,64,0,0,0,0,1,9460000
nn_kernel_gpu,629,1,1,73907,128,0,0,0,0,1,9460000
nn_kernel_gpu_mem,18356,1,1,73907,128,75680000,37840000,37840000,75680000,1,9460000
nn_kernel_cpu,24428,0,1,1,64,0,0,0,0,1,9470000
nn_kernel_gpu,599,1,1,73985,128,0,0,0,0,1,9470000
nn_kernel_gpu_mem,14331,1,1,73985,128,75760000,37880000,37880000,75760000,1,9470000
nn_kernel_cpu,13694,0,1,1,64,0,0,0,0,1,9480000
nn_kernel_gpu,602,1,1,74063,128,0,0,0,0,1,9480000
nn_kernel_gpu_mem,13842,1,1,74063,128,75840000,37920000,37920000,75840000,1,9480000
nn_kernel_cpu,36378,0,1,1,64,0,0,0,0,1,9490000
nn_kernel_gpu,601,1,1,74141,128,0,0,0,0,1,9490000
nn_kernel_gpu_mem,13464,1,1,74141,128,75920000,37960000,37960000,75920000,1,9490000
nn_kernel_cpu,23162,0,1,1,64,0,0,0,0,1,9500000
nn_kernel_gpu,635,1,1,74219,128,0,0,0,0,1,9500000
nn_kernel_gpu_mem,14281,1,1,74219,128,76000000,38000000,38000000,76000000,1,9500000
nn_kernel_cpu,9333,0,1,1,64,0,0,0,0,1,950000
nn_kernel_gpu,98,1,1,7422,128,0,0,0,0,1,950000
nn_kernel_gpu_mem,2377,1,1,7422,128,7600000,3800000,3800000,7600000,1,950000
nn_kernel_cpu,26516,0,1,1,64,0,0,0,0,1,9510000
nn_kernel_gpu,596,1,1,74297,128,0,0,0,0,1,9510000
nn_kernel_gpu_mem,13714,1,1,74297,128,76080000,38040000,38040000,76080000,1,9510000
nn_kernel_cpu,8819,0,1,1,64,0,0,0,0,1,9520000
nn_kernel_gpu,602,1,1,74375,128,0,0,0,0,1,9520000
nn_kernel_gpu_mem,13812,1,1,74375,128,76160000,38080000,38080000,76160000,1,9520000
nn_kernel_cpu,26302,0,1,1,64,0,0,0,0,1,9530000
nn_kernel_gpu,612,1,1,74454,128,0,0,0,0,1,9530000
nn_kernel_gpu_mem,13601,1,1,74454,128,76240000,38120000,38120000,76240000,1,9530000
nn_kernel_cpu,18028,0,1,1,64,0,0,0,0,1,9540000
nn_kernel_gpu,593,1,1,74532,128,0,0,0,0,1,9540000
nn_kernel_gpu_mem,14404,1,1,74532,128,76320000,38160000,38160000,76320000,1,9540000
nn_kernel_cpu,8038,0,1,1,64,0,0,0,0,1,9550000
nn_kernel_gpu,599,1,1,74610,128,0,0,0,0,1,9550000
nn_kernel_gpu_mem,13231,1,1,74610,128,76400000,38200000,38200000,76400000,1,9550000
nn_kernel_cpu,7598,0,1,1,64,0,0,0,0,1,9560000
nn_kernel_gpu,596,1,1,74688,128,0,0,0,0,1,9560000
nn_kernel_gpu_mem,14988,1,1,74688,128,76480000,38240000,38240000,76480000,1,9560000
nn_kernel_cpu,11260,0,1,1,64,0,0,0,0,1,9570000
nn_kernel_gpu,618,1,1,74766,128,0,0,0,0,1,9570000
nn_kernel_gpu_mem,13504,1,1,74766,128,76560000,38280000,38280000,76560000,1,9570000
nn_kernel_cpu,10464,0,1,1,64,0,0,0,0,1,9580000
nn_kernel_gpu,609,1,1,74844,128,0,0,0,0,1,9580000
nn_kernel_gpu_mem,13315,1,1,74844,128,76640000,38320000,38320000,76640000,1,9580000
nn_kernel_cpu,19292,0,1,1,64,0,0,0,0,1,9590000
nn_kernel_gpu,608,1,1,74922,128,0,0,0,0,1,9590000
nn_kernel_gpu_mem,13025,1,1,74922,128,76720000,38360000,38360000,76720000,1,9590000
nn_kernel_cpu,21247,0,1,1,64,0,0,0,0,1,9600000
nn_kernel_gpu,602,1,1,75000,128,0,0,0,0,1,9600000
nn_kernel_gpu_mem,14159,1,1,75000,128,76800000,38400000,38400000,76800000,1,9600000
nn_kernel_cpu,26667,0,1,1,64,0,0,0,0,1,960000
nn_kernel_gpu,106,1,1,7500,128,0,0,0,0,1,960000
nn_kernel_gpu_mem,1948,1,1,7500,128,7680000,3840000,3840000,7680000,1,960000
nn_kernel_cpu,16267,0,1,1,64,0,0,0,0,1,9610000
nn_kernel_gpu,628,1,1,75079,128,0,0,0,0,1,9610000
nn_kernel_gpu_mem,14624,1,1,75079,128,76880000,38440000,38440000,76880000,1,9610000
nn_kernel_cpu,25235,0,1,1,64,0,0,0,0,1,9620000
nn_kernel_gpu,635,1,1,75157,128,0,0,0,0,1,9620000
nn_kernel_gpu_mem,18359,1,1,75157,128,76960000,38480000,38480000,76960000,1,9620000
nn_kernel_cpu,22750,0,1,1,64,0,0,0,0,1,9630000
nn_kernel_gpu,609,1,1,75235,128,0,0,0,0,1,9630000
nn_kernel_gpu_mem,14043,1,1,75235,128,77040000,38520000,38520000,77040000,1,9630000
nn_kernel_cpu,31543,0,1,1,64,0,0,0,0,1,9640000
nn_kernel_gpu,616,1,1,75313,128,0,0,0,0,1,9640000
nn_kernel_gpu_mem,10896,1,1,75313,128,77120000,38560000,38560000,77120000,1,9640000
nn_kernel_cpu,25538,0,1,1,64,0,0,0,0,1,9650000
nn_kernel_gpu,613,1,1,75391,128,0,0,0,0,1,9650000
nn_kernel_gpu_mem,13907,1,1,75391,128,77200000,38600000,38600000,77200000,1,9650000
nn_kernel_cpu,11827,0,1,1,64,0,0,0,0,1,9660000
nn_kernel_gpu,608,1,1,75469,128,0,0,0,0,1,9660000
nn_kernel_gpu_mem,14091,1,1,75469,128,77280000,38640000,38640000,77280000,1,9660000
nn_kernel_cpu,20438,0,1,1,64,0,0,0,0,1,9670000
nn_kernel_gpu,602,1,1,75547,128,0,0,0,0,1,9670000
nn_kernel_gpu_mem,13763,1,1,75547,128,77360000,38680000,38680000,77360000,1,9670000
nn_kernel_cpu,15133,0,1,1,64,0,0,0,0,1,9680000
nn_kernel_gpu,615,1,1,75625,128,0,0,0,0,1,9680000
nn_kernel_gpu_mem,13733,1,1,75625,128,77440000,38720000,38720000,77440000,1,9680000
nn_kernel_cpu,5744,0,1,1,64,0,0,0,0,1,9690000
nn_kernel_gpu,612,1,1,75704,128,0,0,0,0,1,9690000
nn_kernel_gpu_mem,17073,1,1,75704,128,77520000,38760000,38760000,77520000,1,9690000
nn_kernel_cpu,12366,0,1,1,64,0,0,0,0,1,9700000
nn_kernel_gpu,610,1,1,75782,128,0,0,0,0,1,9700000
nn_kernel_gpu_mem,13346,1,1,75782,128,77600000,38800000,38800000,77600000,1,9700000
nn_kernel_cpu,7727,0,1,1,64,0,0,0,0,1,970000
nn_kernel_gpu,126,1,1,7579,128,0,0,0,0,1,970000
nn_kernel_gpu_mem,2295,1,1,7579,128,7760000,3880000,3880000,7760000,1,970000
nn_kernel_cpu,12316,0,1,1,64,0,0,0,0,1,9710000
nn_kernel_gpu,648,1,1,75860,128,0,0,0,0,1,9710000
nn_kernel_gpu_mem,14089,1,1,75860,128,77680000,38840000,38840000,77680000,1,9710000
nn_kernel_cpu,31716,0,1,1,64,0,0,0,0,1,9720000
nn_kernel_gpu,621,1,1,75938,128,0,0,0,0,1,9720000
nn_kernel_gpu_mem,16958,1,1,75938,128,77760000,38880000,38880000,77760000,1,9720000
nn_kernel_cpu,21931,0,1,1,64,0,0,0,0,1,9730000
nn_kernel_gpu,618,1,1,76016,128,0,0,0,0,1,9730000
nn_kernel_gpu_mem,13963,1,1,76016,128,77840000,38920000,38920000,77840000,1,9730000
nn_kernel_cpu,35110,0,1,1,64,0,0,0,0,1,9740000
nn_kernel_gpu,610,1,1,76094,128,0,0,0,0,1,9740000
nn_kernel_gpu_mem,11444,1,1,76094,128,77920000,38960000,38960000,77920000,1,9740000
nn_kernel_cpu,14757,0,1,1,64,0,0,0,0,1,9750000
nn_kernel_gpu,612,1,1,76172,128,0,0,0,0,1,9750000
nn_kernel_gpu_mem,15404,1,1,76172,128,78000000,39000000,39000000,78000000,1,9750000
nn_kernel_cpu,22283,0,1,1,64,0,0,0,0,1,9760000
nn_kernel_gpu,616,1,1,76250,128,0,0,0,0,1,9760000
nn_kernel_gpu_mem,14443,1,1,76250,128,78080000,39040000,39040000,78080000,1,9760000
nn_kernel_cpu,26209,0,1,1,64,0,0,0,0,1,9770000
nn_kernel_gpu,613,1,1,76329,128,0,0,0,0,1,9770000
nn_kernel_gpu_mem,15203,1,1,76329,128,78160000,39080000,39080000,78160000,1,9770000
nn_kernel_cpu,25656,0,1,1,64,0,0,0,0,1,9780000
nn_kernel_gpu,621,1,1,76407,128,0,0,0,0,1,9780000
nn_kernel_gpu_mem,15015,1,1,76407,128,78240000,39120000,39120000,78240000,1,9780000
nn_kernel_cpu,20215,0,1,1,64,0,0,0,0,1,9790000
nn_kernel_gpu,614,1,1,76485,128,0,0,0,0,1,9790000
nn_kernel_gpu_mem,14173,1,1,76485,128,78320000,39160000,39160000,78320000,1,9790000
nn_kernel_cpu,11709,0,1,1,64,0,0,0,0,1,9800000
nn_kernel_gpu,623,1,1,76563,128,0,0,0,0,1,9800000
nn_kernel_gpu_mem,14728,1,1,76563,128,78400000,39200000,39200000,78400000,1,9800000
nn_kernel_cpu,16255,0,1,1,64,0,0,0,0,1,980000
nn_kernel_gpu,114,1,1,7657,128,0,0,0,0,1,980000
nn_kernel_gpu_mem,2833,1,1,7657,128,7840000,3920000,3920000,7840000,1,980000
nn_kernel_cpu,15528,0,1,1,64,0,0,0,0,1,9810000
nn_kernel_gpu,619,1,1,76641,128,0,0,0,0,1,9810000
nn_kernel_gpu_mem,14454,1,1,76641,128,78480000,39240000,39240000,78480000,1,9810000
nn_kernel_cpu,5991,0,1,1,64,0,0,0,0,1,9820000
nn_kernel_gpu,606,1,1,76719,128,0,0,0,0,1,9820000
nn_kernel_gpu_mem,14392,1,1,76719,128,78560000,39280000,39280000,78560000,1,9820000
nn_kernel_cpu,7199,0,1,1,64,0,0,0,0,1,9830000
nn_kernel_gpu,615,1,1,76797,128,0,0,0,0,1,9830000
nn_kernel_gpu_mem,15566,1,1,76797,128,78640000,39320000,39320000,78640000,1,9830000
nn_kernel_cpu,25587,0,1,1,64,0,0,0,0,1,9840000
nn_kernel_gpu,620,1,1,76875,128,0,0,0,0,1,9840000
nn_kernel_gpu_mem,14143,1,1,76875,128,78720000,39360000,39360000,78720000,1,9840000
nn_kernel_cpu,5248,0,1,1,64,0,0,0,0,1,9850000
nn_kernel_gpu,622,1,1,76954,128,0,0,0,0,1,9850000
nn_kernel_gpu_mem,14741,1,1,76954,128,78800000,39400000,39400000,78800000,1,9850000
nn_kernel_cpu,10712,0,1,1,64,0,0,0,0,1,9860000
nn_kernel_gpu,616,1,1,77032,128,0,0,0,0,1,9860000
nn_kernel_gpu_mem,19368,1,1,77032,128,78880000,39440000,39440000,78880000,1,9860000
nn_kernel_cpu,10095,0,1,1,64,0,0,0,0,1,9870000
nn_kernel_gpu,619,1,1,77110,128,0,0,0,0,1,9870000
nn_kernel_gpu_mem,14373,1,1,77110,128,78960000,39480000,39480000,78960000,1,9870000
nn_kernel_cpu,19288,0,1,1,64,0,0,0,0,1,9880000
nn_kernel_gpu,624,1,1,77188,128,0,0,0,0,1,9880000
nn_kernel_gpu_mem,13519,1,1,77188,128,79040000,39520000,39520000,79040000,1,9880000
nn_kernel_cpu,11946,0,1,1,64,0,0,0,0,1,9890000
nn_kernel_gpu,630,1,1,77266,128,0,0,0,0,1,9890000
nn_kernel_gpu_mem,15021,1,1,77266,128,79120000,39560000,39560000,79120000,1,9890000
nn_kernel_cpu,40049,0,1,1,64,0,0,0,0,1,9900000
nn_kernel_gpu,615,1,1,77344,128,0,0,0,0,1,9900000
nn_kernel_gpu_mem,14787,1,1,77344,128,79200000,39600000,39600000,79200000,1,9900000
nn_kernel_cpu,538,0,1,1,64,0,0,0,0,1,990000
nn_kernel_gpu,131,1,1,7735,128,0,0,0,0,1,990000
nn_kernel_gpu_mem,3921,1,1,7735,128,7920000,3960000,3960000,7920000,1,990000
nn_kernel_cpu,23840,0,1,1,64,0,0,0,0,1,9910000
nn_kernel_gpu,626,1,1,77422,128,0,0,0,0,1,9910000
nn_kernel_gpu_mem,14332,1,1,77422,128,79280000,39640000,39640000,79280000,1,9910000
nn_kernel_cpu,8131,0,1,1,64,0,0,0,0,1,9920000
nn_kernel_gpu,611,1,1,77500,128,0,0,0,0,1,9920000
nn_kernel_gpu_mem,16276,1,1,77500,128,79360000,39680000,39680000,79360000,1,9920000
nn_kernel_cpu,20969,0,1,1,64,0,0,0,0,1,9930000
nn_kernel_gpu,627,1,1,77579,128,0,0,0,0,1,9930000
nn_kernel_gpu_mem,14632,1,1,77579,128,79440000,39720000,39720000,79440000,1,9930000
nn_kernel_cpu,21703,0,1,1,64,0,0,0,0,1,9940000
nn_kernel_gpu,623,1,1,77657,128,0,0,0,0,1,9940000
nn_kernel_gpu_mem,15731,1,1,77657,128,79520000,39760000,39760000,79520000,1,9940000
nn_kernel_cpu,12600,0,1,1,64,0,0,0,0,1,9950000
nn_kernel_gpu,632,1,1,77735,128,0,0,0,0,1,9950000
nn_kernel_gpu_mem,14202,1,1,77735,128,79600000,39800000,39800000,79600000,1,9950000
nn_kernel_cpu,62064,0,1,1,64,0,0,0,0,1,9960000
nn_kernel_gpu,624,1,1,77813,128,0,0,0,0,1,9960000
nn_kernel_gpu_mem,16506,1,1,77813,128,79680000,39840000,39840000,79680000,1,9960000
nn_kernel_cpu,20136,0,1,1,64,0,0,0,0,1,9970000
nn_kernel_gpu,625,1,1,77891,128,0,0,0,0,1,9970000
nn_kernel_gpu_mem,17865,1,1,77891,128,79760000,39880000,39880000,79760000,1,9970000
nn_kernel_cpu,31340,0,1,1,64,0,0,0,0,1,9980000
nn_kernel_gpu,643,1,1,77969,128,0,0,0,0,1,9980000
nn_kernel_gpu_mem,14299,1,1,77969,128,79840000,39920000,39920000,79840000,1,9980000
nn_kernel_cpu,25712,0,1,1,64,0,0,0,0,1,9990000
nn_kernel_gpu,630,1,1,78047,128,0,0,0,0,1,9990000
nn_kernel_gpu_mem,14145,1,1,78047,128,79920000,39960000,39960000,79920000,1,9990000
